[
  {
    "type": "mapgen",
    "method": "json",
    "om_terrain": [ "urban_23_1" ],
    "weight": 250,
    "object": {
      "fill_ter": "t_floor",
      "rows": [
        "%%%%%%%%%%%%%%%%%%%%%%%%",
        "%%%%%%%%%%%%%%%%%%%%%%%%",
        "%%%%%%%%%%%%%%%%%iiiiiii",
        "%%%%%%%%%%%%%%%%%iŻŻŻ:::",
        "%%%%%%%%%%%%%%%%%i::::::",
        "%%%%%%%%%%%%%%%%%i::::::",
        "iiiiiiiiiiiiiiiiii:::ii:",
        "iT2|r|2T|OOOOOOOii:::ii:",
        "iS2| |2S|      O+:::::::",
        "i-+|+|+-| OOOO Oii::::::",
        "iO        OOOO Oii::::::",
        "iO OO  -|      Oii:::ii:",
        "IIIIO  >| OOOO Oii:::ii:",
        "+ŽŽIO  -| OOOO Oii::::::",
        "iZrIO          Oii::::::",
        "i yIO  hhh OOO Oii::::::",
        "i yIO  ttt OOO Oii:::ii:",
        "i  +   ttt     Oii:::ii:",
        "iźžIOO hhh OOOOOii:::::i",
        "iiiiiiiiiiiiiiiiii::::ii",
        "%%%%%%%%%%%%%%%%%iŻŻŻ:i%",
        "%%%%%%%%%%%%%%%%%iiiiii%",
        "%%%%%%%%%%%%%%%%%%%%%%%%",
        "%%%%%%%%%%%%%%%%%%%%%%%%"
      ],
      "palettes": [ "acidia_residential_commercial_palette" ],
      "toilets": { "T": {  } },
      "items": {
        " ": { "item": "office", "chance": 1 },
        ":": { "item": "home_hw", "chance": 1 },
        "O": { "item": "office", "chance": 10 },
        "r": { "item": "cleaning", "chance": 60 },
        "t": { "item": "office", "chance": 25, "repeat": 5 }
      },
      "place_monsters": [ { "monster": "GROUP_ZOMBIE", "x": [ 1, 15 ], "y": [ 7, 18 ], "density": 0.12 } ]
    }
  },
  {
    "type": "mapgen",
    "method": "json",
    "om_terrain": [ "urban_23_2" ],
    "weight": 250,
    "object": {
      "fill_ter": "t_floor",
      "rows": [
        "%%%%%%%%%%%%%%%%%%%%%%%%",
        "%%%%%%%%%%%%%%%%%%%%%%%%",
        "iiiiiiiiiiiiiiiiiiiiiiii",
        ":::i::yiiiy::iŻŻ:::::ZŽi",
        ":::i::yyiyy::iŻŻ::::::Zi",
        ":::i:::::::::i:::~~::::i",
        ":::i:::::::::i:::~ii:::i",
        ":::i:::::::::i:::~ii:::i",
        ":::i:::źi::::i:::::|~~:i",
        ":::+:::iii:::+:::::|:~0i",
        ":::i::::i::::i:::::|0~00",
        ":::i:::::::::i::::ii0~~~",
        ":::i:::žžž:::i::::ii0~~~",
        ":::i:::žžž:::i::::|00~00",
        ":::+:::::::::+::::|::~0i",
        ":::i::::i::::i::::|:::0i",
        ":::iZŽZiiiZŽZi::::ii:~0i",
        "iiiiiiiiiiiiiiii::ii::0i",
        "i%%%%%%%%%%%%%%ii>|:::~i",
        "%%%%%%%%%%%%%%%%iii::~~i",
        "%%%%%%%%%%%%%%%%%%iZZZZi",
        "%%%%%%%%%%%%%%%%%%iiiiii",
        "%%%%%%%%%%%%%%%%%%%%%%%%",
        "%%%%%%%%%%%%%%%%%%%%%%%%"
      ],
      "palettes": [ "acidia_residential_commercial_palette" ],
      "items": { "%": { "item": "home_hw", "chance": 1 } }
    }
  },
  {
    "type": "mapgen",
    "method": "json",
    "om_terrain": [ "urban_23_3" ],
    "weight": 250,
    "object": {
      "fill_ter": "t_floor",
      "rows": [
        ",,,,,,,,,,,,,,,,,iiiiiii",
        ",,,,,,,,,,,,,,,;;i      ",
        ",,,,,,,,,,,,,,,;;i      ",
        ";;;;;;;;;;;;;;;;;1      ",
        ";;''''''';;QQQ;;;1      ",
        ";;'''''}';;QQQ;;;i  hhhh",
        "|--w-1---w---w--|i      ",
        "|d6d    hd    hd|i  hhhh",
        "|dh    dd6   dd6|i      ",
        "|               |i  hhhh",
        "|+|-|-|O O      |i      ",
        "|L|u+ |-+|-|  |+|i  hhhh",
        "|-|-| |< |>   |u|i      ",
        "|2T2| |--|-|  |-|i------",
        "|222+   dh      |ig22222",
        "|CSC|   d6d    A|ir26222",
        "|---|          t|ir2C222",
        "|t             A|i-|--+-",
        "|A     AtA  AtAt|iT+222i",
        "|-w-1-w--w-w--w-|i-|2Sii",
        ";;;;;;;;;;;;;;;;;iT+2Si'",
        ";;;;;;;;;^;;;^;;;iiiiii'",
        ";;;;;;;;;;;;;;;;;;;;;;;;",
        ";;;;;;;;;;;;;;;;;;;;;;;;"
      ],
      "palettes": [ "acidia_residential_commercial_palette" ],
      "toilets": { "T": {  } },
      "items": {
        " ": { "item": "office", "chance": 1 },
        "2": { "item": "snacks", "chance": 1 },
        "A": { "item": "magazines", "chance": 15 },
        "C": { "item": "cleaning", "chance": 10 },
        "L": { "item": "home_hw", "chance": 70 },
        "O": { "item": "office", "chance": 90 },
        "d": { "item": "office", "chance": 40 },
        "g": { "item": "vending_drink", "chance": 60 },
        "r": { "item": "vending_food", "chance": 60 },
        "t": { "item": "magazines", "chance": 25 },
        "u": { "item": "cleaning", "chance": 60 }
      },
      "place_monsters": [ { "monster": "GROUP_ZOMBIE", "x": [ 1, 22 ], "y": [ 1, 22 ], "density": 0.25 } ]
    }
  },
  {
    "type": "mapgen",
    "method": "json",
    "om_terrain": [ "urban_23_4" ],
    "weight": 250,
    "object": {
      "fill_ter": "t_floor",
      "rows": [
        "iiiiiiiiiiiiiiiiiii11iii",
        "                       i",
        "                       i",
        "                       i",
        "                       i",
        "hh  hhhhhhhhh  hhhhhh  i",
        "                       i",
        "hh  hhhhhhhhh  hhhhhh  i",
        "                       i",
        "hh  hhhhhhhhh  hhhhhh  i",
        "                       i",
        "hh  hhhhhhhhh  hhhhhh  i",
        "                       i",
        "--++--|---|--++--------i",
        "22222a|>2>|22222222222gi",
        "2222222222222222222262ri",
        "22222222222222222222C2ri",
        "iiiJJivvvvviJJiii+i+-|-i",
        "i'''''''''''''''i<i22+Ti",
        "i'''''''''''''''iiiS2|-i",
        "''''''|-1-|'''''''iS2+Ti",
        "''''''w6hcw'''''''iiiiii",
        ";;;;''|vvv|'';;;;;;;;`;;",
        ";;;;''''''''';;;;;;;;;;;"
      ],
      "palettes": [ "acidia_residential_commercial_palette" ],
      "toilets": { "T": {  } },
      "items": {
        "2": { "item": "snacks", "chance": 1 },
        "g": { "item": "vending_drink", "chance": 60 },
        "r": { "item": "vending_food", "chance": 60 }
      },
      "place_monsters": [ { "monster": "GROUP_ZOMBIE", "x": [ 1, 22 ], "y": [ 1, 22 ], "density": 0.25 } ]
    }
  },
  {
    "type": "mapgen",
    "method": "json",
    "om_terrain": [ "urban_23_5" ],
    "weight": 250,
    "object": {
      "fill_ter": "t_floor",
      "rows": [
        ".................iiiiiii",
        ".................i777777",
        ".................i777777",
        ".................i777777",
        "..8999998........i777777",
        "..8}000{8........i777777",
        "|-w--!-|-|-w--w-|i777777",
        "|C22H22|r|  dd6 |i777777",
        "|S22442|+|   hd |i777777",
        "|C2H442| +      |i777777",
        "|f22H22+ |     O|i777777",
        "|--+-|-| |-|+-|-|i777777",
        "|T22S|>   <| L|L|i777777",
        "|----|-| |-|--|+|i999999",
        "|      | |  h   |i      ",
        "|   d  | +      |i  hhhh",
        "|  hd  | |      |i      ",
        "|  d6  + | dd6d |i  hhhh",
        "|      | |   A  |i      ",
        "|-w--w-|w|-w--w-|i--+-|-",
        ".................ir  r|>",
        ".................iiiiiii",
        "........................",
        "........................"
      ],
      "palettes": [ "acidia_residential_commercial_palette" ],
      "toilets": { "T": {  } },
      "items": {
        " ": { "item": "office", "chance": 1 },
        "2": { "item": "snacks", "chance": 1 },
        "4": { "item": "dining", "chance": 30 },
        "A": { "item": "magazines", "chance": 15 },
        "C": { "item": "kitchen", "chance": 20 },
        "L": { "item": "office", "chance": 70 },
        "O": { "item": "office", "chance": 90 },
        "d": { "item": "office", "chance": 40 },
        "f": { "item": "vending_drink", "chance": 60 },
        "r": { "item": "cleaning", "chance": 60 }
      },
      "place_monsters": [
        { "monster": "GROUP_ZOMBIE", "x": [ 1, 15 ], "y": [ 7, 18 ], "density": 0.09 },
        { "monster": "GROUP_ZOMBIE", "x": [ 18, 22 ], "y": [ 14, 18 ], "density": 0.25 }
      ]
    }
  },
  {
    "type": "mapgen",
    "method": "json",
    "om_terrain": [ "urban_23_6" ],
    "weight": 250,
    "object": {
      "fill_ter": "t_floor",
      "rows": [
        "iiiiiiiiiiiiiiiiiiiiiiii",
        "77777777777777777777777i",
        "77777777777777777777777i",
        "77777777777777777777777i",
        "77777777777777777777777i",
        "77777777777777777777777i",
        "77777777777777777777777i",
        "77777777777777777777777i",
        "77777777777777777777777i",
        "77777777777777777777777i",
        "77777777777777777777777i",
        "77777777777777777777777i",
        "77777777777777777777777i",
        "99999999999999999999999i",
        "       < <             i",
        "hh  hh     hh  hhhhhh  i",
        "                       i",
        "hh  hhhhhhhhh  hhhhhh  i",
        "                       i",
        "-|  hhhhhhhhh  hhhhhh  i",
        " +                     i",
        "iiiiiiiiiiiiiiiiiiiiiiii",
        "....8RRRRRRR8.........`.",
        "....888888888..........."
      ],
      "palettes": [ "acidia_residential_commercial_palette" ],
      "items": { " ": { "item": "office", "chance": 1 } },
      "place_monsters": [ { "monster": "GROUP_ZOMBIE", "x": [ 1, 21 ], "y": [ 14, 18 ], "density": 0.25 } ]
    }
  },
  {
    "type": "mapgen",
    "method": "json",
    "om_terrain": [ "urban_23_7" ],
    "weight": 250,
    "object": {
      "fill_ter": "t_floor",
      "rows": [
        ".................iiiiiii",
        ".................i777777",
        ".................i777777",
        ".................i777777",
        "..8999998........i777777",
        "..8{000}8........i777777",
        "|-w--!--w--w--w-|i777777",
        "|O    h  h      |i777777",
        "|O   httttth    |i777777",
        "|     ttttt    O|i777777",
        "|    h h   h   O|i777777",
        "|--+-|-v+v-|-+|-|i777777",
        "|T22S|<   >|r |r|i777777",
        "|----|-| |-|--|+|i777777",
        "| h    | |      |i777777",
        "|d6d   | +      |i777777",
        "|      | |@   d |i777777",
        "|      + |@   dh|i777777",
        "|  hth | |@   6d|i777777",
        "|-w--w-|w|-w--w-|i7777|-",
        ".................i7777|<",
        ".................iiiiiii",
        "........................",
        "........................"
      ],
      "palettes": [ "acidia_residential_commercial_palette" ],
      "toilets": { "T": {  } },
      "items": {
        " ": { "item": "office", "chance": 1 },
        "@": { "item": "magazines", "chance": 10 },
        "O": { "item": "office", "chance": 90 },
        "d": { "item": "office", "chance": 40 },
        "r": { "item": "cleaning", "chance": 60 },
        "t": { "item": "office", "chance": 20 }
      },
      "place_monsters": [ { "monster": "GROUP_ZOMBIE", "x": [ 1, 15 ], "y": [ 7, 18 ], "density": 0.09 } ]
    }
  },
  {
    "type": "mapgen",
    "method": "json",
    "om_terrain": [ "urban_23_8" ],
    "weight": 250,
    "object": {
      "fill_ter": "t_floor",
      "rows": [
        "iiiiiiiiiiiiiiiiiiiiiiii",
        "77777777777777777777777i",
        "77777777777777777777777i",
        "77777777777777777777777i",
        "77777777777777777777777i",
        "77777777777777777777777i",
        "77777777777777777777777i",
        "77777777777777777777777i",
        "77777777777777777777777i",
        "77777777777777777777777i",
        "77777777777777777777777i",
        "77777777777777777777777i",
        "77777777777777777777777i",
        "77777777777777777777777i",
        "77777777777777777777777i",
        "77777777777777777777777i",
        "77777777777777777777777i",
        "77777777777777777777777i",
        "7|-----www-----|7777777i",
        "-|rrr  hZ  rrrr|7777777i",
        " +             |7777777i",
        "iiiiiiiiiiiiiiiiiiiiiiii",
        ".......................`",
        "........................"
      ],
      "palettes": [ "acidia_residential_commercial_palette" ],
      "items": { "r": { "item": "electronics", "chance": 80 } }
    }
  },
  {
    "type": "mapgen",
    "method": "json",
    "om_terrain": [ "urban_23_9" ],
    "weight": 250,
    "object": {
      "fill_ter": "t_floor",
      "rows": [
        ".................¦¦¦¦¦¦¦",
        ".................¦RRRRRR",
        ".................¦RRRRRR",
        ".................¦RRRRRR",
        "..8999998........¦RRRRRR",
        "..8}000{8........¦RRRRRR",
        "|-w--!--w--w--w-|¦RRRRRR",
        "|A      hd      |¦RRRRRR",
        "|t     d6d     A|¦RRRRRR",
        "|A             t|¦RRRRRR",
        "|              A|¦)RRRRR",
        "|----|-v+v-| |--|¦)RRRRR",
        "|T22S|<    |+|L |¦)RRRRR",
        "|--+-|-----| |-+|¦RRRRRR",
        "|       h       |¦RRRRRR",
        "|c             c|¦RRRRRR",
        "|c             c|¦RRRRRR",
        "|c    cc6cc    c|¦RRRRRR",
        "|       A       |¦RRRRRR",
        "|-w--w-VVV-w--w-|¦RRRRRR",
        ".................¦RRRRRR",
        ".................¦¦¦¦¦¦¦",
        "........................",
        "........................"
      ],
      "palettes": [ "acidia_residential_commercial_palette" ],
      "terrain": { "¦": "t_gutter_west" },
      "toilets": { "T": {  } },
      "items": {
        " ": { "item": "office", "chance": 1 },
        "A": { "item": "magazines", "chance": 15 },
        "L": { "item": "jewelry_safe", "chance": 90 },
        "c": { "item": "wines_worthy", "chance": 10 },
        "d": { "item": "office", "chance": 40 },
        "t": { "item": "magazines", "chance": 10 }
      },
      "place_monsters": [ { "monster": "GROUP_ZOMBIE", "x": [ 1, 15 ], "y": [ 7, 18 ], "density": 0.09 } ]
    }
  },
  {
    "type": "mapgen",
    "method": "json",
    "om_terrain": [ "urban_23_10" ],
    "weight": 250,
    "object": {
      "fill_ter": "t_floor",
      "rows": [
        "111111111111111111111111",
        "RRRRRRRRRRRRRRRRRRRRRRR2",
        "RBRRRRRRRRRRRRRRRRRRRRR2",
        "RRRRRRRRRRRRRRRRRRRRRRR2",
        "RRRRRRRRRRRRRRRRRRRRRRR2",
        "RRRRRRRRRRRRRRRRRRRRRRR2",
        "RRRRRRRRRRRRRRRRRRRRRRR2",
        "RRRRRRRRRRRRRRRRRRRRRRR2",
        "RRRRRRRRRRRRRRRRRRRRRRR2",
        "RRRRRRRRRRRRRRRRRRRRRRR2",
        "RRRRRRRRRRRRRRRRRRRRRRR2",
        "RRRRRRRRRRRRRRRRRRRRRRR2",
        "RRRRRRRRRRRRRRRRRRRRRRR2",
        "RRRRRRRRRRRRRRRRRRRRRRR2",
        "RRRRRRRRRRRRRRRRRRRRRRR2",
        "RRRRRRRRRRRRRRRRRRRRRRR2",
        "RRRRGRRRRGRRRRRGRRRRRRR2",
        "RRRRRRRRRRRRRRRRRRRRRRR2",
        "RRRRRRRRRRRRRRRRRRRRRRR2",
        "RRRRRRRRRRRRRRRRRRRRRRR2",
        "RRRRRRRRRRRRRRRRRRRRRRR2",
        "333333333333333333333335",
        "........................",
        "........................"
      ],
      "palettes": [ "acidia_residential_roof_palette" ]
    }
  },
  {
    "type": "mapgen",
    "method": "json",
    "om_terrain": [ "urban_23_11" ],
    "weight": 250,
    "object": {
      "fill_ter": "t_floor",
      "rows": [
        "........................",
        "........................",
        "........................",
        "........................",
        "..8999998...............",
        "..8{00008...............",
        "888RRRRR888888888.......",
        "8RRRRRRRRRRRRRRR8.......",
        "8RRRRRRRRRRRRRRR8.......",
        "8RRRRRRRRRRRRRRR8.......",
        "8RRRRRRRRRRRRRRR8.......",
        "8RRRRRRR)RRRRRRR8.......",
        "8RRRRRRRRRRRRRRR8.......",
        "8RRRRRRRRRRRRRRR8.......",
        "8RRRRRRRRRRRRRRR8.......",
        "8RRRRRRRRRRRRRRR8.......",
        "8RRRRRRRRRRRRRRR8.......",
        "8RRRRRRRRRRRRRRR8.......",
        "8RRRRRRRRRRRRRRR8.......",
        "88888888888888888.......",
        "........................",
        "........................",
        "........................",
        "........................"
      ],
      "palettes": [ "acidia_residential_commercial_palette" ],
      "place_monsters": [ { "monster": "GROUP_ZOMBIE", "x": [ 1, 15 ], "y": [ 7, 18 ], "density": 0.02 } ]
    }
  }
]
