[
  {
    "type": "mapgen",
    "method": "json",
    "om_terrain": [ "urban_40_1" ],
    "object": {
      "fill_ter": "t_floor",
      "rows": [
        ",,,,,,,,,,,,,,;;;;;,,,,,",
        ",,,,,,,,iwwwwi;;;;;,,,,,",
        ",^,,,iiiiH44Hiii1iiiiwii",
        ",,,,,iCC2H44H22   c6c OO",
        ",,,,,wo22H44H22         ",
        ",,,,,iC22222222         ",
        ",,,,,wS22222222   tt    ",
        ",,,,,iC22222222 @       ",
        ",,,,,if22CjjC22k@@@@@iiw",
        ",,^,,i-+iiiiiiiiiiiiii;;",
        ",,,,,iS2i'''''''''''/i;;",
        ",,,,,wD2+''''''''''''=__",
        ",,,,,iC2i''''''''''''=__",
        ",,,,,i--i''''''''''''=__",
        ",,,^,iL i''''''''''''=__",
        ",,,,,iL +''''''''''''=__",
        ",,,,,iL i''''''''''''=__",
        ",,,,,iiii''''''''''''=__",
        ",,,,,,,,i'''''rr'''''i,,",
        ",,,,,,,,iiiwwiiiiwwiii,,",
        ",,,,,,,,,,,,,,,,,,,,,,,,",
        ",,,,,,,^,,,,,,,,,,,,,,^,",
        ",,,,,,,,,,,,,,^,,,,,,,,,",
        ",,,,,,,,,,,,,,,,,,,,,,,,"
      ],
      "palettes": [ "acidia_residential_commercial_palette" ],
      "terrain": {
        ";": "t_concrete",
        ",": "t_region_groundcover_urban",
        "^": [ [ "t_region_tree_fruit", 2 ], [ "t_region_tree_nut", 2 ], "t_region_tree_shade" ]
      },
      "items": {
        " ": { "item": "livingroom", "chance": 1 },
        "'": { "item": "mechanics", "chance": 1 },
        "2": { "item": "kitchen", "chance": 1 },
        "4": { "item": "dining", "chance": 25 },
        "@": { "item": "magazines", "chance": 10 },
        "A": { "item": "livingroom", "chance": 15 },
        "C": { "item": "kitchen", "chance": 25 },
        "L": { "item": "home_hw", "chance": 70 },
        "O": { "item": "homebooks", "chance": 60 },
        "c": { "item": "livingroom", "chance": 25 },
        "f": { "item": "SUS_fridge", "chance": 70 },
        "j": { "item": "cannedfood", "chance": 50 },
        "o": { "item": "oven", "chance": 30 },
        "q": { "item": "trash", "chance": 50 },
        "r": { "item": "mechanics", "chance": 60 },
        "t": { "item": "coffee_table", "chance": 25 }
      },
      "place_monsters": [ { "monster": "GROUP_ZOMBIE", "x": [ 1, 22 ], "y": [ 1, 22 ], "density": 0.2 } ],
      "place_vehicles": [ { "vehicle": "suburban_home", "x": 15, "y": 14, "chance": 40, "rotation": 0 } ]
    }
  },
  {
    "type": "mapgen",
    "method": "json",
    "om_terrain": [ "urban_40_2" ],
    "object": {
      "fill_ter": "t_floor",
      "rows": [
        ",,,,,,,,,,,,,,,,,,,,,,,,",
        ",,,,,;;;,,,,,,,,,,,,,,,,",
        "iiiiii1iiiiiiwiiiwii,,,,",
        "OA|ST|L|BTS| ebbbe i,,,,",
        "  +22|-|B22+  bbb  i,,,,",
        "  |--|>|---|  bbb  i,,,,",
        "           +       w,,^,",
        "           |       i,,,,",
        "wwii1iiwwwii   hd  i,,,,",
        ";;;;;;;;;;;ik d6dOOi`,,,",
        "i;;;;;;;i;;iiiwwwiii,,,,",
        "__________________,,,,,,",
        "___________________,,,,,",
        "____________________,,,,",
        "____________________,,,,",
        "____________________,,,,",
        "____________________,,,,",
        "____________________,,,,",
        ",,__________________,,,,",
        ",,,_________________,,,,",
        ",,,,________________,,,,",
        ",,,,________________,,,,",
        ",,,,________________,,,,",
        ",,p̄,________________,,,,"
      ],
      "palettes": [ "acidia_residential_commercial_palette" ],
      "terrain": {
        ";": "t_concrete",
        ",": "t_region_groundcover_urban",
        "p̄": "t_region_groundcover_urban",
        "^": [ [ "t_region_tree_fruit", 2 ], [ "t_region_tree_nut", 2 ], "t_region_tree_shade" ]
      },
      "furniture": { "p̄": "f_mailbox" },
      "toilets": { "T": {  } },
      "items": {
        "p̄": { "item": "mail", "chance": 30, "repeat": [ 2, 5 ] },
        " ": { "item": "livingroom", "chance": 1 },
        "2": { "item": "softdrugs", "chance": 10 },
        "4": { "item": "dining", "chance": 25 },
        "A": { "item": "livingroom", "chance": 10 },
        "L": { "item": "home_hw", "chance": 70 },
        "O": { "item": "homebooks", "chance": 60 },
        "b": { "item": "bed", "chance": 60 },
        "d": { "item": "office", "chance": 40 },
        "e": { "item": "dresser", "chance": 60 }
      },
      "place_monsters": [ { "monster": "GROUP_ZOMBIE", "x": [ 1, 22 ], "y": [ 1, 22 ], "density": 0.2 } ]
    }
  },
  {
    "type": "mapgen",
    "method": "json",
    "om_terrain": [ "urban_40_3" ],
    "weight": 250,
    "object": {
      "fill_ter": "t_floor",
      "rows": [
        "........................",
        "........RRRRRR..........",
        ".....RRRRRRRRRRRRRRRRRRR",
        ".....RRRRRRRRRRRRRRRRRRR",
        ".....RRRiiiiwwiiiiiiiiii",
        ".....RRRibbc  eee|BB|@@@",
        ".....RRRwbbc     +22|@  ",
        ".....RRRi        |ST|@ t",
        ".....RRRwbbc     |--|   ",
        ".....RRRibbc     +      ",
        ".....RRRiiiiwwiiiiwwiiii",
        ".....RRRRRRRRRRRRRRRRR..",
        ".....RRRRRRRRRRRRRRRRR..",
        ".....RRRRRRRRRRRRRRRRR..",
        ".....RRRRRRRRRRRRRRRRR..",
        ".....RRRRRRRRRRRRRRRRR..",
        ".....RRRRRRRRRRRRRRRRR..",
        ".....RRRRRRRRRRRRRRRRR..",
        "........RRRRRRRRRRRRRR..",
        "........RRRRRRRRRRRRRR..",
        "........................",
        "........................",
        "........................",
        "........................"
      ],
      "palettes": [ "acidia_residential_commercial_palette" ],
      "toilets": { "T": {  } },
      "items": {
        " ": { "item": "livingroom", "chance": 1 },
        "2": { "item": "softdrugs", "chance": 10 },
        "@": { "item": "magazines", "chance": 10 },
        "b": { "item": "bed", "chance": 60 },
        "c": { "item": "livingroom", "chance": 20 },
        "e": { "item": "dresser", "chance": 60 },
        "t": { "item": "coffee_table", "chance": 25 }
      },
      "place_monsters": [ { "monster": "GROUP_ZOMBIE", "x": [ 9, 22 ], "y": [ 5, 9 ], "density": 0.16 } ]
    }
  },
  {
    "type": "mapgen",
    "method": "json",
    "om_terrain": [ "urban_40_4" ],
    "weight": 250,
    "object": {
      "fill_ter": "t_floor",
      "rows": [
        "........................",
        "........................",
        "RRRRRRRRRRRRRRRRRRRR....",
        "RRRRRRRRRRRRRRRRRRRR....",
        "iiiiiiiiiiiiiiwwiiii....",
        "@@ OO|<|BB| ebbbe ki....",
        "       |22+  bbb   w....",
        "t      |TS|  bbb   i....",
        "       |--|      Adw....",
        "c6c       +     d6di....",
        "wwwwiiiiwwiiiiwwiiii`...",
        "........................",
        "........................",
        "........................",
        "........................",
        "........................",
        "........................",
        "........................",
        "........................",
        "........................",
        "........................",
        "........................",
        "........................",
        "........................"
      ],
      "palettes": [ "acidia_residential_commercial_palette" ],
      "toilets": { "T": {  } },
      "items": {
        " ": { "item": "livingroom", "chance": 1 },
        "2": { "item": "softdrugs", "chance": 10 },
        "@": { "item": "magazines", "chance": 10 },
        "O": { "item": "homebooks", "chance": 60 },
        "b": { "item": "bed", "chance": 60 },
        "c": { "item": "livingroom", "chance": 20 },
        "d": { "item": "office", "chance": 40 },
        "e": { "item": "dresser", "chance": 60 },
        "t": { "item": "coffee_table", "chance": 25 }
      },
      "place_monsters": [ { "monster": "GROUP_ZOMBIE", "x": [ 1, 18 ], "y": [ 5, 9 ], "density": 0.16 } ]
    }
  },
  {
    "type": "mapgen",
    "method": "json",
    "om_terrain": [ "urban_40_5" ],
    "weight": 250,
    "object": {
      "fill_ter": "t_floor",
      "rows": [
        "........................",
        "........................",
        "........................",
        "........................",
        "........1111111111111111",
        "........4RRRRRRRRRRRRRRR",
        "........4RRGRRRRRGRRRRRR",
        "........4RRRRRRRRRRRRRRR",
        "........4RRRRRRRRRRRRRRR",
        "........4RRRRRRRRRRRRRRR",
        "........3333333333333333",
        "........................",
        "........................",
        "........................",
        "........................",
        "........................",
        "........................",
        "........................",
        "........................",
        "........................",
        "........................",
        "........................",
        "........................",
        "........................"
      ],
      "palettes": [ "acidia_residential_roof_palette" ]
    }
  },
  {
    "type": "mapgen",
    "method": "json",
    "om_terrain": [ "urban_40_6" ],
    "weight": 250,
    "object": {
      "fill_ter": "t_floor",
      "rows": [
        "........................",
        "........................",
        "........................",
        "........................",
        "11111111111111111111....",
        "RRRRRRRRRRRGRRRRRRR2....",
        "RRRGRRRRRRRRRRRRRRR2....",
        "RRRRRRRRRRRRRRRRRRR2....",
        "RRRRRRRRRRRRRRRRRRR2....",
        "RRRRRRRRRRRRRRRRRRR2....",
        "33333333333333333335....",
        "........................",
        "........................",
        "........................",
        "........................",
        "........................",
        "........................",
        "........................",
        "........................",
        "........................",
        "........................",
        "........................",
        "........................",
        "........................"
      ],
      "palettes": [ "acidia_residential_roof_palette" ]
    }
  }
]
