[
  {
    "type": "mapgen",
    "method": "json",
    "om_terrain": [ [ "urban_21_1", "urban_21_2" ] ],
    "object": {
      "fill_ter": "t_floor",
      "rows": [
        "..............p`.....................________...",
        "...............`...............[.....________...",
        "..............```.###................________...",
        "..####o########*###a#####o####.......________...",
        "..#@   @@|            HH     #.......________...",
        "..#@     |E           H  l  x#.......________...",
        "..o      |s           H  l  x#.......________...",
        "..#|||+| |E                 x#.......________...",
        "..#D |D| |      RR    E      #.......________...",
        "..#|+|||+||+||||||||||||    |#...[...________...",
        "..#d   +,,,,,,,6,,+          #.......________...",
        "..#@@  ||+||F,,,,3|   hfffh  #.......________...",
        "..#@@  |B,S|4,,,,O|   hfffh  #......&________...",
        "..#d   |B,t|5,,,21|          #.....##========##.",
        ".^##o####o####*########o#o####.....#&~~~~~~~~~#.",
        "..............`....................#~~~~~~~~~~o.",
        "..............`````````````````````*~~~~~~~~~~#.",
        "..[.............................####~~~~Á~~~~~#.",
        ".....00.00.00.00..............[.#q~~~~~~~~~~~~#.",
        ".....00.00.00.00................#q~~~~~~~~~~~~#.",
        ".....00.00.00.00................####~~~~~~~~~~o.",
        ".....00.00.00.00.......[..........^#~~~~~~~~~~#.",
        ".....00.00.00.00...................############.",
        "................................................"
      ],
      "palettes": [
        "standard_domestic_palette",
        "standard_domestic_lino_kitchen",
        "standard_domestic_lino_bathroom",
        "standard_domestic_landscaping_palette"
      ],
      "terrain": {
        "=": "t_door_metal_locked",
        "&": "t_gates_control_brick",
        "~": "t_thconc_floor",
        "q": "t_thconc_floor",
        "0": "t_dirtmound",
        ",": "t_linoleum_gray",
        "Á": "t_thconc_floor"
      },
      "place_loot": [ { "item": "television", "x": 28, "y": 6, "chance": 100 } ],
      "vehicles": { "Á": { "vehicle": "suburban_home", "chance": 100, "rotation": 270 } }
    }
  },
  {
    "type": "mapgen",
    "method": "json",
    "om_terrain": [ [ "urban_21_3", "urban_21_4" ] ],
    "object": {
      "fill_ter": "t_shingle_flat_roof",
      "rows": [
        "                                                ",
        "                                                ",
        "                  ---                           ",
        "  -----------------~----------                  ",
        "  -..........................-                  ",
        "  -..............X...........-                  ",
        "  -..........................-                  ",
        "  -..........................-                  ",
        "  -..........................-                  ",
        "  -..........................-                  ",
        "  -..........................-                  ",
        "  -..........................-                  ",
        "  -......=...................-                  ",
        "  -..........................-     ------------ ",
        "  5---------------------------     -..........- ",
        "                                   -..........- ",
        "                                   -..........- ",
        "                                ----..........- ",
        "                                -.............- ",
        "                                -.............- ",
        "                                ----..........- ",
        "                                   5..........- ",
        "                                   ------------ ",
        "                                                "
      ],
      "palettes": [ "roof_palette" ],
      "terrain": { ".": "t_shingle_flat_roof" }
    }
  }
]
