[
  {
    "type": "mapgen",
    "method": "json",
    "om_terrain": [ [ "urban_20_1", "urban_20_2" ] ],
    "object": {
      "fill_ter": "t_thconc_floor",
      "rows": [
        "                                                ",
        "                                                ",
        "                                                ",
        "                                                ",
        "                                                ",
        "                                                ",
        "               |||||||||||||||||||              ",
        "               |........|........|              ",
        "               |.......J|J.......|              ",
        "               |.......Z|Z.......|              ",
        "               |.......W|W.......|              ",
        "               |.......J|J.......|              ",
        "               |......|||||......|              ",
        "               |.......<|<.......|              ",
        "               |......|||||......|              ",
        "               |.α....Ug|g.......|              ",
        "               |.α......|U.......|              ",
        "               |........|U.......|              ",
        "               |....β...|........|              ",
        "               |.......F|F.......|              ",
        "               |||||||||||||||||||              ",
        "                                                ",
        "                                                ",
        "                                                "
      ],
      "palettes": [ "basement_empty" ],
      "furniture": { "α": "f_exercise", "β": "f_treadmill" }
    }
  },
  {
    "type": "mapgen",
    "method": "json",
    "om_terrain": [ [ "urban_20_3", "urban_20_4" ] ],
    "object": {
      "fill_ter": "t_floor",
      "rows": [
        ".._______........p`..........p`........_______..",
        ".._______.........`...[.......`........_______..",
        ".._______.........`...........`........_______..",
        ".._______.........`...........`........_______..",
        ".._______......#````````#````````#....._______..",
        ".._______``````````````````````````````_______..",
        ".._______......###*#ooo###ooo#*###^...._______..",
        "..___Á___......#RL  HH  #  x L  R#.....___Á___..",
        ".._______......#    Hl x#H l    T#....._______..",
        ".._______....#o#    H  x#HHHH   E#o#..._______..",
        ".._______....oy         #         io..._______..",
        "..._____.....oy       |<#<|       io...._____...",
        ".............#o#hh    ||#||  hh  #o#............",
        "...............#ff    +>#>+  ff  #..............",
        "...............#ff    ||#||  ff  #....[.........",
        "...............#hh    |S#S|  hh  #..............",
        ".............#o#,,,,,,+,#,+,,,,,,#o#............",
        ".............o1,,JJ,,,|t#t|,,,JJ,,1o............",
        ".............o5,,,,,,,||#||,,,,,,,5o............",
        "......[......#o#2O34F,+6#6+,F43O2#o#............",
        "...............###o##*#####*##o###............[.",
        "...............^...```````````..................",
        "...................```````````..................",
        "................................................"
      ],
      "palettes": [
        "standard_domestic_palette",
        "standard_domestic_lino_kitchen",
        "standard_domestic_lino_bathroom",
        "standard_domestic_landscaping_palette"
      ],
      "terrain": { "Á": "t_pavement", ",": "t_linoleum_gray" },
      "place_loot": [
        { "item": "television", "x": 23, "y": 8, "chance": 100 },
        { "item": "stereo", "x": 23, "y": 8, "chance": 65 },
        { "item": "television", "x": 27, "y": 7, "chance": 100 },
        { "item": "stereo", "x": 27, "y": 7, "chance": 65 }
      ],
      "vehicles": { "Á": { "vehicle": "suburban_home", "chance": 100, "rotation": 90 } }
    }
  },
  {
    "type": "mapgen",
    "method": "json",
    "om_terrain": [ [ "urban_20_5", "urban_20_6" ] ],
    "object": {
      "fill_ter": "t_floor",
      "rows": [
        "~~~~~~~~~~~~~~~~~~~~~~~~~~~~~~~~~~~~~~~~~~~~~~~~",
        "~~~~~~~~~~~~~~~~~~~~~~~~~~~~~~~~~~~~~~~~~~~~~~~~",
        "~~~~~~~~~~~~~~~~~~~~~~~~~~~~~~~~~~~~~~~~~~~~~~~~",
        "~~~~~~~~~~~~~~~~~~~~~~~~~~~~~~~~~~~~~~~~~~~~~~~~",
        "~~~~~~~~~~~~~~~&&&&&&&&&&&&&&&&&&&~~~~~~~~~~~~~~",
        "~~~~~~~~~~~~~~~&&&&&&&&&&&&&&&&&&&~~~~~~~~~~~~~~",
        "~~~~~~~~~~~~~~~##o##o#######o##o##~~~~~~~~~~~~~~",
        "~~~~~~~~~~~~~~~# ¤@@¤ |D#D| ¤@@¤ #^~~~~~~~~~~~~~",
        "~~~~~~~~~~~~~~~#  @@  + # +  @@  #~~~~~~~~~~~~~~",
        "~~~~~~~~~~~~~#o#b    d|D#D|d     #o#~~~~~~~~~~~~",
        "~~~~~~~~~~~~~oET     d||#||d     b o~~~~~~~~~~~~",
        "~~~~~~~~~~~~~o        |>#>|   h    o~~~~~~~~~~~~",
        "~~~~~~~~~~~~~#o#RRy   + # +   II #o#~~~~~~~~~~~~",
        "~~~~~~~~~~~~~~~#||||||| # |||||||#~~~~~~~~~~~~~~",
        "~~~~~~~~~~~~~~~#P |B,,+ # +,,B| D#~~~~~~~~~~~~~~",
        "~~~~~~~~~~~~~~~#P |BtS| # |StB| d#~~~~~~~~~~~~~~",
        "~~~~~~~~~~~~~#o#|+|||||+#+|||||+|#o#~~~~~~~~~~~~",
        "~~~~~~~~~~~~~oY     RR  #         io~~~~~~~~~~~~",
        "~~~~~~~~~~~~~o   hr     #   @@    io~~~~~~~~~~~~",
        "~~~~~~~~~~~~~#o#rrr  HHH#y ¤@@¤ d#o#~~~~~~~~~~~~",
        "~~~~~~~~~~~~~~~##o####o###o####o##~~~~~~~~~~~~~~",
        "~~~~~~~~~~~~~~~~^~~~~~~~~~~~~~~~~~~~~~~~~~~~~~~~",
        "~~~~~~~~~~~~~~~~~~~~~~~~~~~~~~~~~~~~~~~~~~~~~~~~",
        "~~~~~~~~~~~~~~~~~~~~~~~~~~~~~~~~~~~~~~~~~~~~~~~~"
      ],
      "palettes": [ "standard_domestic_palette", "standard_domestic_lino_bathroom" ],
      "terrain": { "~": "t_open_air", "&": "t_shingle_flat_roof", ",": "t_linoleum_gray" }
    }
  },
  {
    "type": "mapgen",
    "method": "json",
    "om_terrain": [ [ "urban_20_7", "urban_20_8" ] ],
    "object": {
      "fill_ter": "t_shingle_flat_roof",
      "rows": [
        "                                                ",
        "                                                ",
        "                                                ",
        "                                                ",
        "                                                ",
        "                                                ",
        "               ------------------5              ",
        "               -.................-              ",
        "               -.................-              ",
        "             ---.........N.......---            ",
        "             -.....................-            ",
        "             -.....................-            ",
        "             ---.................---            ",
        "               -.................-              ",
        "               -.....=.....=.....-              ",
        "               -.................-              ",
        "             ---.................---            ",
        "             -.....................-            ",
        "             -......&..............-            ",
        "             ---.................---            ",
        "               5------------------              ",
        "                                                ",
        "                                                ",
        "                                                "
      ],
      "palettes": [ "roof_palette" ],
      "terrain": { ".": "t_shingle_flat_roof" }
    }
  }
]
