[
  {
    "type": "mapgen",
    "method": "json",
    "om_terrain": [ "urban_19_1" ],
    "weight": 250,
    "object": {
      "fill_ter": "t_floor",
      "rows": [
        "%%%%%%%%%%%%%%%%%%%%%%%%",
        "%%%%%%%%%%%%%%%%%%%%%%%%",
        "%%%%%%%%%%%%%%%%%%%%%%%%",
        "%%%%%%%%%%%%iiiiiiiiiiii",
        "%%%%%%%%%%iiiccWDcci::::",
        "%%%%%%%%%%i''''''''i::::",
        "%%%%%%%%%%irrrr''''i::::",
        "%%%%%%%%%%iiiii'''ui::::",
        "%%%%%%%%%%%%i'''''uiiii:",
        "%%%%%%%%%%%%i>i'''ri::i:",
        "%%%%%%%%%%iiiii+iiiii:i:",
        "%%%%%%%%%%i:::::iFii::ii",
        "%%%%%%%%%%i:::::::ZZ::::",
        "%%%%%%%%%%iiiZZ:::::::::",
        "%%%%%%%%%%%%i::::Z::::::",
        "%%%%%%%%%%%%iiiiiiiiiiii",
        "%%%%%%%%%%%%%%%%%%%%%%%%",
        "%%%%%%%%%%%%%%%%%%%%%%%%",
        "%%%%%%%%%%%%%%%%%%%%%%%%",
        "%%%%%%%%%%%%%%%%%%%%%%%%",
        "%%%%%%%%%%%%%%%%%%%%%%%%",
        "%%%%%%%%%%%%%%%%%%%%%%%%",
        "%%%%%%%%%%%%%%%%%%%%%%%%",
        "%%%%%%%%%%%%%%%%%%%%%%%%"
      ],
      "palettes": [ "acidia_residential_commercial_palette" ],
      "items": {
        "'": { "item": "cleaning", "chance": 2 },
        ":": { "item": "home_hw", "chance": 2 },
        "D": { "item": "allclothes", "chance": 50 },
        "W": { "item": "allclothes", "chance": 50 },
        "c": { "item": "cleaning", "chance": 20 },
        "r": { "item": "cannedfood", "chance": 60 },
        "u": { "item": "cannedfood", "chance": 50 }
      },
      "place_monsters": [ { "monster": "GROUP_ZOMBIE", "x": [ 13, 22 ], "y": [ 4, 14 ], "density": 0.03 } ]
    }
  },
  {
    "type": "mapgen",
    "method": "json",
    "om_terrain": [ "urban_19_2" ],
    "weight": 150,
    "object": {
      "fill_ter": "t_floor",
      "rows": [
        "%%%%%%%%%%%%%%%%%%%%%%%%",
        "iiiii%%%%%%%%%%%%%%%%%%%",
        "irrri%%%%%%%%%%%%%%%%%%%",
        "i:::iiii%%%%%%%%%%%%%%%%",
        ":::::::iii%%%%%%%%%%%%%%",
        "::i::::1>i%%%%%%%%%%%%%%",
        ":iii:::iii%%%%%%%%%%%%%%",
        "::i:::Li%%%%%%%%%%%%%%%%",
        "::::::Li%%%%%%%%%%%%%%%%",
        ":::::::i%%%%%%%%%%%%%%%%",
        "::rr:::i%%%%%%%%%%%%%%%%",
        "iiiii+ii%%%%%%%%%%%%%%%%",
        ":i:+:::i%%%%%%%%%%%%%%%%",
        ":::iZZZi%%%%%%%%%%%%%%%%",
        ":iiii+ii%%%%%%%%%%%%%%%%",
        "ii'''''i%%%%%%%%%%%%%%%%",
        "%i''ḞḟḞi%%%%%%%%%%%%%%%%",
        "%iḈ'ḟ''i%%%%%%%%%%%%%%%%",
        "%iiiḞṆ'i%%%%%%%%%%%%%%%%",
        "%%%iḞṇ'i%%%%%%%%%%%%%%%%",
        "%%%iiiii%%%%%%%%%%%%%%%%",
        "%%%%%%%%%%%%%%%%%%%%%%%%",
        "%%%%%%%%%%%%%%%%%%%%%%%%",
        "%%%%%%%%%%%%%%%%%%%%%%%%"
      ],
      "palettes": [ "acidia_residential_commercial_palette" ],
      "terrain": {
        "Ḉ": "t_strconc_floor",
        "Ḟ": "t_strconc_floor",
        "ḟ": "t_strconc_floor",
        "ṇ": "t_strconc_floor",
        "Ṇ": "t_strconc_floor"
      },
      "furniture": {
        "Ḉ": "f_crate_o",
        "Ḟ": "f_large_canvas_wall",
        "ḟ": "f_large_canvas_door",
        "ṇ": "f_autodoc",
        "Ṇ": "f_autodoc_couch"
      },
      "place_monsters": [ { "monster": "GROUP_LAB_CYBORG", "x": [ 1, 6 ], "y": [ 4, 14 ], "density": 0.03 } ],
      "item": { "Ḉ": { "item": "bot_nursebot", "chance": 100 }, "Ṇ": { "item": "bot_prototype_cyborg", "chance": 10 } },
      "items": {
        "ṇ": { "item": "autodoc_supplies", "chance": 100 },
        ":": { "item": "home_hw", "chance": 2 },
        "L": { "item": "farming_tools", "chance": 80 },
        "r": { "item": "home_hw", "chance": 60 }
      }
    }
  },
  {
    "type": "mapgen",
    "method": "json",
    "om_terrain": [ "urban_19_2" ],
    "weight": 250,
    "object": {
      "fill_ter": "t_floor",
      "rows": [
        "%%%%%%%%%%%%%%%%%%%%%%%%",
        "iiiii%%%%%%%%%%%%%%%%%%%",
        "irrri%%%%%%%%%%%%%%%%%%%",
        "i:::iiii%%%%%%%%%%%%%%%%",
        ":::::::iii%%%%%%%%%%%%%%",
        "::i::::1>i%%%%%%%%%%%%%%",
        ":iii:::iii%%%%%%%%%%%%%%",
        "::i:::Li%%%%%%%%%%%%%%%%",
        "::::::Li%%%%%%%%%%%%%%%%",
        ":::::::i%%%%%%%%%%%%%%%%",
        "::rr:::i%%%%%%%%%%%%%%%%",
        "iiiii:ii%%%%%%%%%%%%%%%%",
        ":i:::::i%%%%%%%%%%%%%%%%",
        ":::i:::i%%%%%%%%%%%%%%%%",
        ":iiii:ii%%%%%%%%%%%%%%%%",
        "ii:::::iii%%%%%%%%%%%%%%",
        "%i:::::::i%%%%%%%%%%%%%%",
        "%i:::::::i%%%%%%%%%%%%%%",
        "%iii:::iii%%%%%%%%%%%%%%",
        "%%%i:::i%%%%%%%%%%%%%%%%",
        "%%%iiiii%%%%%%%%%%%%%%%%",
        "%%%%%%%%%%%%%%%%%%%%%%%%",
        "%%%%%%%%%%%%%%%%%%%%%%%%",
        "%%%%%%%%%%%%%%%%%%%%%%%%"
      ],
      "palettes": [ "acidia_residential_commercial_palette" ],
      "items": {
        ":": { "item": "home_hw", "chance": 2 },
        "L": { "item": "farming_tools", "chance": 80 },
        "r": { "item": "home_hw", "chance": 60 }
      },
      "place_monsters": [ { "monster": "GROUP_ZOMBIE", "x": [ 1, 6 ], "y": [ 4, 14 ], "density": 0.03 } ]
    }
  },
  {
    "type": "mapgen",
    "method": "json",
    "om_terrain": [ "urban_19_3" ],
    "weight": 250,
    "object": {
      "fill_ter": "t_floor",
      "rows": [
        ",,,,,,,,,,,,,,,,,,,,,,,,",
        ",iinnninnninnninnnninnni",
        ",i,,,,,,,,,,,,,,,,,,,,,,",
        ",N,,,,,,,,,,|------|----",
        ",N,,,,,,,,|w|CCooCf|u   ",
        ",N,,,,,,,,wS2222222|u   ",
        ",i,,,^,,,,wS2222C22|    ",
        ",N,,,,,,,,|w|-|2C22+    ",
        ",N,,,,,,,,,,| +222j|--| ",
        ",N,,,,,,,,,,|<|2222+ r| ",
        ",i,,,,,,,,|w|-|+IiI|--| ",
        ",N,,,,,,,,wc    IFI|>>|-",
        ",N,,,,,,,,wc            ",
        ",i,,,,,,,,|w|A          ",
        ",N,,,,,,,,,,|tA  At     ",
        ",N,,,,,,,,,,|-w-w-w-11-w",
        ",N,,,,,,,,,,''''''''''''",
        ",i^,,,,,,,,,''''''''''''",
        ",N,,,,,,,,,,,,,,,,,,;;,,",
        ",N,,,,,,##,,,,,,,,,,;;,,",
        ",N,,,,,,##,,,,,,,,,,;;,,",
        ",i,,,,,,,,,,,,^,,,,i;;i,",
        ",iinnninnninnninnnii;;ii",
        ",,,,,,,,,,,,,,,,,,,,;;,,"
      ],
      "palettes": [ "acidia_residential_commercial_palette" ],
      "items": {
        " ": { "item": "livingroom", "chance": 2 },
        "A": { "item": "livingroom", "chance": 15 },
        "C": { "item": "kitchen", "chance": 25 },
        "c": { "item": "livingroom", "chance": 25 },
        "f": { "item": "SUS_fridge", "chance": 70 },
        "j": { "item": "cannedfood", "chance": 50 },
        "o": { "item": "oven", "chance": 30 },
        "r": { "item": "cleaning", "chance": 60 },
        "t": { "item": "coffee_table", "chance": 25 },
        "u": { "item": "dining", "chance": 70 }
      },
      "place_monsters": [ { "monster": "GROUP_ZOMBIE", "x": [ 1, 22 ], "y": [ 1, 22 ], "density": 0.15 } ]
    }
  },
  {
    "type": "mapgen",
    "method": "json",
    "om_terrain": [ "urban_19_4" ],
    "weight": 250,
    "object": {
      "fill_ter": "t_floor",
      "rows": [
        ",,,,,,,,,,,,,,,,,,,,,,,,",
        "|www|innninnninnninnnii,",
        "wcccw,,,,,,,,,###,,,,,i,",
        "|   |--|,,,,,,#P#,,,,,N,",
        "      t|,,,,,,###,,,,,N,",
        " htth t|<,,,,,,,,,,^,,N,",
        " htth t|`,,,|vvv|,,,,,i,",
        " htth u|q,,,v:::v,,,,,N,",
        " htth u|q,,,v:::v,##,,N,",
        "     |||,,,,v:::v,##,,N,",
        "     + +,,,,v:::v,,,,,i,",
        "-|+|---|,,,,|v+v|,,,,,N,",
        " | +222|,,,,,,,,,,,,,,N,",
        "   |SCT|,,,,,,,,,,,,^,i,",
        " |+|---|,,,,,,,,,,,,,,N,",
        "-|     |w|,,,,,,,,,,,,N,",
        "'|O   dd6w,,,,,##,,,,,N,",
        "'wO    hdw,,,,,##,,,,,i,",
        ",|w|   |w|,,,,,,,,,,,,N,",
        ",,,w   w,,,,,,,^,,,,,,N,",
        ",,,|-w-|,,,,,,,,,,,,,,N,",
        ",,,,,,,,,,,,,,,,,,,,,,i,",
        "nnninnninnnninnninnnnii,",
        ",,,,,,,,,,,,,,,,,,,,,,,,"
      ],
      "palettes": [ "acidia_residential_commercial_palette" ],
      "toilets": { "T": {  } },
      "items": {
        " ": { "item": "livingroom", "chance": 2 },
        "2": { "item": "softdrugs", "chance": 10 },
        ":": { "item": "tools_earthworking", "chance": 10 },
        "C": { "item": "cleaning", "chance": 10 },
        "O": { "item": "homebooks", "chance": 60 },
        "c": { "item": "livingroom", "chance": 25 },
        "d": { "item": "office", "chance": 40 },
        "q": { "item": "trash", "chance": 50 },
        "t": { "item": "dining", "chance": 25 }
      },
      "place_monsters": [ { "monster": "GROUP_ZOMBIE", "x": [ 1, 22 ], "y": [ 1, 22 ], "density": 0.15 } ]
    }
  },
  {
    "type": "mapgen",
    "method": "json",
    "om_terrain": [ "urban_19_5" ],
    "weight": 250,
    "object": {
      "fill_ter": "t_floor",
      "rows": [
        "........................",
        "........................",
        "........................",
        "............|--w---w--|-",
        "..........|w|  ebbbe  |r",
        "..........wc    bbb   |+",
        "..........wc    bbb   | ",
        "..........|w|         + ",
        "............|      |--| ",
        "............|u     + O| ",
        "..........|w|---IiI|--| ",
        "..........wc   uIFI|<<| ",
        "..........wc            ",
        "..........|w|A        |+",
        "............|tA  tA|>>| ",
        "............|-w-w-w|--|w",
        "............RRRRRRRRRRRR",
        "............RRRRRRRRRRRR",
        "........................",
        "........................",
        "........................",
        "........................",
        "........................",
        "........................"
      ],
      "palettes": [ "acidia_residential_commercial_palette" ],
      "items": {
        " ": { "item": "livingroom", "chance": 2 },
        "A": { "item": "livingroom", "chance": 15 },
        "O": { "item": "dresser", "chance": 60 },
        "b": { "item": "bed", "chance": 60 },
        "c": { "item": "livingroom", "chance": 25 },
        "e": { "item": "dresser", "chance": 60 },
        "r": { "item": "cleaning", "chance": 60 },
        "t": { "item": "coffee_table", "chance": 25 }
      },
      "place_monsters": [ { "monster": "GROUP_ZOMBIE", "x": [ 13, 22 ], "y": [ 4, 14 ], "density": 0.09 } ]
    }
  },
  {
    "type": "mapgen",
    "method": "json",
    "om_terrain": [ "urban_19_6" ],
    "weight": 250,
    "object": {
      "fill_ter": "t_floor",
      "rows": [
        "........................",
        "|www|...................",
        "wcccw...................",
        "|   |--|................",
        "|g   OO|................",
        "|O     w................",
        "|O    O|....RRRRR.......",
        "|O  A O|`...RRRRR.......",
        "|O  t  w....RRRRR.......",
        "|   A O|....RRRRR.......",
        "+     O|....RRRRR.......",
        "|      w....RRRRR.......",
        "|OOOOOO|................",
        "|------|................",
        "     OO|................",
        "-|     |w|..............",
        "R|  d6d  w..............",
        "Rw   h   w..............",
        ".|w|   |w|..............",
        "...w   w................",
        "...|-w-|................",
        "........................",
        "........................",
        "........................"
      ],
      "palettes": [ "acidia_residential_commercial_palette" ],
      "items": {
        " ": { "item": "livingroom", "chance": 2 },
        "A": { "item": "livingroom", "chance": 15 },
        "O": { "item": "homebooks", "chance": 60 },
        "c": { "item": "livingroom", "chance": 25 },
        "d": { "item": "office", "chance": 40 },
        "g": { "item": "alcohol", "chance": 60 },
        "t": { "item": "coffee_table", "chance": 25 }
      },
      "place_monsters": [ { "monster": "GROUP_ZOMBIE", "x": [ 1, 6 ], "y": [ 4, 14 ], "density": 0.09 } ]
    }
  },
  {
    "type": "mapgen",
    "method": "json",
    "om_terrain": [ "urban_19_7" ],
    "weight": 250,
    "object": {
      "fill_ter": "t_floor",
      "rows": [
        "........................",
        "........................",
        "........................",
        "............|------|--|-",
        "..........RR| ebbe |BB|e",
        "..........RR|  bb  |2T|e",
        "..........RR|      |22+ ",
        "..........RR|h     |SS| ",
        "............|t     |--| ",
        "............|h     +  + ",
        "..........RR|   I'I|  | ",
        "..........RR|  eIFI|  |-",
        "..........RR|+|-IiI|  + ",
        "..........RR| |B222+  |+",
        "............|r|BTCS|<<|>",
        "............|-|-w-w|--|-",
        "........................",
        "........................",
        "........................",
        "........................",
        "........................",
        "........................",
        "........................",
        "........................"
      ],
      "palettes": [ "acidia_residential_commercial_palette" ],
      "toilets": { "T": {  } },
      "items": {
        " ": { "item": "livingroom", "chance": 2 },
        "2": { "item": "softdrugs", "chance": 10 },
        "b": { "item": "bed", "chance": 60 },
        "e": { "item": "dresser", "chance": 60 },
        "r": { "item": "bedroom", "chance": 60 },
        "t": { "item": "coffee_table", "chance": 25 }
      },
      "place_monsters": [ { "monster": "GROUP_ZOMBIE", "x": [ 13, 22 ], "y": [ 4, 14 ], "density": 0.09 } ]
    }
  },
  {
    "type": "mapgen",
    "method": "json",
    "om_terrain": [ "urban_19_8" ],
    "weight": 250,
    "object": {
      "fill_ter": "t_floor",
      "rows": [
        "........................",
        "|www|...................",
        "wcccw...................",
        "|   |--|................",
        "     ee|................",
        "       w................",
        "       |`...............",
        "       |................",
        "  bbb  w................",
        "  bbb  |................",
        " ebbbe |................",
        "----|-+-................",
        "   u|r |................",
        "|   |r |................",
        "|   |--|................",
        "||   OO|w|..............",
        ".w       w..............",
        ".w       w..............",
        ".|w| h |w|..............",
        "...wd6dw................",
        "...|-w-|................",
        "........................",
        "........................",
        "........................"
      ],
      "palettes": [ "acidia_residential_commercial_palette" ],
      "items": {
        " ": { "item": "livingroom", "chance": 2 },
        "b": { "item": "bed", "chance": 60 },
        "d": { "item": "office", "chance": 40 },
        "e": { "item": "dresser", "chance": 60 },
        "r": { "item": "bedroom", "chance": 60 },
        "u": { "item": "cleaning", "chance": 70 }
      },
      "place_monsters": [ { "monster": "GROUP_ZOMBIE", "x": [ 1, 6 ], "y": [ 4, 14 ], "density": 0.09 } ]
    }
  },
  {
    "type": "mapgen",
    "method": "json",
    "om_terrain": [ "urban_19_9" ],
    "weight": 250,
    "object": {
      "fill_ter": "t_floor",
      "rows": [
        "........................",
        "........................",
        "........................",
        "............888888888888",
        "............8RRRRRRRRRRR",
        "............8RRRRRRRRRRR",
        "............8RRRRRRRRRRR",
        "............8RRRRRRRRR|-",
        "............8RRRRRRRRR| ",
        "............8RRRRRRRRRw ",
        "............8RRRRRRRRR| ",
        "............8RRiiiRRRRw ",
        "............8RRRRRRRRR| ",
        "............8RRRRRRRRR|-",
        "............8RRRRRRRRR|<",
        "............8888888888|-",
        "........................",
        "........................",
        "........................",
        "........................",
        "........................",
        "........................",
        "........................",
        "........................"
      ],
      "palettes": [ "acidia_residential_commercial_palette" ]
    }
  },
  {
    "type": "mapgen",
    "method": "json",
    "om_terrain": [ "urban_19_10" ],
    "weight": 250,
    "object": {
      "fill_ter": "t_floor",
      "rows": [
        "........................",
        "88888...................",
        "8RRR8...................",
        "8RRR8888................",
        "RRRRRRR8................",
        "RRRRRRR8................",
        "RRRRRRR8................",
        "-w---w-|`...............",
        " ebbbeL|................",
        "  bbb  w................",
        "  bbb  |................",
        "       w................",
        "       |................",
        "--+-|+-|................",
        "    | r|................",
        "-|  |--|w|..............",
        ".w  AtA  w..............",
        ".w       w..............",
        ".|w|   |w|..............",
        "...wcccw................",
        "...|-w-|................",
        "........................",
        "........................",
        "........................"
      ],
      "palettes": [ "acidia_residential_commercial_palette" ],
      "items": {
        " ": { "item": "livingroom", "chance": 2 },
        "A": { "item": "livingroom", "chance": 15 },
        "L": { "item": "homeguns", "chance": 70 },
        "b": { "item": "bed", "chance": 60 },
        "c": { "item": "livingroom", "chance": 25 },
        "e": { "item": "dresser", "chance": 60 },
        "r": { "item": "bedroom", "chance": 60 },
        "t": { "item": "coffee_table", "chance": 25 }
      },
      "place_monsters": [ { "monster": "GROUP_ZOMBIE", "x": [ 1, 6 ], "y": [ 8, 14 ], "density": 0.06 } ]
    }
  },
  {
    "type": "mapgen",
    "method": "json",
    "om_terrain": [ "urban_19_11" ],
    "weight": 250,
    "object": {
      "fill_ter": "t_floor",
      "rows": [
        "........................",
        "........................",
        "........................",
        "........................",
        "........................",
        "........................",
        "........................",
        "......................41",
        "......................4R",
        "......................4R",
        "......................4R",
        "...............*R*....4R",
        "......................4R",
        "......................4R",
        "......................4R",
        "......................43",
        "........................",
        "........................",
        "........................",
        "........................",
        "........................",
        "........................",
        "........................",
        "........................"
      ],
      "palettes": [ "acidia_residential_roof_palette" ]
    }
  },
  {
    "type": "mapgen",
    "method": "json",
    "om_terrain": [ "urban_19_12" ],
    "weight": 250,
    "object": {
      "fill_ter": "t_floor",
      "rows": [
        "........................",
        "........................",
        "........................",
        "........................",
        "........................",
        "........................",
        "........................",
        "11111115................",
        "RRRRRRR2................",
        "DRRRRRR2................",
        "RRRRRRR2................",
        "RRRRRRR2................",
        "RRRRRRR2................",
        "RRRRRRR2................",
        "RRRRRRR2................",
        "33RRRRR222..............",
        ".3RRRRRRR2..............",
        ".3RRRRRRR2..............",
        ".333RRR322..............",
        "...3RRR3................",
        "...33333................",
        "........................",
        "........................",
        "........................"
      ],
      "palettes": [ "acidia_residential_roof_palette" ]
    }
  }
]
