[
  {
    "type": "mapgen",
    "method": "json",
    "om_terrain": [ [ "urban_11_1", "urban_11_2" ] ],
    "object": {
      "fill_ter": "t_floor",
      "rows": [
        "................................................",
        ".............................................[..",
        ".....[..................`````.u.................",
        "..........%%%.....%%%%..`````...........%%%.....",
        "..........%########oo#####*#o#############%.....",
        "..........%#12O34,hffh,,Y|  WZ|'NN'''''''#%.....",
        "...........o5,,,,,hffh,,,+    +'A''''''''o......",
        "..........^#7,,,,,,,,,,,,||||||''''''''''#^.....",
        "...........#F,,,,,,,,66|,|S8tB|''''Á''''q#......",
        "...........#|||JJJ|  ||| |,,,B|'''''''''q#......",
        "...........o   000    <| |+||||'''''''''q#......",
        "...........#x   l H        |q'+''''''''''#%.....",
        "...[.......#x   l H        ||||''''''''''o%.....",
        "...........#yTE  HH   L    + Q|&'''''''''#%.....",
        "..........%#####o#######o#*#####========##......",
        "..........%%..%..%..%..%.```...&________........",
        ".........................```````________.%......",
        ".........................```````________........",
        "....................[...........________.%...[..",
        ".......[........................________........",
        "..............................%.________.%......",
        "................................________........",
        "..............[...............%.________.%......",
        "...............................p________........"
      ],
      "palettes": [
        "standard_domestic_palette",
        "standard_domestic_lino_kitchen",
        "standard_domestic_lino_bathroom",
        "standard_domestic_landscaping_palette"
      ],
      "terrain": {
        "=": "t_door_metal_locked",
        "&": "t_gates_control_brick",
        "'": "t_thconc_floor",
        "q": "t_thconc_floor",
        "N": "t_thconc_floor",
        "A": "t_thconc_floor",
        "Á": "t_thconc_floor",
        ",": "t_linoleum_gray",
        "Y": "t_linoleum_gray",
        "h": "t_linoleum_gray",
        "f": "t_linoleum_gray",
        "Q": "t_floor",
        "J": "t_floor"
      },
      "furniture": { "0": "f_stool" },
      "place_loot": [ { "item": "television", "x": 12, "y": 11, "chance": 100 }, { "item": "stereo", "x": 12, "y": 12, "chance": 65 } ],
      "vehicles": { "Á": { "vehicle": "suburban_home", "chance": 100, "rotation": 270 } }
    }
  },
  {
    "type": "mapgen",
    "method": "json",
    "om_terrain": [ [ "urban_11_3", "urban_11_4" ] ],
    "object": {
      "fill_ter": "t_floor",
      "rows": [
        "~~~~~~~~~~~~~~~~~~~~~~~~~~~~~~~~~~~~~~~~~~~~~~~~",
        "~~~~~~~~~~~~~~~~~~~~~~~~~~~~~~~~~~~~~~~~~~~~~~~~",
        "~~~~~~~~~~~~~~~~~~~~~~~~~~~~~~~~~~~~~~~~~~~~~~~~",
        "~~~~~~~~~~~~~~~~~~~~~~~~~~~~~~~~~~~~~~~~~~~~~~~~",
        "~~~~~~~~~~~&&&&&&&&&&&&&&&&&&&&&&&&&&&&&&&~~~~~~",
        "~~~~~~~~~~~&&&&#oo#&&&&&#ooo#&&&&&#oo#&&&&~~~~~~",
        "~~~~~~~~~~~#####ii#######BBB#######HH#####~~~~~~",
        "~~~~~~~~~~~#¤@@¤    R|D|t,,,,,,+        ¤#~~~~~~",
        "~~~~~~~~~~^# @@      + |,,,,,|||D      @@#^~~~~~",
        "~~~~~~~~~~~o         |||8S8S8| +       @@o~~~~~~",
        "~~~~~~~~~~~#         |>||||||| |Ih      ¤#~~~~~~",
        "~~~~~~~~~~~#Dbdd     +         |III   db #~~~~~~",
        "~~~~~~~~~~~#####HH#######iii#######ii#####~~~~~~",
        "~~~~~~~~~~~&&&&#oo#&&&&&#ooo#&&&&&#oo#&&&&~~~~~~",
        "~~~~~~~~~~~&&&&&&&&&&&&&&&&&&&&&&&&&&&&&&&~~~~~~",
        "~~~~~~~~~~~~~~~~~~~~~~~~~~~~~~~~~~~~~~~~~~~~~~~~",
        "~~~~~~~~~~~~~~~~~~~~~~~~~~~~~~~~~~~~~~~~~~~~~~~~",
        "~~~~~~~~~~~~~~~~~~~~~~~~~~~~~~~~~~~~~~~~~~~~~~~~",
        "~~~~~~~~~~~~~~~~~~~~~~~~~~~~~~~~~~~~~~~~~~~~~~~~",
        "~~~~~~~~~~~~~~~~~~~~~~~~~~~~~~~~~~~~~~~~~~~~~~~~",
        "~~~~~~~~~~~~~~~~~~~~~~~~~~~~~~~~~~~~~~~~~~~~~~~~",
        "~~~~~~~~~~~~~~~~~~~~~~~~~~~~~~~~~~~~~~~~~~~~~~~~",
        "~~~~~~~~~~~~~~~~~~~~~~~~~~~~~~~~~~~~~~~~~~~~~~~~",
        "~~~~~~~~~~~~~~~~~~~~~~~~~~~~~~~~~~~~~~~~~~~~~~~~"
      ],
      "palettes": [ "standard_domestic_palette", "standard_domestic_lino_bathroom" ],
      "terrain": { ",": "t_linoleum_gray", "~": "t_open_air", "&": "t_shingle_flat_roof" }
    }
  },
  {
    "type": "mapgen",
    "method": "json",
    "om_terrain": [ [ "urban_11_5", "urban_11_6" ] ],
    "object": {
      "fill_ter": "t_shingle_flat_roof",
      "rows": [
        "                                                ",
        "                                                ",
        "                                                ",
        "                                                ",
        "                                                ",
        "               ----     -----     ----          ",
        "           -----..-------...-------..-----      ",
        "           5................=............5      ",
        "           -...N....................&....-      ",
        "           -.............................-      ",
        "           -.............................-      ",
        "           -.............................-      ",
        "           -----..-------...-------..-----      ",
        "               ----     -----     ----          ",
        "                                                ",
        "                                                ",
        "                                                ",
        "                                                ",
        "                                                ",
        "                                                ",
        "                                                ",
        "                                                ",
        "                                                ",
        "                                                "
      ],
      "palettes": [ "roof_palette" ],
      "terrain": { ".": "t_shingle_flat_roof" }
    }
  }
]
