[
  {
    "type": "mapgen",
    "method": "json",
    "om_terrain": [ "urban_19_1" ],
    "weight": 250,
    "object": {
      "fill_ter": "t_thconc_floor",
      "rows": [
        "                        ",
        "                        ",
        "                        ",
        "                #####   ",
        "                #...#   ",
        "              ###...### ",
        "              #.......# ",
        "              #.......# ",
        "              ###.....##",
        "                ##.####.",
        "                #...#...",
        "                #.......",
        "                ##.#####",
        "                #.......",
        "                #.......",
        "                #L......",
        "                #L...#..",
        "              ###...###.",
        "              #<+....#..",
        "              ###.......",
        "                ####...#",
        "                   #UUU#",
        "                   #####",
        "                        "
      ],
      "palettes": [ "basement_empty" ],
      "terrain": { "#": "t_brick_wall" },
      "furniture": { "L": "f_locker" },
      "items": { "L": { "item": "cleaning", "chance": 70, "repeat": [ 1, 2 ] } }
    }
  },
  {
    "type": "mapgen",
    "method": "json",
    "om_terrain": [ "urban_19_1" ],
    "weight": 150,
    "object": {
      "fill_ter": "t_thconc_floor",
      "rows": [
        "                        ",
        "                        ",
        "                        ",
        "                #####   ",
        "                #.?1#   ",
        "                #./1### ",
        "                #..2.o# ",
        "                #121..# ",
        "                #.....##",
        "                ##+####.",
        "                #LLL#...",
        "                #...+...",
        "                ##+#####",
        "                #.......",
        "                #.......",
        "                #L......",
        "                #L...#..",
        "              ###...###.",
        "              #<+....#..",
        "              ###.......",
        "                ####...#",
        "                   #UUU#",
        "                   #####",
        "                        "
      ],
      "palettes": [ "basement_empty" ],
      "terrain": { "#": "t_brick_wall" },
      "furniture": {
        "L": "f_locker",
        "o": "f_crate_o",
        "1": "f_large_canvas_wall",
        "2": "f_large_canvas_door",
        "?": "f_autodoc",
        "/": "f_autodoc_couch"
      },
      "place_monsters": [ { "monster": "GROUP_LAB_CYBORG", "x": [ 17, 21 ], "y": [ 4, 8 ], "density": 0.03 } ],
      "items": { "L": { "item": "cleaning", "chance": 70, "repeat": [ 1, 2 ] }, "?": { "item": "autodoc_supplies", "chance": 100 } },
      "item": { "o": { "item": "bot_nursebot", "chance": 100 }, "/": { "item": "bot_prototype_cyborg", "chance": 10 } }
    }
  },
  {
    "type": "mapgen",
    "method": "json",
    "om_terrain": [ "urban_19_2" ],
    "object": {
      "fill_ter": "t_thconc_floor",
      "rows": [
        "                        ",
        "                        ",
        "                        ",
        "                        ",
        "                        ",
        "                        ",
        "                        ",
        "                        ",
        "############            ",
        "......z...z#            ",
        "..........z###          ",
        ".....z.......#          ",
        "##..z........#          ",
        ".#..####+#####          ",
        ".#..#U...#<#            ",
        ".####U...+.#            ",
        "....#....#####          ",
        "....#.....F.g#          ",
        "....#........#          ",
        "....#JJZWJJ###          ",
        "############            ",
        "                        ",
        "                        ",
        "                        "
      ],
      "palettes": [ "basement_empty" ],
      "terrain": { "#": "t_brick_wall" }
    }
  },
  {
    "type": "mapgen",
    "method": "json",
    "om_terrain": [ [ "urban_19_3", "urban_19_4" ] ],
    "object": {
      "fill_ter": "t_floor",
      "rows": [
        ".........................p``....................",
        ".{{{{{{{{{{{{{{{{{{{{{{{{{``{{{{{{{{{{{{{{{{{{{.",
        ".{.......................{(({....[............{.",
        ".{..............##o##.....``..........%%......{.",
        ".{......[.......orrro.....``..........%%......{.",
        ".{............#o#rh #o#...``..................{.",
        ".{.....%%.....oP     Yo`````````````.........[{.",
        ".{.....%%.....oP      o`````````````..........{.",
        ".{............#o#RRy  ##o#**#o#o#o##..........{.",
        ".{..............#||||+|  L   EsE Es#..........{.",
        ".{.[............#tS8|             E#o#........{.",
        ".{..............#,,,+               yo........{.",
        ".{............``#||||+||||<<| a     yo........{.",
        ".{............``* +     Y|||||||+||#o#........{.",
        ".{..%%........``#||      |6,+,,,,|>#..........{.",
        ".{..%%..........#        ||||,,,,+ #..........{.",
        ".{..............# hffh   xx +,,J,||#o#........{.",
        ".{..........``### hffh      |,,J,,,,5o....[...{.",
        ".{..[.......``*># hffh     H|,,,,,,,no........{.",
        ".{..........``###      sHHHH|F43O21#o#...%%...{.",
        ".{.......u......####   #############.....%%...{.",
        ".{.................oycyo.........^............{.",
        ".{{{{{{{{{{{{{{{{{{#ooo#{{{{{{{{{{{{{{{{{{{{{{{.",
        "................................................"
      ],
      "palettes": [
        "standard_domestic_palette",
        "standard_domestic_lino_kitchen",
        "standard_domestic_lino_bathroom",
        "standard_domestic_landscaping_palette"
      ],
      "terrain": { "(": "t_chaingate_c", "{": "t_chainfence", ",": "t_linoleum_gray" },
      "place_loot": [ { "item": "television", "x": 25, "y": 16, "chance": 100 }, { "item": "stereo", "x": 25, "y": 16, "chance": 65 } ]
    }
  },
  {
    "type": "mapgen",
    "method": "json",
    "om_terrain": [ [ "urban_19_5", "urban_19_6" ] ],
    "object": {
      "fill_ter": "t_floor",
      "rows": [
        "~~~~~~~~~~~~~~~~~~~~~~~~~~~~~~~~~~~~~~~~~~~~~~~~",
        "~~~~~~~~~~~~~~~~~~~~~~~~~~~~~~~~~~~~~~~~~~~~~~~~",
        "~~~~~~~~~~~~~~~~~~~~~~~~~~~~~~~~~~~~~~~~~~~~~~~~",
        "~~~~~~~~~~~~~~~~##o##~~~~~~~~~~~~~~~~~~~~~~~~~~~",
        "~~~~~~~~~~~~~~~~orrro~~~~~~~~~~~~~~~~~~~~~~~~~~~",
        "~~~~~~~~~~~~~~#o#rhr#o#~~~~~~~~~~~~~~~~~~~~~~~~~",
        "~~~~~~~~~~~~~~oP     Yo~~~~~~~~~~~~~~~~~~~~~~~~~",
        "~~~~~~~~~~~~~~oP      o~~~~~~~~~~~~~~~~~~~~~~~~~",
        "~~~~~~~~~~~~~~#o#     ##o####o#o#o##~~~~~~~~~~~~",
        "~~~~~~~~~~~~~~~~#RRTE    |<<|EsE Es#~~~~~~~~~~~~",
        "~~~~~~~~~~~~~~~~#|||||||+|        E#o#~~~~~~~~~~",
        "~~~~~~~~~~~~~~~~#RR  RR|            yo~~~~~~~~~~",
        "~~~~~~~~~~~~~~~~o      | |>>| a     yo~~~~~~~~~~",
        "~~~~~~~~~~~~~~~~#R     + ||||||||||#o#~~~~~~~~~~",
        "~~~~~~~~~~~~~~~~#R E   | |D +     y#~~~~~~~~~~~~",
        "~~~~~~~~~~~~~~~~o  s  M| ||||     b#~~~~~~~~~~~~",
        "~~~~~~~~~~~~~~~~#R E  M| +         #o#~~~~~~~~~~",
        "~~~~~~~~~~~~~~&&#R    M| |          io~~~~~~~~~~",
        "~~~~~~~~~~~~~~&&o      |+|d  @@     io~~~~~~~~~~",
        "~~~~~~~~~~~~~~&&#Ty    |U|d ¤@@¤  T#o#~~~~~~~~~~",
        "~~~~~~~~~~~~~~~~####   #####o###o###~~~~~~~~~~~~",
        "~~~~~~~~~~~~~~~~~~~oysyo~~~~~~~~~~^~~~~~~~~~~~~~",
        "~~~~~~~~~~~~~~~~~~~#ooo#~~~~~~~~~~~~~~~~~~~~~~~~",
        "~~~~~~~~~~~~~~~~~~~~~~~~~~~~~~~~~~~~~~~~~~~~~~~~"
      ],
      "palettes": [ "standard_domestic_palette" ],
      "terrain": { "~": "t_open_air", "&": "t_shingle_flat_roof" }
    }
  },
  {
    "type": "mapgen",
    "method": "json",
    "om_terrain": [ [ "urban_19_7", "urban_19_8" ] ],
    "object": {
      "fill_ter": "t_floor",
      "rows": [
        "~~~~~~~~~~~~~~~~~~~~~~~~~~~~~~~~~~~~~~~~~~~~~~~~",
        "~~~~~~~~~~~~~~~~~~~~~~~~~~~~~~~~~~~~~~~~~~~~~~~~",
        "~~~~~~~~~~~~~~~~~~~~~~~~~~~~~~~~~~~~~~~~~~~~~~~~",
        "~~~~~~~~~~~~~~~~##o##~~~~~~~~~~~~~~~~~~~~~~~~~~~",
        "~~~~~~~~~~~~~~~~orrro~~~~~~~~~~~~~~~~~~~~~~~~~~~",
        "~~~~~~~~~~~~~~#o# hr#o#~~~~~~~~~~~~~~~~~~~~~~~~~",
        "~~~~~~~~~~~~~~oP    ? o~~~~~~~~~~~~~~~~~~~~~~~~~",
        "~~~~~~~~~~~~~~oP      o~~~~~~~~~~~~~~~~~~~~~~~~~",
        "~~~~~~~~~~~~~~#o#RR   #######o#o####~~~~~~~~~~~~",
        "~~~~~~~~~~~~~~~~#|||  y|<|>>|8StB|D#~~~~~~~~~~~~",
        "~~~~~~~~~~~~~~~~# D|   |+|  +,,,B| #&&~~~~~~~~~~",
        "~~~~~~~~~~~~~~~~# v|E    +  ||||||+#&&~~~~~~~~~~",
        "~~~~~~~~~~~~~~~~#+||||||||  | a  b #&&~~~~~~~~~~",
        "~~~~~~~~~~~~~~~~#  dbd   |  |      o&&~~~~~~~~~~",
        "~~~~~~~~~~~~~~~~#        +  +     d#~~~~~~~~~~~~",
        "~~~~~~~~~~~~~~~~o¤       ||||y    d#~~~~~~~~~~~~",
        "~~~~~~~~~~~~~~~~#@@      |8S|      o&&~~~~~~~~~~",
        "~~~~~~~~~~~~~~~~#@@      +,,|      #&&~~~~~~~~~~",
        "~~~~~~~~~~~~~~~~o¤       |t,|  @@  #&&~~~~~~~~~~",
        "~~~~~~~~~~~~~~~~#T      y|BB|T¤@@¤ #&&~~~~~~~~~~",
        "~~~~~~~~~~~~~~~~#### l #######o##o##~~~~~~~~~~~~",
        "~~~~~~~~~~~~~~~~~~~oHHHo~~~~~~~~~~~^~~~~~~~~~~~~",
        "~~~~~~~~~~~~~~~~~~~#ooo#~~~~~~~~~~~~~~~~~~~~~~~~",
        "~~~~~~~~~~~~~~~~~~~~~~~~~~~~~~~~~~~~~~~~~~~~~~~~"
      ],
      "palettes": [ "standard_domestic_palette", "standard_domestic_lino_bathroom" ],
      "terrain": { "~": "t_open_air", "&": "t_shingle_flat_roof", ",": "t_linoleum_gray" },
      "furniture": { "?": "f_shredder" }
    }
  },
  {
    "type": "mapgen",
    "method": "json",
    "om_terrain": [ [ "urban_19_9", "urban_19_10" ] ],
    "object": {
      "fill_ter": "t_floor",
      "rows": [
        "~~~~~~~~~~~~~~~~~~~~~~~~~~~~~~~~~~~~~~~~~~~~~~~~",
        "~~~~~~~~~~~~~~~~~~~~~~~~~~~~~~~~~~~~~~~~~~~~~~~~",
        "~~~~~~~~~~~~~~~~~~~~~~~~~~~~~~~~~~~~~~~~~~~~~~~~",
        "~~~~~~~~~~~~~~~~##o##~~~~~~~~~~~~~~~~~~~~~~~~~~~",
        "~~~~~~~~~~~~~~~~oy yo~~~~~~~~~~~~~~~~~~~~~~~~~~~",
        "~~~~~~~~~~~~~~#o#   #o#~~~~~~~~~~~~~~~~~~~~~~~~~",
        "~~~~~~~~~~~~~~o       o~~~~~~~~~~~~~~~~~~~~~~~~~",
        "~~~~~~~~~~~~~~o  EsE  o~~~~~~~~~~~~~~~~~~~~~~~~~",
        "~~~~~~~~~~~~~~#o#|||  ####----------~~~~~~~~~~~~",
        "~~~~~~~~~~~~~~~~#D |    >#&&&&&&&&&-~~~~~~~~~~~~",
        "~~~~~~~~~~~~~~~~#|+||+|||#&&&&&&&&&-~~~~~~~~~~~~",
        "~~~~~~~~~~~~~~~~#       y#&&&&&&&&&-~~~~~~~~~~~~",
        "~~~~~~~~~~~~~~~~oIh      o&&&&?&&&&-~~~~~~~~~~~~",
        "~~~~~~~~~~~~~~~~#I      b#&&&&&&&&&-~~~~~~~~~~~~",
        "~~~~~~~~~~~~~~~~o   @@   o&&&&&&&&&-~~~~~~~~~~~~",
        "~~~~~~~~~~~~~~~~#T ¤@@¤dd#&&&&&&&&&-~~~~~~~~~~~~",
        "~~~~~~~~~~~~~~~~###o##o###&&&&&&&&&-~~~~~~~~~~~~",
        "~~~~~~~~~~~~~~~~-^&&&&&&&&&&&&&&&&&-~~~~~~~~~~~~",
        "~~~~~~~~~~~~~~~~-&&&&&&&&&&&&&&&&&&-~~~~~~~~~~~~",
        "~~~~~~~~~~~~~~~~-&&&&&&&&&&&&&&&&&&-~~~~~~~~~~~~",
        "~~~~~~~~~~~~~~~~----&&&------------!~~~~~~~~~~~~",
        "~~~~~~~~~~~~~~~~~~~-&&&-~~~~~~~~~~~~~~~~~~~~~~~~",
        "~~~~~~~~~~~~~~~~~~~-----~~~~~~~~~~~~~~~~~~~~~~~~",
        "~~~~~~~~~~~~~~~~~~~~~~~~~~~~~~~~~~~~~~~~~~~~~~~~"
      ],
      "palettes": [ "standard_domestic_palette" ],
      "terrain": { "~": "t_open_air", "&": "t_shingle_flat_roof", "?": "t_shingle_flat_roof", "!": "t_gutter_drop", "-": "t_gutter" },
      "furniture": { "?": "f_chimney" }
    }
  },
  {
    "type": "mapgen",
    "method": "json",
    "om_terrain": [ [ "urban_19_11", "urban_19_12" ] ],
    "object": {
      "fill_ter": "t_shingle_flat_roof",
      "rows": [
        "                                                ",
        "                                                ",
        "                                                ",
        "                -----                           ",
        "                -...-                           ",
        "              ---...---                         ",
        "              -.......-                         ",
        "              -.......-                         ",
        "              ---.....----                      ",
        "                -........-                      ",
        "                -........-                      ",
        "                -....N...-                      ",
        "                -........-                      ",
        "                -..:.....-                      ",
        "                -........-                      ",
        "                -........-                      ",
        "                -5--------                      ",
        "                                                ",
        "                                                ",
        "                                                ",
        "                                                ",
        "                                                ",
        "                                                ",
        "                                                "
      ],
      "palettes": [ "roof_palette" ],
      "terrain": { ".": "t_shingle_flat_roof" }
    }
  }
]
