[
  {
    "type": "mapgen",
    "method": "json",
    "om_terrain": [ "urban_21_1" ],
    "object": {
      "fill_ter": "t_floor",
      "rows": [
        "........................",
        ".############...........",
        ".#~~~~~~~~~~#^..........",
        ".o~~~~~~~~~~####........",
        ".#~~~~~~~~~~~~q#........",
        ".#~~~~~~~~~~~~q#.[......",
        ".#~~~~~~~~~~####........",
        ".#~~~~~~~~~~*```````````",
        ".o~~~~~~~~~~#...........",
        ".#~~~~~~~~~&#.....####o#",
        ".##========##.....#     ",
        "...________&......#  hff",
        "...________.......#  hff",
        "...________.......#     ",
        "...________...[...#|    ",
        "...________.......#     ",
        "...________.......#x    ",
        "...________.......#x  l ",
        "...________.......#x  l ",
        "...________.......#     ",
        "...________.......####o#",
        "...________.............",
        "...________.....[.......",
        "...________............."
      ],
      "palettes": [
        "standard_domestic_palette",
        "standard_domestic_lino_kitchen",
        "standard_domestic_lino_bathroom",
        "standard_domestic_landscaping_palette"
      ],
      "terrain": { "=": "t_door_metal_locked", "&": "t_gates_control_brick", "~": "t_thconc_floor", "q": "t_thconc_floor" },
      "place_loot": [ { "item": "television", "x": 19, "y": 17, "chance": 100 } ],
      "place_monsters": [ { "monster": "GROUP_ZOMBIE", "x": [ 1, 22 ], "y": [ 1, 22 ], "density": 0.09 } ],
      "place_vehicles": [ { "vehicle": "suburban_home", "x": 7, "y": 6, "chance": 100, "rotation": 90 } ]
    }
  },
  {
    "type": "mapgen",
    "method": "json",
    "om_terrain": [ "urban_21_2" ],
    "object": {
      "fill_ter": "t_floor",
      "rows": [
        "........................",
        "........00.00.00.00.....",
        "[.......00.00.00.00.....",
        "........00.00.00.00.....",
        "........00.00.00.00.....",
        "........00.00.00.00.....",
        ".....................[..",
        "``````````..............",
        ".........`..............",
        "o########*####o####o##^.",
        "     |12,,,5|t,B|   d#..",
        "fh   |O,,,,4|S,B|  @@#..",
        "fh   |3,,,,F||+||  @@#..",
        "     +,,6,,,,,,,+   d#..",
        "||||||||||||+||+|||+|#..",
        " E    RR      | |D| D#..",
        "             E| |+|||#..",
        " H           s|      o..",
        " H           E|     @#..",
        "HH            |@@   @#..",
        "####a###*########o####..",
        "...###.```..............",
        "........`...............",
        "........`p.............."
      ],
      "palettes": [
        "standard_domestic_palette",
        "standard_domestic_lino_kitchen",
        "standard_domestic_lino_bathroom",
        "standard_domestic_landscaping_palette"
      ],
      "terrain": { "0": "t_dirtmound", ",": "t_linoleum_gray" },
      "place_monsters": [ { "monster": "GROUP_ZOMBIE", "x": [ 1, 22 ], "y": [ 1, 22 ], "density": 0.09 } ]
    }
  },
  {
    "type": "mapgen",
    "method": "json",
    "om_terrain": [ "urban_21_3" ],
    "weight": 250,
    "object": {
      "fill_ter": "t_floor",
      "rows": [
        "........................",
        ".111111111111...........",
        ".4RRRRRRRRRR5...........",
        ".4RRGRRRRRRR1111........",
        ".4RRRRRRRRRRRRR2........",
        ".4RRRRRRRRRRRRR2........",
        ".4RRRRRRRRRR3333........",
        ".4RRRRRRRRRR2...........",
        ".4RRRRRRRRRR2...........",
        ".333333333333.....111111",
        "..................4RRRRR",
        "..................4RRRRR",
        "..................4RRRRR",
        "..................4RRRRR",
        "..................4RRRRR",
        "..................4RRRRR",
        "..................4RRRRR",
        "..................4RRRR&",
        "..................4RRRRR",
        "..................4RRRRR",
        "..................333333",
        "........................",
        "........................",
        "........................"
      ],
      "palettes": [ "acidia_residential_roof_palette" ]
    }
  },
  {
    "type": "mapgen",
    "method": "json",
    "om_terrain": [ "urban_21_4" ],
    "weight": 250,
    "object": {
      "fill_ter": "t_floor",
      "rows": [
        "........................",
        "........................",
        "........................",
        "........................",
        "........................",
        "........................",
        "........................",
        "........................",
        "........................",
        "1111111111111111111115..",
        "RRRRRRRRRRRRRRRRRRRRR2..",
        "RRRRRRRRRRRRRR!RRRRRR2..",
        "RRRRGRRRRRRRRRRRRRRRR2..",
        "RRRRRRRRRRRRRRRRRRRRR2..",
        "RRRRRRRRRRRRRRRRRRRRR2..",
        "RRRRRRRRRRRRRRRRRRRRR2..",
        "RRRRRRRRRRRRRRRRRRRRR2..",
        "RRRRRRRRRRRRRRRRR&RRR2..",
        "RRRRRR^RRRRRRRRRRRRRR2..",
        "RRRRRRRRRRRRRRRRRRRRR2..",
        "3333RRRRR3333333333333..",
        "...3333333..............",
        "........................",
        "........................"
      ],
      "palettes": [ "acidia_residential_roof_palette" ]
    }
  }
]
