[
  {
    "type": "mapgen",
    "method": "json",
    "om_terrain": [ [ "urban_18_1", "urban_18_2" ] ],
    "object": {
      "fill_ter": "t_thconc_floor",
      "rows": [
        "                                                ",
        "                                                ",
        "                                                ",
        "                                                ",
        "                               #####            ",
        "            #####              #...#            ",
        "            #g.F#            ###...###          ",
        "          ###...###          #.......#          ",
        "          #JJ...UU############.......#          ",
        "        ###J..........zz.............#          ",
        "        #Z........###..z...........###          ",
        "        #W........+<#z.............#            ",
        "        ###.......#####............#            ",
        "          #.##.##.#U.L#............#            ",
        "          #.......#U.L#............#            ",
        "          #.......##+##............#            ",
        "          #........................#            ",
        "          #.......##########...#####            ",
        "          #.......#        #...#                ",
        "          #########        #####                ",
        "                                                ",
        "                                                ",
        "                                                ",
        "                                                "
      ],
      "palettes": [ "basement_empty" ],
      "terrain": { "#": "t_brick_wall" },
      "furniture": { "L": "f_locker" },
      "items": { "L": { "item": "cleaning", "chance": 70, "repeat": [ 1, 2 ] } }
    }
  },
  {
    "type": "mapgen",
    "method": "json",
    "om_terrain": [ [ "urban_18_3", "urban_18_4" ] ],
    "object": {
      "fill_ter": "t_floor",
      "rows": [
        "......................p``.......................",
        ".{{{{{{{{{{{{{{{{{{{{{{``{{{{{{{{{{{{{{{{{{{{{{.",
        ".{....................{(({....................{.",
        ".{.....................``................[....{.",
        ".{.....................``......##o##..........{.",
        ".{....[.....#o#o#......``......oyyyo..........{.",
        ".{..........oiiio..``````````###   ###........{.",
        ".{........###   ###``````````#  hhh  #........{.",
        ".{........#       ##o##**##o## hfffh o........{.",
        ".{......#o# HHHHT +             hhh  #........{.",
        ".{......or  Hll  E||||L      |+|   ###........{.",
        ".{......orh       +>|<    #'#|U|   #..........{.",
        ".{......#o#       |||||  |#a#||||+|#..........{.",
        ".{........#RRxxxRR|t,B|  |###|47J,3#....[.....{.",
        ".{.....[..#||||||||S,B|  +,,,,,,,,5o..........{.",
        ".{........#T¤@@¤ y||+||  ||+||,,,,no..........{.",
        ".{........o  @@   +      |6,6|,FO21#..........{.",
        ".{........o      E###*#o####||,#####..........{.",
        ".{..[.....#  dbD R#````````#<,,*`.^...........{.",
        ".{........##o###o##````````#####`..........[..{.",
        ".{........................```````....[........{.",
        ".{............................................{.",
        ".{{{{{{{{{{{{{{{{{{{{{{{{{{{{{{{{{{{{{{{{{{{{{{.",
        "................................................"
      ],
      "palettes": [
        "standard_domestic_palette",
        "standard_domestic_lino_kitchen",
        "standard_domestic_lino_bathroom",
        "standard_domestic_landscaping_palette"
      ],
      "terrain": { "(": "t_chaingate_c", "{": "t_chainfence", "'": "t_thconc_floor", ",": "t_linoleum_gray" },
      "place_loot": [ { "item": "television", "x": 14, "y": 13, "chance": 100 }, { "item": "stereo", "x": 14, "y": 13, "chance": 65 } ]
    }
  },
  {
    "type": "mapgen",
    "method": "json",
    "om_terrain": [ [ "urban_18_5", "urban_18_6" ] ],
    "object": {
      "fill_ter": "t_floor",
      "rows": [
        "~~~~~~~~~~~~~~~~~~~~~~~~~~~~~~~~~~~~~~~~~~~~~~~~",
        "~~~~~~~~~~~~~~~~~~~~~~~~~~~~~~~~~~~~~~~~~~~~~~~~",
        "~~~~~~~~~~~~~~~~~~~~~~~~~~~~~~~~~~~~~~~~~~~~~~~~",
        "~~~~~~~~~~~~~~~~~~~~~~~~~~~~~~~~~~~~~~~~~~~~~~~~",
        "~~~~~~~~~~~~~~~~~~~~~~~~~~~~~~~##o##~~~~~~~~~~~~",
        "~~~~~~~~~~~~#o#o#~~~~~~~~~~~~~~orrro~~~~~~~~~~~~",
        "~~~~~~~~~~~~oHHHo~~~~~~~~~~~~###rhr###~~~~~~~~~~",
        "~~~~~~~~~~### l ###~~~~~~~~~~#Y    PP#~~~~~~~~~~",
        "~~~~~~~~~~#Td   yD##o######o##       o~~~~~~~~~~",
        "~~~~~~~~#o#       |  c ii c        ET#~~~~~~~~~~",
        "~~~~~~~~oIh       +          |+||+|###~~~~~~~~~~",
        "~~~~~~~~oI    @@  |< >|   ###|U|t,So~~~~~~~~~~~~",
        "~~~~~~~~#o#  ¤@@¤ |||||   #a#||||||#~~~~~~~~~~~~",
        "~~~~~~~~~~#||||||||MMM|++|#'#RRTyRR#~~~~~~~~~~~~",
        "~~~~~~~~~~#       |                o~~~~~~~~~~~~",
        "~~~~~~~~~~# ee            EsE   h  o~~~~~~~~~~~~",
        "~~~~~~~~~~o ee  A0|RRRRT        rr #~~~~~~~~~~~~",
        "~~~~~~~~~~o ee AA0#######o##|+|#####~~~~~~~~~~~~",
        "~~~~~~~~~~#    000#~~~~~~~~#> <#~^~~~~~~~~~~~~~~",
        "~~~~~~~~~~##o###o##~~~~~~~~##o##~~~~~~~~~~~~~~~~",
        "~~~~~~~~~~~~~~~~~~~~~~~~~~~~~~~~~~~~~~~~~~~~~~~~",
        "~~~~~~~~~~~~~~~~~~~~~~~~~~~~~~~~~~~~~~~~~~~~~~~~",
        "~~~~~~~~~~~~~~~~~~~~~~~~~~~~~~~~~~~~~~~~~~~~~~~~",
        "~~~~~~~~~~~~~~~~~~~~~~~~~~~~~~~~~~~~~~~~~~~~~~~~"
      ],
      "palettes": [ "standard_domestic_palette", "standard_domestic_lino_bathroom" ],
      "terrain": { "~": "t_open_air", ",": "t_linoleum_gray", "'": "t_thconc_floor" },
      "furniture": { "0": "f_counter" },
      "items": { "0": { "item": "liquor_and_spirits", "chance": 30 } }
    }
  },
  {
    "type": "mapgen",
    "method": "json",
    "om_terrain": [ [ "urban_18_7", "urban_18_8" ] ],
    "object": {
      "fill_ter": "t_floor",
      "rows": [
        "~~~~~~~~~~~~~~~~~~~~~~~~~~~~~~~~~~~~~~~~~~~~~~~~",
        "~~~~~~~~~~~~~~~~~~~~~~~~~~~~~~~~~~~~~~~~~~~~~~~~",
        "~~~~~~~~~~~~~~~~~~~~~~~~~~~~~~~~~~~~~~~~~~~~~~~~",
        "~~~~~~~~~~~~~~~~~~~~~~~~~~~~~~~~~~~~~~~~~~~~~~~~",
        "~~~~~~~~~~~~~~~~~~~~~~~~~~~~~~~##o##~~~~~~~~~~~~",
        "~~~~~~~~~~~~#o#o#~~~~~~~~~~~~~~oHHHo~~~~~~~~~~~~",
        "~~~~~~~~~~~~oHHHo~~~~~~~~~~~~###   ###~~~~~~~~~~",
        "~~~~~~~~~~###   ###~~~~~~~~~~#x     H#~~~~~~~~~~",
        "~~~~~~~~~~#Db   yD##o###o#####x     Ho~~~~~~~~~~",
        "~~~~~~~~#o#       |   |8S8|v|       H#~~~~~~~~~~",
        "~~~~~~~~oI        +   |,,,+ +     ¤###~~~~~~~~~~",
        "~~~~~~~~oIh   @@  |>| |t,,###y  @@@#~~~~~~~~~~~~",
        "~~~~~~~~#o#  ¤@@¤T||| |BB,#a'   @@@#~~~~~~~~~~~~",
        "~~~~~~~~~~#||||||||   ||||###y  @@@#~~~~~~~~~~~~",
        "~~~~~~~~~~# ¤@@¤  +        T||    ¤#~~~~~~~~~~~~",
        "~~~~~~~~~~#  @@   ||+||      +     o~~~~~~~~~~~~",
        "~~~~~~~~~~o      E|t,S|Yy    | bddD#~~~~~~~~~~~~",
        "~~~~~~~~~~o       ##o####o##+#######~~~~~~~~~~~~",
        "~~~~~~~~~~#y dbd D#~~~~~~~~#  >#^~~~~~~~~~~~~~~~",
        "~~~~~~~~~~##o###o##~~~~~~~~##o##~~~~~~~~~~~~~~~~",
        "~~~~~~~~~~~~~~~~~~~~~~~~~~~~~~~~~~~~~~~~~~~~~~~~",
        "~~~~~~~~~~~~~~~~~~~~~~~~~~~~~~~~~~~~~~~~~~~~~~~~",
        "~~~~~~~~~~~~~~~~~~~~~~~~~~~~~~~~~~~~~~~~~~~~~~~~",
        "~~~~~~~~~~~~~~~~~~~~~~~~~~~~~~~~~~~~~~~~~~~~~~~~"
      ],
      "palettes": [ "standard_domestic_palette", "standard_domestic_lino_bathroom" ],
      "terrain": { "~": "t_open_air", ",": "t_linoleum_gray", "'": "t_thconc_floor" },
      "place_loot": [ { "item": "television", "x": 30, "y": 8, "chance": 100 }, { "item": "stereo", "x": 30, "y": 8, "chance": 65 } ]
    }
  },
  {
    "type": "mapgen",
    "method": "json",
    "om_terrain": [ [ "urban_18_9", "urban_18_10" ] ],
    "object": {
      "fill_ter": "t_shingle_flat_roof",
      "rows": [
        "                                                ",
        "                                                ",
        "                                                ",
        "                                                ",
        "                               -----            ",
        "            -----              -...-            ",
        "            -...-            ---...---          ",
        "          ---...---          -.......-          ",
        "          -.......------------.......-          ",
        "        ---..........................-          ",
        "        -...............=..........---          ",
        "        -..........................-            ",
        "        ---................~.......-            ",
        "          -........................-            ",
        "          -........................-            ",
        "          -...&...............N....-            ",
        "          -........................-            ",
        "          -.......----------...-----            ",
        "          -.......-        -...5                ",
        "          ---------        -----                ",
        "                                                ",
        "                                                ",
        "                                                ",
        "                                                "
      ],
      "palettes": [ "roof_palette" ],
      "terrain": { ".": "t_shingle_flat_roof" }
    }
  }
]
