[
  {
    "type": "mapgen",
    "method": "json",
    "om_terrain": [ [ "urban_17_1", "urban_17_2" ] ],
    "object": {
      "fill_ter": "t_floor",
      "rows": [
        ".......................``...........p_________..",
        ".........###oo###```````````````....._________..",
        ".........#RE   d#```````````````....._________..",
        ".........#     b###oo#oo####*###....._________..",
        "..[......o  @@  |    Es   +  +L#^...._________..",
        ".........# ¤@@¤ | HH     y|||||###..._________..",
        ".........#||||| | H  l   x|E     #..._________..",
        ".........#B,,,+ | H  l   x|  rrr o..._________..",
        ".........#Bt8S|+| HH     y|   hr o..._________..",
        ".........#||||| |         +   PP #..._________..",
        ".........#t|BB|          Y|||||||#..._________..",
        ".........#,+,,| |      ,,,,,,,,,6#..._________..",
        ".........#||8,|+| hffh ,JJJ,,4|,Zo..._________..",
        ".........#D|S,+ | hffh ,,,,,,O|,W#..._________..",
        ".....[...#+|||| |      ,F3n521|,?#..__________..",
        ".........#  II  ##::¶::##||||||+|#&___________..",
        ".........#R h   #```````#''''''''=____________..",
        ".........o     d#```````#''''''''=____________..",
        ".........o  @@ b#```````#U'''''''=____________..",
        ".........#y @@ T#```````#U''Á''''=____________..",
        ".........##o##o##```````#''''''''=___________...",
        "...[.....^..............#''''''''=__________..[.",
        "........................###o##o###..............",
        "................................................"
      ],
      "palettes": [
        "standard_domestic_palette",
        "standard_domestic_lino_kitchen",
        "standard_domestic_lino_bathroom",
        "standard_domestic_landscaping_palette"
      ],
      "terrain": {
        "=": "t_door_metal_locked",
        "&": "t_gates_control_brick",
        "'": "t_thconc_floor",
        "U": "t_thconc_floor",
        "Á": "t_thconc_floor",
        ",": "t_linoleum_gray",
        "?": "t_linoleum_gray",
        "Z": "t_linoleum_gray",
        "W": "t_linoleum_gray"
      },
      "furniture": { "?": "f_counter" },
      "place_loot": [ { "item": "television", "x": 25, "y": 6, "chance": 100 }, { "item": "stereo", "x": 25, "y": 6, "chance": 65 } ],
      "vehicles": { "Á": { "vehicle": "suburban_home", "chance": 100, "rotation": 180 } }
    }
  },
  {
    "type": "mapgen",
    "method": "json",
    "om_terrain": [ [ "urban_17_3", "urban_17_4" ] ],
    "object": {
      "fill_ter": "t_shingle_flat_roof",
      "rows": [
        "                                                ",
        "         --------                               ",
        "         -......-                               ",
        "         -......----------------                ",
        "         -.....................5                ",
        "         -.....................---              ",
        "         -.......................-              ",
        "         -..=.........N..........-              ",
        "         -.......................-              ",
        "         -.......................-              ",
        "         -.......................-              ",
        "         -.......................-              ",
        "         -...=.............&.....-              ",
        "         -.......................-              ",
        "         -.......................-              ",
        "         -......---------........-              ",
        "         -......-       -........-              ",
        "         -......-       -........-              ",
        "         -......-       -........-              ",
        "         -......-       -........-              ",
        "         5-------       -........-              ",
        "                        -........-              ",
        "                        ----------              ",
        "                                                "
      ],
      "palettes": [ "roof_palette" ],
      "terrain": { ".": "t_shingle_flat_roof" }
    }
  }
]
