[
  {
    "type": "mapgen",
    "method": "json",
    "om_terrain": [ [ "urban_11_1", "urban_11_2" ] ],
    "object": {
      "fill_ter": "t_floor",
      "rows": [
        "................................................",
        ".............................................[..",
        ".....[..................`````.u.................",
        "..........%%%.....%%%%..`````...........%%%.....",
        "..........%########oo#####*#o#############%.....",
        "..........%#12O34,hffh,,Y|  WZ|'NN'''''''#%.....",
        "...........o5,,,,,hffh,,,+    +'A''''''''o......",
        "...........#7,,,,,,,,,,,,||||||''''''''''#......",
        "...........#F,,,,,,,,66|,|S8tB|''''Á''''q#......",
        "...........#|||JJJ|  ||| |,,,B|'''''''''q#......",
        "...........o   000    <| |+||||'''''''''q#......",
        "...........#x   l H        |q'+''''''''''#%.....",
        "...[.......#x   l H        ||||''''''''''o%.....",
        "...........#yTE  HH   L    + Q|&'''''''''#%.....",
        "..........%#####o#######o#*#####========##......",
        "..........%%..%..%..%..%.```...&________........",
        ".........................```````________.%......",
        ".........................```````________........",
        "....................[...........________.%...[..",
        ".......[........................________........",
        "..............................%.________.%......",
        "................................________........",
        "..............[...............%.________.%......",
        "...............................p________........"
      ],
      "palettes": [
        "standard_domestic_palette",
        "standard_domestic_lino_kitchen",
        "standard_domestic_lino_bathroom",
        "standard_domestic_landscaping_palette"
      ],
      "terrain": {
        "=": "t_door_metal_locked",
        "&": "t_gates_control_brick",
        "'": "t_thconc_floor",
        "q": "t_thconc_floor",
        "N": "t_thconc_floor",
        "A": "t_thconc_floor",
        "Á": "t_thconc_floor",
        ",": "t_linoleum_gray",
        "Y": "t_linoleum_gray",
        "h": "t_linoleum_gray",
        "f": "t_linoleum_gray",
        "Q": "t_floor",
        "J": "t_floor"
      },
      "furniture": { "0": "f_stool" },
      "place_loot": [ { "item": "television", "x": 12, "y": 11, "chance": 100 }, { "item": "stereo", "x": 12, "y": 12, "chance": 65 } ],
      "vehicles": { "Á": { "vehicle": "suburban_home", "chance": 100, "rotation": 270 } }
    }
  },
  {
    "type": "mapgen",
    "method": "json",
    "om_terrain": [ "urban_11_3" ],
    "weight": 250,
    "object": {
      "fill_ter": "t_floor",
      "rows": [
        "........................",
        "........................",
        "........................",
        "........................",
        "...........RRRRRRRRRRRRR",
        "...........RRRRIwwIRRRRR",
        "...........IiiiIccIiiiii",
        "...........Iebbe    O|r|",
        "...........I bb      + |",
        "...........w         |-|",
        "...........I         |<|",
        "...........I eee     +  ",
        "...........IiiiIccIiiiii",
        "...........RRRRIwwIRRRRR",
        "...........RRRRRRRRRRRRR",
        "........................",
        "........................",
        "........................",
        "........................",
        "........................",
        "........................",
        "........................",
        "........................",
        "........................"
      ],
      "palettes": [ "acidia_residential_commercial_palette" ],
      "items": {
        " ": { "item": "livingroom", "chance": 2 },
        "O": { "item": "homebooks", "chance": 60 },
        "b": { "item": "bed", "chance": 60 },
        "c": { "item": "livingroom", "chance": 25 },
        "e": { "item": "dresser", "chance": 60 },
        "r": { "item": "bedroom", "chance": 60 }
      },
      "place_monsters": [ { "monster": "GROUP_ZOMBIE", "x": [ 12, 22 ], "y": [ 7, 11 ], "density": 0.09 } ]
    }
  },
  {
    "type": "mapgen",
    "method": "json",
    "om_terrain": [ "urban_11_4" ],
    "weight": 250,
    "object": {
      "fill_ter": "t_floor",
      "rows": [
        "........................",
        "........................",
        "........................",
        "........................",
        "RRRRRRRRRRRRRRRRRR......",
        "IwwwIRRRRRIwwIRRRR......",
        "IBBBIiiiiiIeeIiiiI......",
        "T222222+        eI......",
        "22222|-|      bbbI......",
        "CSCSC| +      bbbw......",
        "-----| |dh    bbbI......",
        "       |6dd     eI......",
        "IcccIiiiiiIccIiiiI......",
        "IwwwIRRRRRIwwIRRRR......",
        "RRRRRRRRRRRRRRRRRR......",
        "........................",
        "........................",
        "........................",
        "........................",
        "........................",
        "........................",
        "........................",
        "........................",
        "........................"
      ],
      "palettes": [ "acidia_residential_commercial_palette" ],
      "toilets": { "T": {  } },
      "items": {
        " ": { "item": "livingroom", "chance": 2 },
        "2": { "item": "softdrugs", "chance": 10 },
        "C": { "item": "cleaning", "chance": 10 },
        "O": { "item": "homebooks", "chance": 60 },
        "b": { "item": "bed", "chance": 60 },
        "c": { "item": "livingroom", "chance": 25 },
        "d": { "item": "office", "chance": 40 },
        "e": { "item": "dresser", "chance": 60 },
        "r": { "item": "bedroom", "chance": 60 }
      },
      "place_monsters": [ { "monster": "GROUP_ZOMBIE", "x": [ 1, 15 ], "y": [ 7, 11 ], "density": 0.09 } ]
    }
  },
  {
    "type": "mapgen",
    "method": "json",
    "om_terrain": [ "urban_11_5" ],
    "weight": 250,
    "object": {
      "fill_ter": "t_floor",
      "rows": [
        "........................",
        "........................",
        "........................",
        "........................",
        "........................",
        "...............1111.....",
        "...........41111RR111111",
        "...........4RRRRRRRRRRRR",
        "...........4RRERRRRRERRR",
        "...........4RRRRRRRRRRRR",
        "...........4RRRRRRRRRRRR",
        "...........4RRRRRRRRRRRR",
        "...........43333RR333333",
        "...............3333.....",
        "........................",
        "........................",
        "........................",
        "........................",
        "........................",
        "........................",
        "........................",
        "........................",
        "........................",
        "........................"
      ],
      "palettes": [ "acidia_residential_roof_palette" ]
    }
  },
  {
    "type": "mapgen",
    "method": "json",
    "om_terrain": [ "urban_11_6" ],
    "weight": 250,
    "object": {
      "fill_ter": "t_floor",
      "rows": [
        "........................",
        "........................",
        "........................",
        "........................",
        "........................",
        "11111.....1111..........",
        "RRRR1111111RR11112......",
        "RRRRRRRRRRRRRRRRR2......",
        "RRRRRRRRRRRRRRRRR2......",
        "RRRRRRRRRRRR&RRRR2......",
        "RRRRRRR^RRRRRRRRR2......",
        "RRRRRRRRRRRRRRRRR2......",
        "RRRR3333333RR33332......",
        "33333.....3333..........",
        "........................",
        "........................",
        "........................",
        "........................",
        "........................",
        "........................",
        "........................",
        "........................",
        "........................",
        "........................"
      ],
      "palettes": [ "acidia_residential_roof_palette" ]
    }
  }
]
