[
  {
    "type": "mapgen",
    "method": "json",
    "om_terrain": [ [ "urban_12_1", "urban_12_2" ] ],
    "object": {
      "fill_ter": "t_floor",
      "rows": [
        "..............``p...............________........",
        "...[.........%``%...............________........",
        ".............````...............________..[.....",
        ".....%..%..##````##..%..%.......________........",
        "...###oo#####o**o#####oo###....&________........",
        "...# xxxx T|      |c      #...##========##^.....",
        "...o      E|Ls       hffh #...#&'''''''''#......",
        "...#       |||    |  hffh #...o''''''''''#......",
        "...#H ll H  y|  |<|  hffh #%.%#''''''''''o......",
        "...#HHHHHH      |||       #%%%#''''''''''#......",
        "...o            +w|yMy    ##o##''''''''''#......",
        "...#  RR    y|  ||||||||  |U'U|'''''Á''''#......",
        "..^######oo###   ciic     +'''+''''''''''o......",
        "....`````````#            |Z'W|'''''''''N#......",
        "....`````````*,,,,,,,,||+|##*##qqq'''''AN#......",
        "....`````````#Y,,,,,,6|,,,#```####o##o####......",
        "....`````````on,JJ,,,6|S,t#```..............[...",
        "....`````````o5,JJ,,,,||||#```%%................",
        "....`````````#2,,,,,,,+,,,#```%%................",
        "....#````````#17O43FJJ|666#........[............",
        ".............#####o##o#####.....................",
        "................................................",
        ".....[....................................[.....",
        "................................................"
      ],
      "palettes": [
        "standard_domestic_palette",
        "standard_domestic_lino_kitchen",
        "standard_domestic_lino_bathroom",
        "standard_domestic_landscaping_palette"
      ],
      "terrain": {
        "=": "t_door_metal_locked",
        "&": "t_gates_control_brick",
        "'": "t_thconc_floor",
        "q": "t_thconc_floor",
        "N": "t_thconc_floor",
        "A": "t_thconc_floor",
        "Á": "t_thconc_floor",
        "U": "t_thconc_floor",
        "W": "t_thconc_floor",
        "Z": "t_thconc_floor",
        ",": "t_linoleum_gray",
        "Y": "t_linoleum_gray"
      },
      "place_loot": [ { "item": "television", "x": 6, "y": 5, "chance": 100 }, { "item": "stereo", "x": 7, "y": 5, "chance": 65 } ],
      "vehicles": { "Á": { "vehicle": "suburban_home", "chance": 100, "rotation": 90 } }
    }
  },
  {
    "type": "mapgen",
    "method": "json",
    "om_terrain": [ [ "urban_12_3", "urban_12_4" ] ],
    "object": {
      "fill_ter": "t_floor",
      "rows": [
        "~~~~~~~~~~~~~~~~~~~~~~~~~~~~~~~~~~~~~~~~~~~~~~~~",
        "~~~~~~~~~~~~~~~~~~~~~~~~~~~~~~~~~~~~~~~~~~~~~~~~",
        "~~~~~~~~~~~~~~~~~~~~~~~~~~~~~~~~~~~~~~~~~~~~~~~~",
        "~~~~~~~~~~~&&&&&&&&~~~~~~~~~~~~~~~~~~~~~~~~~~~~~",
        "~~~##o###o###o##########o##~~~~~~~~~~~~~~~~~~~~~",
        "~~~# T ¤@@@¤  dd|D|B,t|R  #~~~####o##o####~~~~~~",
        "~~~#    @@@     + |B,8|R  #~~~#98|    sdD#^~~~~~",
        "~~~o    @@@     |||,,S|   #~~~#,,+       o~~~~~~",
        "~~~#           b|>||+||  s#~~~#tS|       #~~~~~~",
        "~~~o            |        E#~~~#|||     @@#~~~~~~",
        "~~~#Ih          +         ##o##  +     @@#~~~~~~",
        "~~^#III         |||||||    iii   ||||||||#~~~~~~",
        "~~~###o###o###|||t8S8B|          |RRR   r#~~~~~~",
        "~~~~&&&&&&&&&#D |,,,,B|y   iii   +     hro~~~~~~",
        "~~~~&&&&&&&&&#|+|||+||||+|##o##yy| PP  rr#~~~~~~",
        "~~~~&&&&&&&&&#           d#~~~####o##o####~~~~~~",
        "~~~~&&&&&&&&&#           bo~~~~~~~~~~~~~~~~~~~~~",
        "~~~~&&&&&&&&&o           d#~~~~~~~~~~~~~~~~~~~~~",
        "~~~~&&&&&&&&&#Ih    @@    o~~~~~~~~~~~~~~~~~~~~~",
        "~~~~&&&&&&&&&#III  ¤@@¤   #~~~~~~~~~~~~~~~~~~~~~",
        "~~~~~~~~~~~~~###o######o###~~~~~~~~~~~~~~~~~~~~~",
        "~~~~~~~~~~~~~~~~~~~~~~~~~~~~~~~~~~~~~~~~~~~~~~~~",
        "~~~~~~~~~~~~~~~~~~~~~~~~~~~~~~~~~~~~~~~~~~~~~~~~",
        "~~~~~~~~~~~~~~~~~~~~~~~~~~~~~~~~~~~~~~~~~~~~~~~~"
      ],
      "palettes": [ "standard_domestic_palette", "standard_domestic_lino_bathroom" ],
      "terrain": { ",": "t_linoleum_gray", "~": "t_open_air", "&": "t_shingle_flat_roof" }
    }
  },
  {
    "type": "mapgen",
    "method": "json",
    "om_terrain": [ [ "urban_12_5", "urban_12_6" ] ],
    "object": {
      "fill_ter": "t_shingle_flat_roof",
      "rows": [
        "                                                ",
        "                                                ",
        "                                                ",
        "                                                ",
        "   ------------------------                     ",
        "   -......................-   -----------5      ",
        "   -......................-   -..........-      ",
        "   -......................-   -.....=....-      ",
        "   -............N.........-   -..........-      ",
        "   -......................-   -..........-      ",
        "   -......................-----..........-      ",
        "   -.....................................-      ",
        "   5----------......................:....-      ",
        "             -.....&.....................-      ",
        "             -............-----..........-      ",
        "             -............-   ------------      ",
        "             -............-                     ",
        "             -............-                     ",
        "             -............-                     ",
        "             -............-                     ",
        "             --------------                     ",
        "                                                ",
        "                                                ",
        "                                                "
      ],
      "palettes": [ "roof_palette" ],
      "terrain": { ".": "t_shingle_flat_roof" }
    }
  }
]
