[
  {
    "type": "mapgen",
    "method": "json",
    "om_terrain": [ [ "urban_40_1", "urban_40_2" ] ],
    "object": {
      "fill_ter": "t_floor",
      "rows": [
        "....________________p...........................",
        "....________________.............[..............",
        "....________________.....[..............[.......",
        "....________________............................",
        "...._________________.....###oo####oo###........",
        "....__________________...&#&''''qq'''NN#^.......",
        "....______________________='''''''''''A####.....",
        "....______________________=''''''''''''#'U#.....",
        "....______________________=''''''''''''+'U#.....",
        "....______________________='''''Á''''''#'U#.[...",
        "....______________________=''''''''''''#||#.....",
        "....._____________________=''''''''''''#,?#.....",
        "......____________________=''''''''''''+,Zo.....",
        "....###ooo###``#```````#``#''''''''''''#,W#.....",
        "....#RRIIITy#`````````````##############+|#..[..",
        "....#  I0   ##ooo##*##ooo##HHHHHy,,J66J,,F#.....",
        "....#       |     L            H ,,,,,,,,4#.....",
        ".[..o       +               ll   ,,,,,,,,5o.....",
        "....#  @@@ b|||||<||||           ,,,,,,,,7#.....",
        "....#  @@@  +,,B|||,,+           ,,hffh,,Oo.....",
        "...^#d¤@@@¤d|StB|g|tS|ERRR xxx   ,,hffh123#.....",
        "....##o###o######*########o####*###hffh####...[.",
        "................```..........`````#oooo#........",
        ".............................`````.............."
      ],
      "palettes": [
        "standard_domestic_palette",
        "standard_domestic_lino_kitchen",
        "standard_domestic_lino_bathroom",
        "standard_domestic_landscaping_palette"
      ],
      "terrain": {
        "=": "t_door_metal_locked",
        "&": "t_gates_control_brick",
        "'": "t_thconc_floor",
        "Á": "t_thconc_floor",
        "N": "t_thconc_floor",
        "A": "t_thconc_floor",
        "U": "t_thconc_floor",
        "q": "t_thconc_floor",
        ",": "t_linoleum_gray",
        "?": "t_linoleum_gray",
        "Z": "t_linoleum_gray",
        "W": "t_linoleum_gray",
        "h": "t_linoleum_gray",
        "f": "t_linoleum_gray"
      },
      "furniture": { "?": "f_counter", "0": "f_chair" },
      "place_loot": [ { "item": "television", "x": 28, "y": 20, "chance": 100 }, { "item": "stereo", "x": 28, "y": 20, "chance": 65 } ],
      "vehicles": { "Á": { "vehicle": "suburban_home", "chance": 40, "rotation": 180 } }
    }
  },
  {
    "type": "mapgen",
    "method": "json",
    "om_terrain": [ [ "urban_40_3", "urban_40_4" ] ],
    "object": {
      "fill_ter": "t_floor",
      "rows": [
        "~~~~~~~~~~~~~~~~~~~~~~~~~~~~~~~~~~~~~~~~~~~~~~~~",
        "~~~~~~~~~~~~~~~~~~~~~~~~~~~~~~~~~~~~~~~~~~~~~~~~",
        "~~~~~~~~~~~~~~~~~~~~~~~~~~~~~~~~~~~~~~~~~~~~~~~~",
        "~~~~~~~~~~~~~~~~~~~~~~~~~~~~~~~~~~~~~~~~~~~~~~~~",
        "~~~~~~~~~~~~~~~~~~~~~~~~~~--------------~~~~~~~~",
        "~~~~~~~~~~~~~~~~~~~~~~~~~~-&&&&&&&&&&&&!~~~~~~~~",
        "~~~~~~~~~~~~~~~~~~~~~~~~~~-&&&&&&&&&&&&----~~~~~",
        "~~~~~~~~~~~~~~~~~~~~~~~~~~-&&&&&&&&&&&&&&&-~~~~~",
        "~~~~~~~~~~~~~~~~~~~~~~~~~~-&&&&&&&&&&&&&&&-~~~~~",
        "~~~~~~~~~~~~~~~~~~~~~~~~~~-&&&&&&&&&&&&&&&-~~~~~",
        "~~~~~~~~~~~~~~~~~~~~~~~~~~-&&&&&&&&&&&&&&&-~~~~~",
        "~~~~~~~~~~~~~~~~~~~~~~~~~~-&&&&&&&&&&&&&&&-~~~~~",
        "~~~~~~~~~~~~~~~~~~~~~~~~~~-&&&&&&&&&&&&^&&-~~~~~",
        "~~~~####oo####oo####oooo####oo####oo####&&-~~~~~",
        "~~~~#IIIy    +         sxs    +     i@@#&&-~~~~~",
        "~~~~oIA      ||||          ||||     i@@o&&-~~~~~",
        "~~~~#T       |St|       l H|8S|       T#&&-~~~~~",
        "~~~~o   @@   +,,|         H|,,+     i@@o&&-~~~~~",
        "~~~~#d ¤@@¤dD|BB|>|RR HHHHH|9t|dd   i@@#&&-~~~~~",
        "~~~~####oo########################oo####&&-~~~~~",
        "~~~~!&&&&&&&&&&&&&&&&&&&&&&&&&&&&&&&&&&&&&-~~~~~",
        "~~~~-------------------------------&&&&----~~~~~",
        "~~~~~~~~~~~~~~~~~~~~~~~~~~~~~~~~~~------~~~~~~~~",
        "~~~~~~~~~~~~~~~~~~~~~~~~~~~~~~~~~~~~~~~~~~~~~~~~"
      ],
      "palettes": [ "standard_domestic_palette", "standard_domestic_lino_bathroom" ],
      "terrain": { ",": "t_linoleum_gray", "~": "t_open_air", "&": "t_shingle_flat_roof", "!": "t_gutter_drop", "-": "t_gutter" },
      "place_loot": [ { "item": "television", "x": 24, "y": 14, "chance": 100 }, { "item": "stereo", "x": 24, "y": 14, "chance": 65 } ]
    }
  },
  {
    "type": "mapgen",
    "method": "json",
    "om_terrain": [ [ "urban_40_5", "urban_40_6" ] ],
    "object": {
      "fill_ter": "t_shingle_flat_roof",
      "rows": [
        "                                                ",
        "                                                ",
        "                                                ",
        "                                                ",
        "                                                ",
        "                                                ",
        "                                                ",
        "                                                ",
        "                                                ",
        "                                                ",
        "                                                ",
        "                                                ",
        "                                                ",
        "    -----------------------------------5        ",
        "    -..................................-        ",
        "    -..................................-        ",
        "    -................N.................-        ",
        "    -.........=..............=.........-        ",
        "    -..................................-        ",
        "    ------------------------------------        ",
        "                                                ",
        "                                                ",
        "                                                ",
        "                                                "
      ],
      "palettes": [ "roof_palette" ],
      "terrain": { ".": "t_shingle_flat_roof" }
    }
  }
]
