[
  {
    "type": "mapgen",
    "method": "json",
    "om_terrain": [ "urban_39_1" ],
    "weight": 250,
    "object": {
      "fill_ter": "t_linoleum_white",
      "rows": [
        "%%%llllllllllllllllll%%%",
        "%%%l▪▪▪▪▪▪×▪▪×▪▪▪▪▪¦l%%%",
        "iiii▪▪▪▪▪▪▪▪▪▪▪▪▪▪▪¦llll",
        "i~~i▪▪▪▪▪▪▪▪▪▪▪▪▪▪▪¦(((2",
        "i ~i▪▪▪▪▪▪▪▪▪▪▪▪▪▪▪¦2222",
        "i  i▪▪▪▪▪▪×▪▪×▪▪▪▪▪¦2222",
        "i ~i▪▪▪▪▪▪▪▪▪▪▪▪▪▪▪¦(((2",
        "i  i▪▪▪▪▪▪▪▪▪▪▪▪▪▪▪¦2222",
        "i ~i▪▪▪▪▪▪▪▪▪▪▪▪▪▪▪¦2222",
        "i~~i▪▪▪▪▪▪×▪▪×¦¦¦¦¦¦(((2",
        "0~ i▪▪▪▪▪▪¦¦¦¦¦Ṃ22222222",
        "0~ i▪▪▪▪▪▪¦<<22222222222",
        "0~ i▪▪▪▪▪▪¦<<22222222222",
        "0~ i▪▪▪▪▪▪¦¦¦¦¦222222222",
        "i~~i▪▪▪▪▪▪×▪▪×¦¦¦¦¦¦2222",
        "i~ i▪▪▪▪▪▪▪▪▪▪▪▪▪▪▪¦2222",
        "i~~i▪▪▪▪▪▪▪▪▪▪▪▪▪▪▪¦2222",
        "i~ i▪▪▪▪▪▪▪▪▪▪▪▪▪▪▪¦2222",
        "i  i▪▪▪▪▪▪×▪▪×▪▪▪▪▪¦lCCC",
        "i  i▪▪▪▪▪▪▪▪▪▪▪▪▪▪▪¦l222",
        "i~ i▪▪▪▪▪▪▪▪▪▪▪▪▪▪▪¦lggg",
        "iiii▪▪▪▪▪▪▪▪▪▪▪▪▪▪▪¦llll",
        "%%%l▪▪▪▪▪▪×▪▪×▪▪▪▪▪¦l%%%",
        "%%%llllllllllllllllll%%%"
      ],
      "palettes": [ "acidia_residential_commercial_palette" ],
      "terrain": { "▪": "t_open_air", "×": "t_column", "¦": "t_glass_railing", "C": "t_linoleum_white", "g": "t_linoleum_white" },
      "items": { "'": { "item": "subway", "chance": 1 }, "g": { "item": "vending_drink", "chance": 60 } },
      "signs": { "Ṃ": { "signage": "Subway Map: <city> stop" } },
      "place_monsters": [ { "monster": "GROUP_MALL", "x": [ 10, 22 ], "y": [ 1, 22 ], "density": 0.25 } ]
    }
  },
  {
    "type": "mapgen",
    "method": "json",
    "om_terrain": [ "urban_39_2" ],
    "weight": 250,
    "object": {
      "fill_ter": "t_floor",
      "rows": [
        "%%%%%%%%%%%%%%%%%%%%%%%%",
        "%%%%%%%%%%%%%%%%%%%%%%%%",
        "lll%%%%%%%%%%%%%%%%%%%%%",
        "2(l%%%%%%%%%%%%%%%%%%%%%",
        "2(l%%%%%%%%%%%%%%%%%%%%%",
        "2(l%%%%%%%%%%%%%%%%%%%%%",
        "2(l%%%%%%%%%%%%%%%%%%%%%",
        "2(l%%%%%%lllllllllllllll",
        "2(llllllllLLLLLLL''''''l",
        "22vgg 6 rl'''''''''''''l",
        "22vg  C  1''''''')ZZ''Zl",
        "22vg  C rlL''žž'')ZZ''Zl",
        "22lvJvllllL''žž'''''''Ž0",
        "222222=EElL''žž''ZZ)''Žl",
        "222222=EElL''''''ZZ)'''l",
        "222222lEElL''''''''''''l",
        "222222lllllllll1llllllll",
        "222222222222l'''''l%%%%%",
        "CCl222222222='''''l%%%%%",
        "26llllaa2222lLLLLLl%%%%%",
        "ggl%%llll>>>lllllll%%%%%",
        "lll%%%%%lllll%%%%%%%%%%%",
        "%%%%%%%%%%%%%%%%%%%%%%%%",
        "%%%%%%%%%%%%%%%%%%%%%%%%"
      ],
      "palettes": [ "acidia_residential_commercial_palette" ],
      "terrain": {
        "ž": "t_strconc_floor",
        "L": "t_strconc_floor",
        " ": "t_linoleum_white",
        "(": "t_linoleum_white",
        "C": "t_linoleum_white",
        "g": "t_linoleum_white",
        "r": "t_linoleum_white"
      },
      "items": {
        " ": { "item": "subway", "chance": 1 },
        "'": { "item": "home_hw", "chance": 1 },
        "L": { "item": "hardware_plumbing", "chance": 25 },
        "g": { "item": "vending_drink", "chance": 60, "repeat": 2 },
        "r": { "item": "snacks", "chance": 40, "repeat": 4 }
      },
      "place_monsters": [ { "monster": "GROUP_ZOMBIE", "x": [ 1, 22 ], "y": [ 1, 22 ], "density": 0.25 } ]
    }
  },
  {
    "type": "mapgen",
    "method": "json",
    "om_terrain": [ "urban_39_3" ],
    "weight": 250,
    "object": {
      "fill_ter": "t_floor",
      "rows": [
        ";;;;;;;;;;;;;;;;;;;;;;;;",
        ";;;;;;;;;;;''''';;;;;;;;",
        ";;;;;;;;;;;'''}'QQQ;QQQ;",
        "lllllllllwll1lllQQQ'QQQ'",
        "lT2lXXXX      Xlllllllll",
        "l22l X       XXlgggggggg",
        "lS2l          Xl        ",
        "ll+llllllllJJlll        ",
        "lr  gggggg        crrrc ",
        "lr                      ",
        "lr                      ",
        "l   rrrr  rrrr  rrrr  c ",
        "l   rrrr  rrrr  rrrr  r ",
        "lr                    r ",
        "lr                    c ",
        "lr  rr    rr  rr  rr    ",
        "lr  rr    6c  6c  6c    ",
        "lr  rr    ch  ch  ch    ",
        "lr  rr    cc  cc  cc    ",
        "lr                      ",
        "lrCCCCC    CCCCC    CCCC",
        "lllvvvllJJllvvvllJJllvvv",
        ";;;;;;;;;;;;;;;;;;;;;;;;",
        ";;;;;;;;;;;;;;;;;;;;;;;;"
      ],
      "palettes": [ "acidia_residential_commercial_palette" ],
      "toilets": { "T": {  } },
      "items": {
        "C": { "item": "kitchen", "chance": 30 },
        "Q": { "item": "trash_dumpster", "chance": 80 },
        "X": { "item": "produce", "chance": 60 },
        "g": { "item": "forage_spring", "chance": 40 },
        "r": { "item": "produce", "chance": 35 }
      },
      "place_monsters": [ { "monster": "GROUP_MALL", "x": [ 1, 22 ], "y": [ 1, 22 ], "density": 0.6 } ]
    }
  },
  {
    "type": "mapgen",
    "method": "json",
    "om_terrain": [ "urban_39_4" ],
    "weight": 250,
    "object": {
      "fill_ter": "t_floor",
      "rows": [
        ";;NnnnnnnnnnnnnnnnnnnnnN",
        ";;N,,,,,,mmmmmmmmmmmmm,N",
        ";;N,mmmm,,,,,,,,,,,,,,,N",
        "''N,mmmm,mmmmmmmmmmmmm,N",
        "lll,mmmm,,,,,,,,,,,,,,,N",
        "ggl;;;;;;mmmmmmmmmmmmm,N",
        "  J;;;;;;;;;;,,,,,,,,,,N",
        "  l;;;;;;ll1llllllllllll",
        " rllJlllllX LlggOOOOOOOl",
        " rlk  l >lX Xl         l",
        " rl   +  ll1ll   OO   Ol",
        " rl   l  l   c   OO   Ol",
        " rl   llll  hc   OO   Ol",
        " rl   =77l cc6   OO   Ol",
        " rl   =77l             l",
        " rl   l77lccccc   cccccl",
        " rllJllllllvvvlJvJlvvvll",
        " rl;;;;;;;;;;;;;;;;;;;;;",
        " Cv;;;;;;;;;;;;;;;;;;;;;",
        " Cv;;;;(lvvvl(;;;;;,,,;;",
        "CCl;;;;(v<<<v(;;;;;,^,;;",
        "lll;;;;(v'''v(;;;;;,,,;;",
        ";;;;;;;(l'''l(;;;;;;;;;;",
        ";;;;;;;;;;;;;;;;;;;;;;;;"
      ],
      "palettes": [ "acidia_residential_commercial_palette" ],
      "terrain": { "(": "t_sidewalk" },
      "items": {
        "O": { "item": "newspapers", "chance": 60, "repeat": 3 },
        "X": { "item": "newspapers", "chance": 60, "repeat": 10 },
        "c": { "item": "bookstore_misc", "chance": 30 },
        "g": { "item": "forage_spring", "chance": 40 },
        "r": { "item": "produce", "chance": 35 }
      },
      "place_monsters": [ { "monster": "GROUP_ZOMBIE", "x": [ 1, 22 ], "y": [ 1, 22 ], "density": 0.5 } ]
    }
  },
  {
    "type": "mapgen",
    "method": "json",
    "om_terrain": [ "urban_39_5" ],
    "weight": 250,
    "object": {
      "fill_ter": "t_floor",
      "rows": [
        "........................",
        "...........89998........",
        "...........8}0{8........",
        "llllwlllwllll1llllwlllwl",
        "le     fSoCl   lCoSfWD b",
        "lbbb   222Cl   lC222   b",
        "lbbb       1   1  @@@   ",
        "lbbb htth  l   l    @ |-",
        "le   htth  l   l      +2",
        "l     6th  l   lc6c   |S",
        "ll+llllll+ll   lll1lllll",
        "lr lBBlu+2Sl            ",
        "llllT2lll2Tl            ",
        "lr lS2+ulBBl            ",
        "ll+ll+llllll   lllllllll",
        "le     OOOOl   lc6c   |S",
        "lbb        l   l    @ +2",
        "lbb   AtA  l   l    @ |-",
        "l          1   1  @@@   ",
        "l   h  222Cl   lC222 hdb",
        "l  d6d fSoCl   lCoSfdd6b",
        "llllwlllwlllllllllwlllwl",
        "........................",
        "........................"
      ],
      "palettes": [ "acidia_residential_commercial_palette" ],
      "toilets": { "T": {  } },
      "items": {
        " ": { "item": "livingroom", "chance": 1 },
        "2": { "item": "softdrugs", "chance": 1 },
        "@": { "item": "magazines", "chance": 10 },
        "A": { "item": "livingroom", "chance": 10 },
        "C": { "item": "kitchen", "chance": 25 },
        "O": { "item": "homebooks", "chance": 60 },
        "b": { "item": "bed", "chance": 60 },
        "c": { "item": "livingroom", "chance": 25 },
        "d": { "item": "office", "chance": 40 },
        "e": { "item": "dresser", "chance": 60 },
        "f": { "item": "fridge", "chance": 70 },
        "o": { "item": "oven", "chance": 30 },
        "r": { "item": "bedroom", "chance": 60 },
        "t": { "item": "coffee_table", "chance": 25 },
        "u": { "item": "cleaning", "chance": 50 }
      },
      "place_monsters": [ { "monster": "GROUP_ZOMBIE", "x": [ 1, 22 ], "y": [ 4, 20 ], "density": 0.25 } ]
    }
  },
  {
    "type": "mapgen",
    "method": "json",
    "om_terrain": [ "urban_39_6" ],
    "weight": 250,
    "object": {
      "fill_ter": "t_floor",
      "rows": [
        "........................",
        "........................",
        "........................",
        "lll.....................",
        "bel.....................",
        "b l.....................",
        "  l.....................",
        "--l......ll1wllllllwllll",
        "2BllwlllllCoSCfWD|O bbel",
        "TBlk  l <lC2222  |  bb l",
        "lll   +  1       +     l",
        "      l >l      c|     l",
        "      llllA     6|+-|+-l",
        "      =77l@ t   c|2S| rl",
        "lll   =77l@      +2T| rl",
        "TBl   l77l@@@  OO|BB| rl",
        "2Bllwlllllllllllllllllll",
        "--l.....................",
        "  l.....................",
        "b l.....RRRR............",
        "bel.....RRRR............",
        "lll.....RRRR............",
        "........RRRR............",
        "........................"
      ],
      "palettes": [ "acidia_residential_commercial_palette" ],
      "toilets": { "T": {  } },
      "items": {
        " ": { "item": "livingroom", "chance": 1 },
        "2": { "item": "softdrugs", "chance": 1 },
        "@": { "item": "magazines", "chance": 10 },
        "A": { "item": "livingroom", "chance": 10 },
        "C": { "item": "kitchen", "chance": 25 },
        "O": { "item": "homebooks", "chance": 60 },
        "b": { "item": "bed", "chance": 60 },
        "c": { "item": "livingroom", "chance": 25 },
        "d": { "item": "office", "chance": 40 },
        "e": { "item": "dresser", "chance": 60 },
        "f": { "item": "fridge", "chance": 70 },
        "o": { "item": "oven", "chance": 30 },
        "r": { "item": "bedroom", "chance": 60 },
        "t": { "item": "coffee_table", "chance": 25 },
        "u": { "item": "cleaning", "chance": 50 }
      },
      "place_monsters": [ { "monster": "GROUP_ZOMBIE", "x": [ 1, 22 ], "y": [ 9, 15 ], "density": 0.25 } ]
    }
  },
  {
    "type": "mapgen",
    "method": "json",
    "om_terrain": [ "urban_39_7" ],
    "weight": 250,
    "object": {
      "fill_ter": "t_floor",
      "rows": [
        "........................",
        "...........89998........",
        "...........8{0}8........",
        "llllwlllwllll1llllwlllwl",
        "l      2SoCl   lCoSfbbee",
        "l   K K222Cl   lC222bb  ",
        "l          1   1 @@@@   ",
        "l K  b  K  l   l @    |-",
        "l    b     l   l      +2",
        "l  K   K   l   l  c6c |S",
        "ll+llllll+ll   lll1lllll",
        "l  lBBlu+ Sl            ",
        "llllT lll Tl            ",
        "lr lS +ulBBl            ",
        "ll+ll+llllll   lllllllll",
        "le       WDl   l  bbe |S",
        "lbb  htth  l   l      +2",
        "lbb  htth  l   l  tt  |-",
        "le         1   1        ",
        "l      222Cl   lC222 d h",
        "lL     fSoCl   lCoSf d66",
        "llllwlllwlllllllllwlllwl",
        "........................",
        "........................"
      ],
      "palettes": [ "acidia_residential_commercial_palette" ],
      "toilets": { "T": {  } },
      "items": {
        " ": { "item": "livingroom", "chance": 1 },
        "2": { "item": "softdrugs", "chance": 1 },
        "@": { "item": "magazines", "chance": 10 },
        "A": { "item": "livingroom", "chance": 10 },
        "C": { "item": "kitchen", "chance": 25 },
        "D": { "item": "allclothes", "chance": 60 },
        "K": { "item": "male_underwear_bottom", "chance": 70 },
        "O": { "item": "homebooks", "chance": 60 },
        "W": { "item": "allclothes", "chance": 60 },
        "b": { "item": "bed", "chance": 60 },
        "c": { "item": "livingroom", "chance": 25 },
        "d": { "item": "office", "chance": 40 },
        "e": { "item": "dresser", "chance": 60 },
        "f": { "item": "fridge", "chance": 70 },
        "o": { "item": "oven", "chance": 30 },
        "r": { "item": "bedroom", "chance": 60 },
        "t": { "item": "coffee_table", "chance": 25 },
        "u": { "item": "cleaning", "chance": 50 }
      },
      "place_monsters": [ { "monster": "GROUP_ZOMBIE", "x": [ 1, 22 ], "y": [ 4, 20 ], "density": 0.25 } ]
    }
  },
  {
    "type": "mapgen",
    "method": "json",
    "om_terrain": [ "urban_39_8" ],
    "weight": 250,
    "object": {
      "fill_ter": "t_floor",
      "rows": [
        "........................",
        "........................",
        "........................",
        "lll.....................",
        "bbl.....................",
        "bbl.....................",
        "  l.....................",
        "--l......888888888888888",
        "2BllwlllllRRRRRRRRRRRRR8",
        "TBl   l  lRRRRRRRRRRRRR8",
        "lll   +  +RRRRRRRRRRRRR8",
        "      l <lRRRRRRRRRRRRR8",
        "      llllRRRRRRRRRRRRR8",
        "      =77lRRRRRRRRRRRRR8",
        "lll   =77lRRRRRRRRRRRRR8",
        "TBlK  l77lRRRRRRRRRRRRR8",
        "2Bllwlllll88888888888888",
        "--l.....................",
        "  l.....................",
        " dl.....................",
        "6dl.....................",
        "lll.....................",
        "........................",
        "........................"
      ],
      "palettes": [ "acidia_residential_commercial_palette" ],
      "toilets": { "T": {  } },
      "items": {
        " ": { "item": "livingroom", "chance": 1 },
        "2": { "item": "softdrugs", "chance": 10 },
        "b": { "item": "bed", "chance": 60 },
        "d": { "item": "office", "chance": 40 }
      },
      "place_monsters": [ { "monster": "GROUP_ZOMBIE", "x": [ 1, 5 ], "y": [ 9, 15 ], "density": 0.25 } ]
    }
  },
  {
    "type": "mapgen",
    "method": "json",
    "om_terrain": [ "urban_39_9" ],
    "weight": 250,
    "object": {
      "fill_ter": "t_floor",
      "rows": [
        "........................",
        "...........89998........",
        "...........800{8........",
        "899999999998RRR899999999",
        "8RRRRRRRRRRRRRRRRRRRRRRR",
        "8RRRRRRRRRRRRRRRRRRRRRRR",
        "8RRRRRRRRRRRRRRRRRRRRRRR",
        "8RRRRRRRRRRRRRRRRRRRRRRR",
        "8RRRRRRRRRRRRRRRRRRRRRRR",
        "8RRRRZZ)RRRRRRRRZZ)RRRRR",
        "8RRRRZZ)RRRRRRRRZZ)RRRRR",
        "8RRRRRRRRRRRRRRRRRRRRRRR",
        "8RRRRRRRRRRRRRRRRRRRRRRR",
        "8RRRRRRRRRRRRRRRRRRRRRRR",
        "8RRRRRRRRRRRRRRRRRRRRRRR",
        "8RRRRRRRRRRRRRRRRRRRRRRR",
        "8RRRRRRRRRRRRRRRRRRRRRRR",
        "8RRRRRRRRRRRRRRRRRRRRRRR",
        "8RRRRRRRRRRRRRRRRRRRRRRR",
        "8RRRRRRRRRRRRRRRRRRRRRRR",
        "8RRRRRRRRRRRRRRRRRRRRRRR",
        "899999999999999999999999",
        "........................",
        "........................"
      ],
      "palettes": [ "acidia_residential_commercial_palette" ],
      "place_monsters": [ { "monster": "GROUP_ZOMBIE", "x": [ 1, 22 ], "y": [ 1, 22 ], "density": 0.06 } ]
    }
  },
  {
    "type": "mapgen",
    "method": "json",
    "om_terrain": [ "urban_39_10" ],
    "weight": 250,
    "object": {
      "fill_ter": "t_floor",
      "rows": [
        "........................",
        "........................",
        "........................",
        "998.....................",
        "RR8.....................",
        "RR8.....................",
        "RR8.....................",
        "RR8.....................",
        "RR89999998..............",
        "RRRRRRRRR8..............",
        "RRRRRRRRR8..............",
        "RRRRRRRRR8..............",
        "RRRRRRRRR8..............",
        "RRRRRRRRR8..............",
        "RRRRRRRRR8..............",
        "RRRRRRRRR8..............",
        "RR89999998..............",
        "RR8.....................",
        "RR8.....................",
        "RR8.....................",
        "RR8.....................",
        "998.....................",
        "........................",
        "........................"
      ],
      "palettes": [ "acidia_residential_commercial_palette" ],
      "place_monsters": [ { "monster": "GROUP_ZOMBIE", "x": [ 1, 22 ], "y": [ 1, 22 ], "density": 0.06 } ]
    }
  }
]
