[
  {
    "type": "mapgen",
    "method": "json",
    "om_terrain": [ "urban_7_2" ],
    "object": {
      "fill_ter": "t_floor",
      "rotation": 2,
      "rows": [
        "########################",
        "#,,,,,,,|---|-----------",
        "#,,,,#;;|W D|ffCoCSC2   ",
        "#,,,;;;;!   +22222222   ",
        "#,,,;#;;|rrr|22CCC222   ",
        "#,,,;,,,|---|22CCC222   ",
        "#,,,;,,,|AtA 22222222 |-",
        "#,,,;,,,w             |#",
        "#,##;,,,w     A       w#",
        "#,##;##,w    At       w#",
        "#,,,;##,|             w#",
        "#,##;,,,|-  -|+-|-|   |#",
        "#,##;##,|O  O|2S|>    !;",
        "#,,,;##,|O  O|2T|>    !;",
        "#,##;,,,|-  -|--|-|   |#",
        "#,##;##,|c           cw#",
        "#,,,;##,wc   httth   cw#",
        "#,##;,,,wc   httth   cw#",
        "#,##;##,|c           c|#",
        "#,,,;##,|-www-----www-|,",
        "#,,,;,,,,#####,,,#####,,",
        "#,,,;;;;;;;;;;;;;;;;;;;;",
        "#,,,,,,,,,,,,,,,,,,,,,,,",
        "########################"
      ],
      "palettes": [ "acidia_residential_commercial_palette" ],
      "terrain": {
        "#": [ "t_region_shrub", "t_region_shrub_fruit", "t_region_shrub_decorative" ],
        ";": "t_concrete",
        ",": "t_region_groundcover_urban"
      },
      "toilets": { "T": {  } },
      "items": {
        " ": { "item": "livingroom", "chance": 2 },
        "A": { "item": "livingroom", "chance": 15 },
        "C": { "item": "kitchen", "chance": 25 },
        "O": { "item": "homebooks", "chance": 60 },
        "c": { "item": "livingroom", "chance": 25 },
        "f": { "item": "SUS_fridge", "chance": 70 },
        "o": { "item": "oven", "chance": 30 },
        "q": { "item": "trash", "chance": 50 },
        "r": { "item": "cannedfood", "chance": 60 },
        "t": { "item": "dining", "chance": 25 }
      },
      "place_monsters": [ { "monster": "GROUP_ZOMBIE", "x": [ 1, 22 ], "y": [ 1, 22 ], "density": 0.09 } ]
    }
  },
  {
    "type": "mapgen",
    "method": "json",
    "om_terrain": [ "urban_7_1" ],
    "object": {
      "fill_ter": "t_floor",
      "rotation": 2,
      "rows": [
        "########################",
        "--|-----|#,,,,,,,,,,,,,#",
        "OO|rrrrr|#,,,,,,,,,,,,,#",
        "  1     !;;;;;,,,,,,,,,#",
        "  |r r r|#,,;;,,###,,,,#",
        "  |r r r|#,,;;,,#^#,,,,#",
        "--|-----|,,,;;,,###,,,,#",
        "`###,,,,,,,,;;,,,,,,,,,#",
        ",,,,,,,;;;;;;;;;,,,,,,,#",
        ",,,,;;;;;;;;;;;;;;;,,,,#",
        ",,,,;;;;;;;;;;;;;;;;,,,#",
        ",,,;;;;,,,###,,,;;;;,,,#",
        ";;;;;;,,,#####,,,;;;,,,#",
        ";;;;;;,,,#####,,,;;;,,,#",
        ",,,;;;;,,,###,,,;;;;,,,#",
        ",,,,;;;;;;;;;;;;;;;;,,,#",
        ",,,,;;;;;;;;;;;;;;;,,,,#",
        ",,,,,,##;;;;;;;##,,,,,,#",
        ",,,,,,##;;;;;;;##,,,,,,#",
        ",,,,,,,,,;;;;;,,,,,,,,,#",
        ",,,,,,,,,,;;;,,,,,,,,,,#",
        ";;;;;;;;;;;;;p̄,,,,,,,,,#",
        ",,,,,,,,,,;;;,,,,,,,,,,#",
        "##########;;;###########"
      ],
      "palettes": [ "acidia_residential_commercial_palette" ],
      "terrain": {
        "#": [ "t_region_shrub", "t_region_shrub_fruit", "t_region_shrub_decorative" ],
        ";": "t_concrete",
        ",": "t_region_groundcover_urban",
        "p̄": "t_region_groundcover_urban",
        "^": [ [ "t_region_tree_fruit", 2 ], [ "t_region_tree_nut", 2 ], "t_region_tree_shade" ]
      },
      "furniture": { "p̄": "f_mailbox" },
      "items": {
        "p̄": { "item": "mail", "chance": 30, "repeat": [ 2, 5 ] },
        " ": { "item": "livingroom", "chance": 2 },
        "O": { "item": "homebooks", "chance": 60 },
        "r": { "item": "farming_seeds", "chance": 60 }
      },
      "place_monsters": [ { "monster": "GROUP_ZOMBIE", "x": [ 1, 22 ], "y": [ 1, 22 ], "density": 0.09 } ]
    }
  },
  {
    "type": "mapgen",
    "method": "json",
    "om_terrain": [ "urban_7_4" ],
    "object": {
      "fill_ter": "t_floor",
      "rotation": 2,
      "rows": [
        "........................",
        "........|-w-w-|-|---|-|-",
        "........w     +r|u u|r+ ",
        "........|     |-|-+-|-| ",
        "........|b    |       + ",
        "........|b    + |-----| ",
        "........|e    | |  bbe|-",
        "........w   OO| |     |`",
        "........|-----| +     w.",
        "........|2TCSC| |dh  ew.",
        "........|B2222+ |6dd e|.",
        "........|B2222| |-|---|.",
        "........|-----|  <|S2B|.",
        "........|r   r|  <|T2B|.",
        "........|--+--|+--|-+-|.",
        "........|e            |.",
        "........we    bbb     w.",
        "........w     bbb     w.",
        "........|    ebbbe  OO|.",
        "........|-------------|.",
        "........................",
        "........................",
        "........................",
        "........................"
      ],
      "palettes": [ "acidia_residential_commercial_palette" ],
      "toilets": { "T": {  } },
      "items": {
        " ": { "item": "livingroom", "chance": 2 },
        "2": { "item": "softdrugs", "chance": 10 },
        "@": { "item": "magazines", "chance": 10 },
        "O": { "item": "homebooks", "chance": 60 },
        "b": { "item": "bed", "chance": 60 },
        "e": { "item": "dresser", "chance": 60 },
        "r": { "item": "bedroom", "chance": 60 },
        "u": { "item": "cleaning", "chance": 60 }
      },
      "place_monsters": [ { "monster": "GROUP_ZOMBIE", "x": [ 9, 19 ], "y": [ 2, 18 ], "density": 0.09 } ]
    }
  },
  {
    "type": "mapgen",
    "method": "json",
    "om_terrain": [ "urban_7_3" ],
    "object": {
      "fill_ter": "t_floor",
      "rotation": 2,
      "rows": [
        "........................",
        "vvvvvvv-|...............",
        " tA   At|...............",
        " A      v...............",
        "        v...............",
        "    AtA |...............",
        "vvvvvvv-|...............",
        "........................",
        "........................",
        "........................",
        "........................",
        "........................",
        "........................",
        "........................",
        "........................",
        "........................",
        "........................",
        "........................",
        "........................",
        "........................",
        "........................",
        "........................",
        "........................",
        "........................"
      ],
      "palettes": [ "acidia_residential_commercial_palette" ],
      "items": {
        " ": { "item": "livingroom", "chance": 2 },
        "A": { "item": "livingroom", "chance": 15 },
        "t": { "item": "coffee_table", "chance": 25 }
      },
      "place_monsters": [ { "monster": "GROUP_ZOMBIE", "x": [ 1, 7 ], "y": [ 2, 5 ], "density": 0.09 } ]
    }
  },
  {
    "type": "mapgen",
    "method": "json",
    "om_terrain": [ "urban_7_6" ],
    "object": {
      "fill_ter": "t_floor",
      "rotation": 2,
      "rows": [
        "........................",
        "........1111111111111111",
        "........4RRRRRRRRRRRRRRR",
        "........4RRRRRRRRRRRRRRR",
        "........4RRRRRGRRRRRRRRR",
        "........4RRRRRRRRRRRRRRR",
        "........4RRRRRRRRRRRRR33",
        "........4RRRRRRRRRRRRR5.",
        "........4RRRRRRRRRRRRR2.",
        "........4R!RRRRRRRRRRR2.",
        "........4RRRRRRRRRRRRR2.",
        "........4RRRRRRRRRRRRR2.",
        "........4RRRRRRRRRRRRR2.",
        "........4RRRRRRRRRR!RR2.",
        "........4RRRRRRRRRRRRR2.",
        "........4RRRRRRRRRRRRR2.",
        "........4RR^RRRRRRRRRR2.",
        "........4RRRRRRRRRRRRR2.",
        "........4RRRRRRRRRRRRR2.",
        "........333333333333333.",
        "........................",
        "........................",
        "........................",
        "........................"
      ],
      "palettes": [ "acidia_residential_roof_palette" ]
    }
  },
  {
    "type": "mapgen",
    "method": "json",
    "om_terrain": [ "urban_7_5" ],
    "object": {
      "fill_ter": "t_floor",
      "rotation": 2,
      "rows": [
        "........................",
        "111111112...............",
        "RRRRRRRR2...............",
        "RRRRRRRR2...............",
        "RRRRRRRR2...............",
        "RRRRRRRR2...............",
        "333333333...............",
        "........................",
        "........................",
        "........................",
        "........................",
        "........................",
        "........................",
        "........................",
        "........................",
        "........................",
        "........................",
        "........................",
        "........................",
        "........................",
        "........................",
        "........................",
        "........................",
        "........................"
      ],
      "palettes": [ "acidia_residential_roof_palette" ]
    }
  }
]
