[
  {
    "type": "mapgen",
    "method": "json",
    "om_terrain": [ [ "urban_9_1", "urban_9_2" ] ],
    "object": {
      "fill_ter": "t_floor",
      "rows": [
        "...__________...................``p.............",
        "...__________...%%..............``..............",
        ".[.__________..%%%%............%``%.........[...",
        "...__________...%%....!!!%!!!.%````%............",
        "...__________........##o###o####**##o####^......",
        "...__________........#T xxx y|L    Y   R#.......",
        "...__________........#                 R#.......",
        "...__________........os      |<|  |     o.......",
        "...__________..[.....#Hll    |||  |TEsE #.......",
        "...__________........#HHHH E |w+  ||||||#%......",
        "...__________........####o######  +,,|,6#%%.....",
        "...__________.....%%.^....`````#,,|St|,6#%%.....",
        "...__________....%%%%.....`````*,,||||+|#%......",
        "...__________```..%%......`````#,,,00,,3#.......",
        "..._________&````.........`````o,,,JJ,,O#.......",
        "..##========##.````````````````o,,,,,,,7o.......",
        "..#U''''''''&#.````````````````#,F4n5321#.......",
        "..#''''''''''##*o#.............#####o####.......",
        "..o''''''''''#g''#........%%.......!!!..........",
        "..#''''''''''+''W#..u....%%%%...................",
        "..o'''''Á'''q#<'Z#........%%....................",
        "..#N''''''''q#####.................[............",
        "..#NA'''''''q#^.................................",
        "..############.................................."
      ],
      "palettes": [
        "standard_domestic_palette",
        "standard_domestic_lino_kitchen",
        "standard_domestic_lino_bathroom",
        "standard_domestic_landscaping_palette"
      ],
      "terrain": {
        "=": "t_door_metal_locked",
        "&": "t_gates_control_brick",
        "'": "t_thconc_floor",
        "q": "t_thconc_floor",
        "U": "t_thconc_floor",
        "N": "t_thconc_floor",
        "A": "t_thconc_floor",
        "Á": "t_thconc_floor",
        "W": "t_thconc_floor",
        "Z": "t_thconc_floor",
        "g": "t_thconc_floor",
        ",": "t_linoleum_gray",
        "0": "t_linoleum_gray"
      },
      "furniture": { "0": "f_stool" },
      "place_loot": [ { "item": "television", "x": 25, "y": 5, "chance": 100 }, { "item": "stereo", "x": 25, "y": 5, "chance": 65 } ],
      "vehicles": { "Á": { "vehicle": "suburban_home", "chance": 30, "rotation": 90 } }
    }
  },
  {
    "type": "mapgen",
    "method": "json",
    "om_terrain": [ [ "urban_9_3", "urban_9_4" ] ],
    "object": {
      "fill_ter": "t_floor",
      "rows": [
        "~~~~~~~~~~~~~~~~~~~~~~~~~~~~~~~~~~~~~~~~~~~~~~~~",
        "~~~~~~~~~~~~~~~~~~~~~~~~~~~~~~~~~~~~~~~~~~~~~~~~",
        "~~~~~~~~~~~~~~~~~~~~~~~~~~~~~~~~~~~~~~~~~~~~~~~~",
        "~~~~~~~~~~~~~~~~~~~~~~~~~~~~~~~~~~~~~~~~~~~~~~~~",
        "~~~~~~~~~~~~~~~~~~~~~#####o######o#######~~~~~~~",
        "~~~~~~~~~~~~~~~~~~~~~#¤@@¤   +D|t,B|yIII#^~~~~~~",
        "~~~~~~~~~~~~~~~~~~~~~# @@   d|||8,B|R hI#~~~~~~~",
        "~~~~~~~~~~~~~~~~~~~~~o      d|>|S,,|R   o~~~~~~~",
        "~~~~~~~~~~~~~~~~~~~~~#    h  | ||+||   E#~~~~~~~",
        "~~~~~~~~~~~~~~~~~~~~~#RR III +     + HHT#~~~~~~~",
        "~~~~~~~~~~~~~~~~~~~~~#####o#####|+||||||#~~~~~~~",
        "~~~~~~~~~~~~~~~~~~~~~~^~~~~~~~~#y b|D  D#~~~~~~~",
        "~~~~~~~~~~~~~~~~~~~~~~~~~~~~~~~#   ||+||#~~~~~~~",
        "~~~~~~~~~~~~~~~~~~~~~~~~~~~~~~~#E     dd#~~~~~~~",
        "~~~~~~~~~~~~~~~~~~~~~~~~~~~~~~~os       o~~~~~~~",
        "~~###o####o###~~~~~~~~~~~~~~~~~#E   @@  #~~~~~~~",
        "~~#xxy 6475O2#~~~~~~~~~~~~~~~~~#y  ¤@@¤ #~~~~~~~",
        "~~#    ,,,,,1#&&&#~~~~~~~~~~~~~##########~~~~~~~",
        "~~oHl  JJ,,,F#yyy&~~~~~~~~~~~~~~~~~~~~~~~~~~~~~~",
        "~~#HHH AA    +  i&~~~~~~~~~~~~~~~~~~~~~~~~~~~~~~",
        "~~o      Y|||#> i&~~~~~~~~~~~~~~~~~~~~~~~~~~~~~~",
        "~~# @@    +,S#&&&#~~~~~~~~~~~~~~~~~~~~~~~~~~~~~~",
        "~~#¤@@ ddD|t8#~~~~~~~~~~~~~~~~~~~~~~~~~~~~~~~~~~",
        "~~####o#######^~~~~~~~~~~~~~~~~~~~~~~~~~~~~~~~~~"
      ],
      "palettes": [ "standard_domestic_palette", "standard_domestic_lino_kitchen", "standard_domestic_lino_bathroom" ],
      "terrain": { "~": "t_open_air", ",": "t_linoleum_gray", "&": "t_screened_porch_wall" },
      "place_loot": [ { "item": "television", "x": 4, "y": 16, "chance": 100 }, { "item": "stereo", "x": 4, "y": 16, "chance": 65 } ]
    }
  },
  {
    "type": "mapgen",
    "method": "json",
    "om_terrain": [ [ "urban_9_5", "urban_9_6" ] ],
    "object": {
      "fill_ter": "t_shingle_flat_roof",
      "rows": [
        "                                                ",
        "                                                ",
        "                                                ",
        "                                                ",
        "                     -------------------5       ",
        "                     -..................-       ",
        "                     -...........=......-       ",
        "                     -.&................-       ",
        "                     -..................-       ",
        "                     -..................-       ",
        "                     5----------........-       ",
        "                               -........-       ",
        "                               -......X.-       ",
        "                               -........-       ",
        "                               -........-       ",
        "  ------------                 -........-       ",
        "  -..........-                 -........-       ",
        "  -.......&..-----             ----------       ",
        "  -..............-                              ",
        "  -..N...........-                              ",
        "  -..............-                              ",
        "  -........=.-----                              ",
        "  -..........-                                  ",
        "  -----------5                                  "
      ],
      "palettes": [ "roof_palette" ],
      "terrain": { ".": "t_shingle_flat_roof" }
    }
  }
]
