[
  {
    "type": "mapgen",
    "method": "json",
    "om_terrain": [ [ "urban_8_1", "urban_8_2" ] ],
    "object": {
      "fill_ter": "t_floor",
      "rows": [
        "..........p`....................................",
        ".{{{{{{{{{{({{{{{{{{{{{{{{{{{{{{{{{{{{{{{{{{{{{.",
        ".{.......`````````````````....................{.",
        ".{.......`````...........`.....%%.............{.",
        ".{.^#######*##oo####^....`.....%%..[...%%.....{.",
        ".{..#t,8S|L     E R#.....`.............%%.....{.",
        ".{..o,,,,+    Hl  x#.....`....................{.",
        ".{..#|||+|    Hl  x#.....````````````.........{.",
        ".{..#Db|w|<       yo.....`........$...........{.",
        ".{..#|+||||| ||||||#.....`.0000...............{.",
        ".{..#T   dd| |JJ66F#.....`.0000...............{.",
        ".{..oE     +  ,,,,,#.....`.0000...............{.",
        ".{..o  @@  |+|1,,,,*``````.0000...............{.",
        ".{..#R @@ Y|U|2O354#..`....0000...............{.",
        ".{..######o######o##..`...........€...........{.",
        ".{..^..............^..`.......................{.",
        ".{....................`..u....................{.",
        ".{.........00000......`.....[.............%%..{.",
        ".{.........00000...)))])))................%%..{.",
        ".{....[....00000...)W~~~q)...%%...............{.",
        ".{.........00000...)Z~~~q)...%%.....`.........{.",
        ".{.................)g~~~q)....................{.",
        ".{{{{{{{{{{{{{{{{{{))))))){{{{{{{{{{{{{{{{{{{{{.",
        "................................................"
      ],
      "palettes": [
        "standard_domestic_palette",
        "standard_domestic_lino_kitchen",
        "standard_domestic_lino_bathroom",
        "standard_domestic_landscaping_palette"
      ],
      "terrain": {
        ",": "t_linoleum_gray",
        "(": "t_chaingate_c",
        "{": "t_chainfence",
        "]": "t_door_metal_pickable",
        ")": "t_wall_metal",
        "~": "t_metal_floor",
        "g": "t_metal_floor",
        "W": "t_metal_floor",
        "Z": "t_metal_floor",
        "q": "t_metal_floor",
        "0": "t_dirtmound",
        "$": "t_region_groundcover_urban",
        "€": "t_region_groundcover_urban"
      },
      "nested": { "$": { "chunks": [ "greenhouse_6x6_herbal" ] }, "€": { "chunks": [ "greenhouse_6x6_vegetable" ] } },
      "place_loot": [ { "item": "television", "x": 18, "y": 6, "chance": 100 }, { "item": "stereo", "x": 18, "y": 6, "chance": 65 } ]
    }
  },
  {
    "type": "mapgen",
    "method": "json",
    "om_terrain": [ [ "urban_8_3", "urban_8_4" ] ],
    "object": {
      "fill_ter": "t_floor",
      "rows": [
        "~~~~~~~~~~~~~~~~~~~~~~~~~~~~~~~~~~~~~~~~~~~~~~~~",
        "~~~~~~~~~~~~~~~~~~~~~~~~~~~~~~~~~~~~~~~~~~~~~~~~",
        "~~~~~~~~~~~~~~~~~~~~~~~~~~~~~~~~~~~~~~~~~~~~~~~~",
        "~~~~~~~~~~~~~~~~~~~~~~~~~~~~~~~~~~~~~~~~~~~~~~~~",
        "~~~~^&&&&#oooo#&&&&^~~~~~~~~~~~~~~~~~~~~~~~~~~~~",
        "~~~~######yIIT##oo##~~~~~~~~~~~~~~~~~~~~~~~~~~~~",
        "~~~~#D  D|  h RR   #~~~~~~~~~~~~~~~~~~~~~~~~~~~~",
        "~~~~#||+||||     @@#~~~~~~~~~~~~~~~~~~~~~~~~~~~~",
        "~~~~#@d y|>|     @@#~~~~~~~~~~~~~~~~~~~~~~~~~~~~",
        "~~~~o@   + + ddD   o~~~~~~~~~~~~~~`````~~~~~~~~~",
        "~~~~#    | ||||||+|#~~~~~~~~~~~~~~`````~~~~~~~~~",
        "~~~~#    |+|StB|  U#~~~~~~~~~~~~~~`````~~~~~~~~~",
        "~~~~#d@@ |,,,,B|v q#~~~~~~~~~~~~~~`````~~~~~~~~~",
        "~~~~####o###o#######~~~~~~~~~~~~~~`````~~~~~~~~~",
        "~~~~^&&&&&&&&&&&&&&^~~~~~~~~~~~~~~~~~~~~~~~~~~~~",
        "~~~~~~~~~~~~~~~~~~~~~~~~~~~~~~~~~~`````~~~~~~~~~",
        "~~~~~~~~~~~~~~~~~~~~~~~~~~~~~~~~~~`````~~~~~~~~~",
        "~~~~~~~~~~~~~~~~~~~~~~~~~~~~~~~~~~`````~~~~~~~~~",
        "~~~~~~~~~~~~~~~~~~~&&&&&&&~~~~~~~~`````~~~~~~~~~",
        "~~~~~~~~~~~~~~~~~~~&&&&&&&~~~~~~~~`````~~~~~~~~~",
        "~~~~~~~~~~~~~~~~~~~&&&&&&&~~~~~~~~~~~~~~~~~~~~~~",
        "~~~~~~~~~~~~~~~~~~~&&&&&&&~~~~~~~~~~~~~~~~~~~~~~",
        "~~~~~~~~~~~~~~~~~~~&&&&&&&~~~~~~~~~~~~~~~~~~~~~~",
        "~~~~~~~~~~~~~~~~~~~~~~~~~~~~~~~~~~~~~~~~~~~~~~~~"
      ],
      "palettes": [ "standard_domestic_palette", "standard_domestic_lino_bathroom" ],
      "terrain": { "~": "t_open_air", ",": "t_linoleum_gray", "&": "t_shingle_flat_roof", "`": "t_glass_roof" }
    }
  },
  {
    "type": "mapgen",
    "method": "json",
    "om_terrain": "urban_8_6",
    "object": {
      "fill_ter": "t_shingle_flat_roof",
      "rows": [
        "                        ",
        "                        ",
        "                        ",
        "                        ",
        "         ------         ",
        "    5-----....-----5    ",
        "    -.......N......-    ",
        "    -..............-    ",
        "    -..............-    ",
        "    -..............-    ",
        "    -..............-    ",
        "    -........=.....-    ",
        "    -..............-    ",
        "    5--------------5    ",
        "                        ",
        "                        ",
        "                        ",
        "                        ",
        "                        ",
        "                        ",
        "                        ",
        "                        ",
        "                        ",
        "                        "
      ],
      "palettes": [ "roof_palette" ],
      "terrain": { ".": "t_shingle_flat_roof" }
    }
  }
]
