[
  {
    "type": "mapgen",
    "method": "json",
    "om_terrain": [ [ "urban_16_1", "urban_16_2" ] ],
    "object": {
      "fill_ter": "t_floor",
      "rows": [
        ".....................```.p.......________.......",
        ".....................```.........________.......",
        "..[...###o#######o####*##oo####..________.......",
        "......#@ II |89|y @@|L       y##.________..%....",
        "......#@  h +,,+   d|||R HH   a#.________.%%%...",
        "......#T    |tS|    +D|R Hl   ##.________..%....",
        "......#|+||+||||+||||||R H   x#..________.......",
        ".....^#D d|                   #..________....[..",
        "......#|||||+|||||||+||0f0,,,1#..________.......",
        "......#¤   b   + D|S,t|0f0,,,5o..________..%....",
        "......#@@     d||||||||,,,,,,O#..________.%%%...",
        "..[...#@@   h  +,,,,,,|6,,7432#..________..%....",
        "......#¤   IIIy|S8BB|t|6,,F|||#.&________.......",
        "......###oo############Y,,J|ZW###========##.....",
        "..........````````````*,,,,+,,#'&'''''''''#.....",
        "..........````````````###  |||#'''''''''''#.....",
        "..........``````````````#     #'''''''''''o.....",
        "..........``````````````#|+|| +'''''''''''#.....",
        ".....%..............````*  L||#''''''Á'''N#.....",
        "....%%%..........u..````#ii +U#'''''''''ANo.....",
        ".....%..............````##o####q'''''''''N#.....",
        "..............................#q''''''''''#...[.",
        "...............[..............#############.....",
        "..........................................^....."
      ],
      "palettes": [
        "standard_domestic_palette",
        "standard_domestic_lino_kitchen",
        "standard_domestic_lino_bathroom",
        "standard_domestic_landscaping_palette"
      ],
      "terrain": {
        "=": "t_door_metal_locked",
        "&": "t_gates_control_brick",
        "'": "t_thconc_floor",
        "q": "t_thconc_floor",
        "N": "t_thconc_floor",
        "A": "t_thconc_floor",
        "Á": "t_thconc_floor",
        ",": "t_linoleum_gray",
        "f": "t_linoleum_gray",
        "0": "t_linoleum_gray",
        "Y": "t_linoleum_gray",
        "Z": "t_linoleum_gray",
        "W": "t_linoleum_gray"
      },
      "furniture": { "0": "f_chair" },
      "place_loot": [ { "item": "television", "x": 29, "y": 6, "chance": 100 }, { "item": "stereo", "x": 29, "y": 6, "chance": 65 } ],
      "vehicles": { "Á": { "vehicle": "suburban_home", "chance": 100, "rotation": 90 } }
    }
  },
  {
    "type": "mapgen",
    "method": "json",
    "om_terrain": [ [ "urban_16_3", "urban_16_4" ] ],
    "object": {
      "fill_ter": "t_shingle_flat_roof",
      "rows": [
        "                                                ",
        "                                                ",
        "      -------------------------                 ",
        "      -.......................--                ",
        "      -.......=...............~-                ",
        "      -...................N...--                ",
        "      -.......................-                 ",
        "      5.......................-                 ",
        "      -.......................-                 ",
        "      -.......................-                 ",
        "      -.......................-                 ",
        "      -.............=.........-                 ",
        "      -.......................-                 ",
        "      -----------------.......-------------     ",
        "                      -...................-     ",
        "                      ---.................-     ",
        "                        -.................-     ",
        "                        -.................-     ",
        "                        -.................-     ",
        "                        -.................-     ",
        "                        -------...........-     ",
        "                              -...........-     ",
        "                              ------------5     ",
        "                                                "
      ],
      "palettes": [ "roof_palette" ],
      "terrain": { ".": "t_shingle_flat_roof" }
    }
  }
]
