[
  {
    "type": "mapgen",
    "method": "json",
    "om_terrain": [ [ "urban_11_1", "urban_11_2" ] ],
    "object": {
      "fill_ter": "t_floor",
      "rows": [
        "........________p...............................",
        "......%.________.%...............[..............",
        "........________................................",
        "......%.________.%..............................",
        "........________........................[.......",
        "..[...%.________...........[....................",
        "........________```````.........................",
        "......%.________```````.........................",
        "........________&...```.%..%..%..%..%%..........",
        "......##========#####*#o#######o#####%..........",
        ".....%#'''''''''&|Q +    L   HH  ETy#...........",
        ".....%o''''''''''||||        H l   x#.......[...",
        ".....%#''''''''''+'q|        H l   x#...........",
        "......#q'''''''''||||+| |<    000   o...........",
        "......#q'''''''''|B,,,| |||  |JJJ|||#...........",
        "......#q''''Á''''|Bt8S|,|66,,,,,,,,F#...........",
        ".....^#''''''''''||||||,,,,,,,,,,,,7#^..........",
        "......o''''''''A'+    +,,,hffh,,,,,5o...........",
        ".....%#'''''''NN'|ZW  |Y,,hffh,43O21#%..........",
        ".....%#############o#*#####oo########%..........",
        ".....%%%...........`````..%%%%.....%%%..........",
        ".................u.`````..................[.....",
        "..[.............................................",
        "................................................"
      ],
      "palettes": [
        "standard_domestic_palette",
        "standard_domestic_lino_kitchen",
        "standard_domestic_lino_bathroom",
        "standard_domestic_landscaping_palette"
      ],
      "terrain": {
        "=": "t_door_metal_locked",
        "&": "t_gates_control_brick",
        "'": "t_thconc_floor",
        "q": "t_thconc_floor",
        "N": "t_thconc_floor",
        "A": "t_thconc_floor",
        "Á": "t_thconc_floor",
        ",": "t_linoleum_gray",
        "Y": "t_linoleum_gray",
        "h": "t_linoleum_gray",
        "f": "t_linoleum_gray",
        "Q": "t_floor",
        "J": "t_floor"
      },
      "furniture": { "0": "f_stool" },
      "place_loot": [ { "item": "television", "x": 35, "y": 11, "chance": 100 }, { "item": "stereo", "x": 35, "y": 12, "chance": 65 } ],
      "vehicles": { "Á": { "vehicle": "suburban_home", "chance": 100, "rotation": 90 } }
    }
  },
  {
    "type": "mapgen",
    "method": "json",
    "om_terrain": [ [ "urban_11_3", "urban_11_4" ] ],
    "object": {
      "fill_ter": "t_floor",
      "rows": [
        "~~~~~~~~~~~~~~~~~~~~~~~~~~~~~~~~~~~~~~~~~~~~~~~~",
        "~~~~~~~~~~~~~~~~~~~~~~~~~~~~~~~~~~~~~~~~~~~~~~~~",
        "~~~~~~~~~~~~~~~~~~~~~~~~~~~~~~~~~~~~~~~~~~~~~~~~",
        "~~~~~~~~~~~~~~~~~~~~~~~~~~~~~~~~~~~~~~~~~~~~~~~~",
        "~~~~~~~~~~~~~~~~~~~~~~~~~~~~~~~~~~~~~~~~~~~~~~~~",
        "~~~~~~~~~~~~~~~~~~~~~~~~~~~~~~~~~~~~~~~~~~~~~~~~",
        "~~~~~~~~~~~~~~~~~~~~~~~~~~~~~~~~~~~~~~~~~~~~~~~~",
        "~~~~~~~~~~~~~~~~~~~~~~~~~~~~~~~~~~~~~~~~~~~~~~~~",
        "~~~~~~~~~~~~~~~~~~~~~~~~~~~~~~~~~~~~~~~~~~~~~~~~",
        "~~~~~~&&&&&&&&&&&&&&&&&&&&&&&&&&&&&&&~~~~~~~~~~~",
        "~~~~~~&&&&#oo#&&&&&#ooo#&&&&&#oo#&&&&~~~~~~~~~~~",
        "~~~~~~#####ii#######iii#######HH#####~~~~~~~~~~~",
        "~~~~~~# bd   III|         +     ddbD#~~~~~~~~~~~",
        "~~~~~~#¤      hI| |||||||>|         #~~~~~~~~~~~",
        "~~~~~~o@@       + |8S8S8|||         o~~~~~~~~~~~",
        "~~~~~^#@@      D|||,,,,,| +      @@ #^~~~~~~~~~~",
        "~~~~~~#¤        +,,,,,,t|D|R    ¤@@¤#~~~~~~~~~~~",
        "~~~~~~#####HH#######BBB#######ii#####~~~~~~~~~~~",
        "~~~~~~&&&&#oo#&&&&&#ooo#&&&&&#oo#&&&&~~~~~~~~~~~",
        "~~~~~~&&&&&&&&&&&&&&&&&&&&&&&&&&&&&&&~~~~~~~~~~~",
        "~~~~~~~~~~~~~~~~~~~~~~~~~~~~~~~~~~~~~~~~~~~~~~~~",
        "~~~~~~~~~~~~~~~~~~~~~~~~~~~~~~~~~~~~~~~~~~~~~~~~",
        "~~~~~~~~~~~~~~~~~~~~~~~~~~~~~~~~~~~~~~~~~~~~~~~~",
        "~~~~~~~~~~~~~~~~~~~~~~~~~~~~~~~~~~~~~~~~~~~~~~~~"
      ],
      "palettes": [ "standard_domestic_palette", "standard_domestic_lino_bathroom" ],
      "terrain": { ",": "t_linoleum_gray", "~": "t_open_air", "&": "t_shingle_flat_roof" }
    }
  },
  {
    "type": "mapgen",
    "method": "json",
    "om_terrain": [ [ "urban_11_5", "urban_11_6" ] ],
    "object": {
      "fill_ter": "t_shingle_flat_roof",
      "rows": [
        "                                                ",
        "                                                ",
        "                                                ",
        "                                                ",
        "                                                ",
        "                                                ",
        "                                                ",
        "                                                ",
        "                                                ",
        "                                                ",
        "          ----     -----     ----               ",
        "      -----..-------...-------..-----           ",
        "      -.............................-           ",
        "      -.............................-           ",
        "      -.............................-           ",
        "      -....&....................N...-           ",
        "      5............=................5           ",
        "      -----..-------...-------..-----           ",
        "          ----     -----     ----               ",
        "                                                ",
        "                                                ",
        "                                                ",
        "                                                ",
        "                                                "
      ],
      "palettes": [ "roof_palette" ],
      "terrain": { ".": "t_shingle_flat_roof" }
    }
  }
]
