[
  {
    "type": "mapgen",
    "method": "json",
    "om_terrain": [ [ "urban_15_1", "urban_15_2" ] ],
    "object": {
      "fill_ter": "t_floor",
      "rows": [
        "....p._______...................................",
        "......_______.....................[.............",
        "......_______````````````.......................",
        "......_______```......```..................[....",
        ".....&_______```%%%%%.```#####o##o#######.......",
        "....##=======#*##ooo###*##D|II¤@@¤ |8,BB#.......",
        "....#&'''''''''|4n5321  L| + h @@  |S,,,o.......",
        "....#''''''''''|7,,,,,   |||      E|S,,t#.......",
        "....#''''''''''|O,JJ0,   +6|ydb   T|8,,,#.......",
        "....#q'''''''''|J,JJ0,  R||||||||+|||+||#.......",
        "....#q''''Á''''|J,JJ0,     <          |D#.......",
        "...^#N'''''''''|F,,,,,                | #.......",
        "....#NA''''''''|               y||+||||+#.......",
        "....#||||||||+||  hffh    H l  x|T  dbd #.......",
        "....#g            hffh    H l  x|       #.......",
        "....#?   ||+||+|  hffh    H    x|  @@   #.......",
        "....#??ZW|S,t|U|E         HHHH T|y¤@@¤  #.......",
        "....##oo#########o#**#o####ooo####o###o##^......",
        ".................``````.........................",
        "..............u..``````...................[.....",
        ".........[......................................",
        "................................................",
        "............................[...................",
        "................................................"
      ],
      "palettes": [
        "standard_domestic_palette",
        "standard_domestic_lino_kitchen",
        "standard_domestic_lino_bathroom",
        "standard_domestic_landscaping_palette"
      ],
      "terrain": {
        "=": "t_door_metal_locked",
        "&": "t_gates_control_brick",
        "'": "t_thconc_floor",
        "q": "t_thconc_floor",
        "N": "t_thconc_floor",
        "A": "t_thconc_floor",
        "Á": "t_thconc_floor",
        ",": "t_linoleum_gray",
        "0": "t_linoleum_gray"
      },
      "furniture": { "0": "f_stool", "?": "f_counter" },
      "place_loot": [ { "item": "television", "x": 31, "y": 14, "chance": 100 }, { "item": "stereo", "x": 31, "y": 14, "chance": 65 } ],
      "vehicles": { "Á": { "vehicle": "suburban_home", "chance": 100, "rotation": 90 } }
    }
  },
  {
    "type": "mapgen",
    "method": "json",
    "om_terrain": [ [ "urban_15_3", "urban_15_4" ] ],
    "object": {
      "fill_ter": "t_floor",
      "rows": [
        "~~~~~~~~~~~~~~~~~~~~~~~~~~~~~~~~~~~~~~~~~~~~~~~~",
        "~~~~~~~~~~~~~~~~~~~~~~~~~~~~~~~~~~~~~~~~~~~~~~~~",
        "~~~~~~~~~~~~~~~~~~~~~~~~~~~~~~~~~~~~~~~~~~~~~~~~",
        "~~~~~~~~~~~~~~~~~~~~~~~~~~~~~~~~~~~~~~~~~~~~~~~~",
        "~~~~~~~~~~~~~~~~~~~~~~~~-----------------~~~~~~~",
        "~~~~---------------------&&&&&&&&&&&&&&&-~~~~~~~",
        "~~~~-&&&&&&&&&&&&&&&&&&&&&&&&&&&&&&&&&&&-~~~~~~~",
        "~~~~-&&&&&&&&&&&&&&&&&&&&&&&&&&&&&&&&&&&-~~~~~~~",
        "~~~~-&&&&&&&&&&&&&&&&&&&&&&&&&&&&&&&&&&&-~~~~~~~",
        "~~~~-&&&&&&&&&&&&&^###oo#########&&&&&&&-~~~~~~~",
        "~~~~-&&&&&&&&&&&&&&#RR  yb|>|8S8#&&&&&&&-~~~~~~~",
        "~~~~!&&&&&&&&&&&&&&#      + +,,,o&&&&&&&-~~~~~~~",
        "~~~~-&&&&&&&&&&&&&&#  @@  |||B,,o&&&&&&&-~~~~~~~",
        "~~~~-&&&&&&&&&&&&&&#d¤@@¤ +D|B,t#&&&&&&&-~~~~~~~",
        "~~~~-&&&&&&&&&&&&&&##o##o########&&&&&&&-~~~~~~~",
        "~~~~-&&&&&&&&&&&&&&&&&&&&&&&&&&&&&&&&&&&-~~~~~~~",
        "~~~~-&&&&&&&&&&&&&&&&&&&&&&&&&&&&&&&&&&&-~~~~~~~",
        "~~~~------------------------------------!~~~~~~~",
        "~~~~~~~~~~~~~~~~~~~~~~~~~~~~~~~~~~~~~~~~~~~~~~~~",
        "~~~~~~~~~~~~~~~~~~~~~~~~~~~~~~~~~~~~~~~~~~~~~~~~",
        "~~~~~~~~~~~~~~~~~~~~~~~~~~~~~~~~~~~~~~~~~~~~~~~~",
        "~~~~~~~~~~~~~~~~~~~~~~~~~~~~~~~~~~~~~~~~~~~~~~~~",
        "~~~~~~~~~~~~~~~~~~~~~~~~~~~~~~~~~~~~~~~~~~~~~~~~",
        "~~~~~~~~~~~~~~~~~~~~~~~~~~~~~~~~~~~~~~~~~~~~~~~~"
      ],
      "palettes": [ "standard_domestic_palette", "standard_domestic_lino_bathroom" ],
      "terrain": { ",": "t_linoleum_gray", "~": "t_open_air", "&": "t_shingle_flat_roof", "!": "t_gutter_drop", "-": "t_gutter" }
    }
  },
  {
    "type": "mapgen",
    "method": "json",
    "om_terrain": [ [ "urban_15_5", "urban_15_6" ] ],
    "object": {
      "fill_ter": "t_shingle_flat_roof",
      "rows": [
        "                                                ",
        "                                                ",
        "                                                ",
        "                                                ",
        "                                                ",
        "                                                ",
        "                                                ",
        "                                                ",
        "                                                ",
        "                   5-------------               ",
        "                   -............-               ",
        "                   -...N........-               ",
        "                   -........:...-               ",
        "                   -............-               ",
        "                   --------------               ",
        "                                                ",
        "                                                ",
        "                                                ",
        "                                                ",
        "                                                ",
        "                                                ",
        "                                                ",
        "                                                ",
        "                                                "
      ],
      "palettes": [ "roof_palette" ],
      "terrain": { ".": "t_shingle_flat_roof" }
    }
  }
]
