[
  {
    "type": "mapgen",
    "method": "json",
    "om_terrain": [ [ "urban_10_1", "urban_10_2" ] ],
    "object": {
      "fill_ter": "t_floor",
      "rows": [
        ".......................``p......................",
        ".......................``.......................",
        ".....................[.``.[.....................",
        ".........%%%..%%%......``......%%%..%%%.........",
        ".......###o####o###....``....##ooo##ooo##.......",
        ".......#         R#....``....#y        y#.......",
        ".......#x    HH  R#``````````#M  hffh   o%......",
        "......%#x  l  H  R#``````````#M  hffh   o%......",
        "......%ox  l  H   ###o#**#o###y  hffh   o%......",
        "......%#y     H    iiiL   iii          R#....[..",
        ".......#   TE                          R#.......",
        "......^#|||||||+||||+||  ||+||,,,AA,7|||#^......",
        "..[...%#R        T|S,t|<<|q U|,,,JJ,F|,6#.......",
        "......%o   rh    E############,,,,,,,+,6#.......",
        "......%#R  rrrP   #``````````#Y,325O1|,6#.......",
        ".......##o######o##``````````##*##o######.......",
        "........%%%...%``````~~~~~~``````%..............",
        "..............%``````~~~~~~``````%..............",
        "..[........[..%```~~~~~~~~~~~~```%....[.........",
        "..............%```~~~~~~~~~~~~```%..............",
        "..............%```~~~~~~~~~~~~```%.........[....",
        ".......[......%``````````````````%..............",
        "..............%%%%%%%%%%%%%%%%%%%%..............",
        "................................................"
      ],
      "palettes": [
        "standard_domestic_palette",
        "standard_domestic_lino_kitchen",
        "standard_domestic_lino_bathroom",
        "standard_domestic_landscaping_palette"
      ],
      "terrain": { "~": "t_water_pool_outdoors", ",": "t_linoleum_gray", "Y": "t_linoleum_gray", "A": "t_linoleum_gray" },
      "place_loot": [ { "item": "television", "x": 8, "y": 7, "chance": 100 }, { "item": "stereo", "x": 8, "y": 7, "chance": 65 } ]
    }
  },
  {
    "type": "mapgen",
    "method": "json",
    "om_terrain": [ [ "urban_10_3", "urban_10_4" ] ],
    "object": {
      "fill_ter": "t_floor",
      "rows": [
        "~~~~~~~~~~~~~~~~~~~~~~~~~~~~~~~~~~~~~~~~~~~~~~~~",
        "~~~~~~~~~~~~~~~~~~~~~~~~~~~~~~~~~~~~~~~~~~~~~~~~",
        "~~~~~~~~~~~~~~~~~~~~~~~~~~~~~~~~~~~~~~~~~~~~~~~~",
        "~~~~~~~~~~~~~~~~~~~~~~~~~~~~~~~~~~~~~~~~~~~~~~~~",
        "~~~~~~~####o##o####~~~~~~~~~~####o##o####~~~~~~~",
        "~~~~~~~#RRR Yssy R#~~~~~~~~~~#D|b ¤@@@¤ #~~~~~~~",
        "~~~~~~~o          o~~~~~~~~~~# +   @@@  o~~~~~~~",
        "~~~~~~~#R        R#~~~~~~~~~~#D|   @@@  #~~~~~~~",
        "~~~~~~~#R  EsE    ###o####o###||       d#~~~~~~~",
        "~~~~~~~#R             yiiy     +       d#~~~~~~~",
        "~~~~~~^#|||||||||+|          |+|||dd||+|#^~~~~~~",
        "~~~~~~~#II   Tdd  |||+|  |+|||,,S||||t,S#~~~~~~~",
        "~~~~~~~#Ih        +D|U|>>|q|w+,,8|w,+,,8#~~~~~~~",
        "~~~~~~~oI        @############B,t||||,,,o~~~~~~~",
        "~~~~~~~#   ¤@@  ¤@#~~~~~~~~~~#B,,+ U|,BB#~~~~~~~",
        "~~~~~~~###o####o###~~~~~~~~~~###o####o###~~~~~~~",
        "~~~~~~~~~~~~~~~~~~~~~~~~~~~~~~~~~~~~~~~~~~~~~~~~",
        "~~~~~~~~~~~~~~~~~~~~~~~~~~~~~~~~~~~~~~~~~~~~~~~~",
        "~~~~~~~~~~~~~~~~~~~~~~~~~~~~~~~~~~~~~~~~~~~~~~~~",
        "~~~~~~~~~~~~~~~~~~~~~~~~~~~~~~~~~~~~~~~~~~~~~~~~",
        "~~~~~~~~~~~~~~~~~~~~~~~~~~~~~~~~~~~~~~~~~~~~~~~~",
        "~~~~~~~~~~~~~~~~~~~~~~~~~~~~~~~~~~~~~~~~~~~~~~~~",
        "~~~~~~~~~~~~~~~~~~~~~~~~~~~~~~~~~~~~~~~~~~~~~~~~",
        "~~~~~~~~~~~~~~~~~~~~~~~~~~~~~~~~~~~~~~~~~~~~~~~~"
      ],
      "palettes": [ "standard_domestic_palette", "standard_domestic_lino_bathroom" ],
      "terrain": { "~": "t_open_air", ",": "t_linoleum_gray" }
    }
  },
  {
    "type": "mapgen",
    "method": "json",
    "om_terrain": [ [ "urban_10_5", "urban_10_6" ] ],
    "object": {
      "fill_ter": "t_shingle_flat_roof",
      "rows": [
        "                                                ",
        "                                                ",
        "                                                ",
        "                                                ",
        "       ------------          ------------       ",
        "       -..........-          -..........-       ",
        "       -..........-          -..........-       ",
        "       -..........-          -.....&....-       ",
        "       -..........------------..........-       ",
        "       -................................-       ",
        "       5........X.......................5       ",
        "       -................................-       ",
        "       -.......................=......=.-       ",
        "       -..........------------..........-       ",
        "       -..........-          -..........-       ",
        "       ------------          ------------       ",
        "                                                ",
        "                                                ",
        "                                                ",
        "                                                ",
        "                                                ",
        "                                                ",
        "                                                ",
        "                                                "
      ],
      "palettes": [ "roof_palette" ],
      "terrain": { ".": "t_shingle_flat_roof" }
    }
  }
]
