[
  {
    "type": "mapgen",
    "om_terrain": [ [ "microlab_generic" ] ],
    "method": "json",
    "object": {
      "fill_ter": "t_strconc_floor",
      "rows": [
        " cc  |   c|  |c  c|r    ",
        " cc  |   c|  |c  c|r  c ",
        "     | h 6|  2    2   c ",
        " dd  |==|||22||||||6h   ",
        " hd  |tt|--  -----|6    ",
        "|||22||||-   -fYf-||||||",
        " c|  |##|-dd -f f-|hd^= ",
        " c|  ||||-h  -f f-| d = ",
        " c|    c|-G55-f f-|   [ ",
        "  2    c|-   --2--|   = ",
        "|||    c|-       -||||||",
        "       ?|-Y  cc c-|     ",
        "       ?|-   cc c-|     ",
        "||2||||||-h     c-|  |||",
        "       r|-tt-   c-|  |r ",
        "cc  c  r||((-   Y-|  |r ",
        "cc  c rr|-@;-5- h-|  |r ",
        "       r|-@M5 -dd-|  |r ",
        "||||||rr|---------|  |||",
        "     ||||||||||||||  |c ",
        "  c      6|          |c ",
        "  iccc   6|          2  ",
        "  c      6|  ||22|||||  ",
        "  c c|c   |22|    |cc   "
      ],
      "palettes": [ "microlab" ],
      "terrain": { "G": "t_card_science" },
      "items": { "f": { "item": "mutagens", "chance": 60, "repeat": [ 1, 4 ] } },
      "monster": { "M": { "monster": "mon_mutant_experimental" } },
      "place_monsters": [ { "monster": "GROUP_LAB", "chance": 2, "x": [ 2, 21 ], "y": [ 2, 21 ], "repeat": [ 1, 5 ] } ]
    }
  },
  {
    "type": "mapgen",
    "om_terrain": [ [ "microlab_generic" ] ],
    "method": "json",
    "object": {
      "fill_ter": "t_strconc_floor",
      "rows": [
        "     | cc |  | cc |     ",
        "     2    2  2    | c c ",
        "   F|||||||  |||||||c c ",
        "   F|m 5  |22|0c6c0|c c ",
        "   F|(((  (  |     |    ",
        "|||||m 5  (  |((2((|  ||",
        "  66|(((  (       c|    ",
        "    |m 5  (       6|  c ",
        "  cc||||  |((((   c|  c ",
        "    |  2  5   (    |    ",
        "2((||2||((|  m(    ||2||",
        "   2      (((((    2    ",
        "   2               2    ",
        "2((||              ||2||",
        "   c|      d6d     |c   ",
        " c c| d6d   h   d6d|c c ",
        " c c|  h         h |c c ",
        "   c|              |F   ",
        "|||||              |||2|",
        "c66c|FFFFFF  |ccccc|cc  ",
        " c c|||||||22|||||||    ",
        " c cc(ccc |  |FFFF|  cc ",
        " c        2  ||22||  cc ",
        "     (    |  |    |     "
      ],
      "palettes": [ "microlab" ],
      "terrain": { "0": "t_vat" },
      "monster": { "T": { "monster": "mon_mutant_experimental" } },
      "place_items": [  ],
      "monsters": { "m": { "monster": "GROUP_NETHER" } },
      "place_monsters": [ { "monster": "GROUP_LAB", "chance": 2, "x": [ 2, 21 ], "y": [ 2, 21 ], "repeat": [ 1, 5 ] } ]
    }
  },
  {
    "type": "mapgen",
    "om_terrain": [ [ "microlab_generic" ] ],
    "method": "json",
    "object": {
      "fill_ter": "t_strconc_floor",
      "rows": [
        "     | cc 2  2 cc |     ",
        "     |    |^^|    |cccc ",
        "  ||||||||||||||||||||c ",
        "  |------------------|6 ",
        "  |-F   cccccc -lll -|r ",
        "|||-F          2   c-||2",
        "  |---  cc pp  -  h6-|  ",
        "  |-F   cc pt  - h c-|c ",
        "  |-F   cc pp  -cccc-|c ",
        "  |---         -((((-|  ",
        "2|G            2   t-|||",
        "  5  T----22----  @@-|  ",
        "  5  T-h       5   t-|  ",
        "||-lll-66      5    -|||",
        " |-----(((222---------|c",
        " |-0 0 0 0   0 0 0 0 -| ",
        " |-0 0 0 0   0 0 0 0 -| ",
        "c|-                  -|c",
        "||-0 0 0 0 0 0 0 0 0 -||",
        "c|-0 0 0 0 0 0 0 0 0 -|F",
        " |--------------------|F",
        " |||||||||||||||||||||||",
        " cccc|c   |^^|    |  cc ",
        "    c|c   2  2    |     "
      ],
      "palettes": [ "microlab" ],
      "terrain": { "0": "t_vat", "G": "t_card_science" },
      "furniture": { "t": "f_counter", "p": "f_counter" },
      "monster": { "T": { "monster": "mon_turret_light" } },
      "item": { "0": { "item": "fetus" }, "t": { "item": "iv_mutagen_alpha" } },
      "place_monsters": [ { "monster": "GROUP_LAB", "chance": 2, "x": [ 2, 21 ], "y": [ 2, 21 ], "repeat": [ 1, 5 ] } ]
    }
  },
  {
    "type": "mapgen",
    "om_terrain": [ [ "microlab_generic" ] ],
    "method": "json",
    "object": {
      "fill_ter": "t_strconc_floor",
      "rows": [
        " cc  |   c|  |c  c|r    ",
        " cc  |   c|  |c  c|r  c ",
        "     | h 6|  2    2   c ",
        " dd  |==|||  ||||||6h   ",
        " hd  |tt|--  -----|6    ",
        "|||  ||||-       -||||||",
        " c|  |##|-DDd    -|hd^= ",
        " c|  ||||-       -| d = ",
        " c|      (      c-|   [ ",
        "        |-   A   -|=[== ",
        "|||     |-       -|   ||",
        "             A          ",
        "             Ac   2     ",
        "|| ||   |-       -|  |||",
        "    |  Y|-   A   (   |r ",
        "cc  |    (       (   |r ",
        "cc  |||||-  ddd  -|  |r ",
        "     2 r|-   h   -|  |r ",
        "||2|||rr|--  --((-|  |||",
        "     ||||||  ||  ||  |c ",
        "  c      6|          |c ",
        "  iccc   6|             ",
        "  c      6|  ||22|||||  ",
        "  c c|c   |  |    |cc   "
      ],
      "palettes": [ "microlab" ],
      "terrain": { "A": "t_plut_generator" },
      "place_loot": [ { "item": "corpse", "x": [ 2, 21 ], "y": [ 2, 21 ], "repeat": [ 5, 10 ] } ],
      "place_monster": [
        { "monster": "mon_leech_blossom", "x": 12, "y": 11 },
        { "monster": "mon_leech_pod_cluster", "x": [ 2, 21 ], "y": [ 2, 21 ], "repeat": [ 5, 10 ] },
        { "monster": "mon_leech_stalk", "x": [ 2, 21 ], "y": [ 2, 21 ], "repeat": [ 5, 10 ] }
      ],
      "place_monsters": [ { "monster": "GROUP_LAB", "chance": 2, "x": [ 2, 21 ], "y": [ 2, 21 ], "repeat": [ 1, 5 ] } ]
    }
  },
  {
    "type": "mapgen",
    "om_terrain": [ [ "microlab_generic" ] ],
    "method": "json",
    "object": {
      "fill_ter": "t_strconc_floor",
      "rows": [
        "^|FFF|c  c|  |c  c|     ",
        " ||||||||||  |||||||||| ",
        " |D      D|  |^^^^|ccc| ",
        " |@@    @@|       2   2 ",
        "^|D   T  D|       |   | ",
        "||@@    @@|  |2(((||||||",
        "r|        2  |       O| ",
        "r|||||2||||  |  RR   O| ",
        "r|l  | | l|  |  RR   O| ",
        " |l  | 2 l|  |       O| ",
        "2||||||||||22|  |-tt-|||",
        "           YY|  |-((--|^",
        "           YY|  |-@Ti-|^",
        "|||||2||||||||5G|-@ ;-||",
        " |        |---5----2--| ",
        " | cc  cc |-p   Y   p-| ",
        " | cc  cc |-p   7   p-|t",
        " |     cc |-p   / T p-|t",
        "||     cc |-         -||",
        " |2|||    |-(- -(-   -| ",
        " |   |dh d|-T-6-T-ppp-| ",
        " 2   |dddd|-----------| ",
        " |||||||||||||||||||||| ",
        "     |ttt |^^| cc |     "
      ],
      "palettes": [ "microlab" ],
      "terrain": { "G": "t_card_science" },
      "furniture": { "7": "f_autodoc", "/": "f_autodoc_couch", "T": "f_counter", "p": "f_counter" },
      "items": {
        "p": { "item": "bionics", "chance": 20 },
        "T": [
          { "item": "bionics_sci", "chance": 100, "repeat": [ 1, 2 ] },
          { "item": "bionics", "chance": 100, "repeat": [ 1, 2 ] },
          { "item": "bionic_power_storage_mil", "chance": 100 },
          { "item": "autodoc_installation_programs", "chance": 50 }
        ],
        "7": { "item": "autodoc_supplies", "chance": 100 }
      },
      "place_loot": [ { "item": "anesthetic_kit", "x": 20, "y": 15 } ],
      "place_monsters": [ { "monster": "GROUP_LAB", "x": [ 2, 21 ], "y": [ 2, 21 ], "repeat": [ 1, 5 ] } ],
      "monster": { "T": { "monster": "mon_prototype_cyborg" } },
      "computers": {
        "6": {
          "name": "Surgery room computer",
          "access_denied": "ERROR!  Access denied!  Unauthorized access will be met with lethal force!",
          "security": 3,
          "options": [
            { "name": "Open Storage Chambers", "security": 5, "action": "release_bionics" },
            { "name": "Manifest", "action": "list_bionics" }
          ],
          "failures": [ { "action": "manhacks" }, { "action": "secubots" } ]
        }
      }
    }
  },
  {
    "type": "mapgen",
    "om_terrain": [ [ "microlab_generic" ] ],
    "method": "json",
    "object": {
      "fill_ter": "t_strconc_floor",
      "rows": [
        "     |    |  |((((|     ",
        "     ||22||  | 66 |     ",
        " ccc      2  2    2     ",
        "          2  2 cc 2     ",
        " UUU      |  |    | ??V^",
        "|((((2|||||||||22|||||||",
        "       |  |   |         ",
        " hhh   |  5   2   666   ",
        " ttt   |  5   2   666   ",
        "       |  |7  |         ",
        "|((|||||44|||||22|||||||",
        "   |----  ----|         ",
        "   |-r +  - S-| ????    ",
        "|22|----  - S-||((((|22|",
        "   |-r +  + S-|UUcc    |",
        "  d|----  - S-|       6|",
        " hd|-r +  - S-|       6|",
        "   |----------|        |",
        "|22|||||||||||||22||||||",
        "    B|             2  cF",
        "    B|ccii         2  c ",
        " F   |((((|22|||||||  c ",
        " i   2 66 2  2  Y  2    ",
        "     |    |  |     |    "
      ],
      "palettes": [ "microlab" ],
      "terrain": { "+": "t_door_metal_c", "7": "t_console" },
      "furniture": { "S": "f_utility_shelf" },
      "mapping": {
        "S": { "items": { "item": "microlab_storage_cvd_carbon", "chance": 50, "repeat": 2 } },
        "r": { "items": { "item": "microlab_storage_cvd_hydrogen", "chance": 50, "repeat": 4 } }
      },
      "computers": {
        "7": {
          "name": "Hydrocarbon Materials Storage Control",
          "security": 5,
          "options": [ { "name": "UNLOCK STORAGE", "action": "unlock" } ],
          "failures": [ { "action": "alarm" }, { "action": "damage" } ]
        }
      }
    }
  },
  {
    "type": "mapgen",
    "om_terrain": [ [ "microlab_generic" ] ],
    "method": "json",
    "object": {
      "fill_ter": "t_strconc_floor",
      "rows": [
        "    h|||||||||    |     ",
        " 6 dd|B  h  ^(    (cc   ",
        " 6 dd|B ddd  (    (cc   ",
        "    h|       (    (     ",
        "     2       2    2     ",
        "    n|||||||||||||||||||",
        "     2       Y      2   ",
        "     2       Y      2   ",
        "   hd||22||||||||||||   ",
        "    d|    |---------|   ",
        "||2((|    55      r-|22|",
        "     |    55      r-|   ",
        "     |   7|-      r-|   ",
        "|    ||22||-       -|22|",
        "|t   |    |-     ---|   ",
        "|^   |l  b|-     4 -|   ",
        "|?   |l  b|-rrr  -S-|   ",
        "|?   |l  b|---------|   ",
        "|||2|||||||||||||||||22|",
        "     | cFF|B   ??? |    ",
        " FF  |    |B       2    ",
        " cc  2 66 ||||     (6   ",
        "     | 66 2  2     (6h  ",
        "     |    |  |     |    "
      ],
      "palettes": [ "microlab" ],
      "furniture": { "S": "f_utility_shelf" },
      "set": [ { "square": "radiation", "amount": [ 10, 30 ], "x": 12, "y": 10, "x2": 18, "y2": 16 } ],
      "mapping": {
        "S": { "items": { "item": "microlab_storage_plutonium_special" } },
        "l": { "items": { "item": "rad_gear", "chance": 50, "repeat": 2 } },
        "r": {
          "item": { "item": "plut_cell", "chance": 40, "repeat": 2 },
          "items": { "item": "ammo_atomic_batteries_full", "chance": 25 }
        }
      },
      "computers": {
        "7": {
          "name": "Nuclear Materials Storage Control",
          "access_denied": "ERROR!  Access denied!  Unauthorized access will be met with lethal force!",
          "security": 5,
          "options": [ { "name": "UNLOCK STORAGE - CAUTION: RADIATION LEAK DETECTED", "action": "unlock" } ],
          "failures": [ { "action": "alarm" }, { "action": "damage" }, { "action": "secubots" } ]
        }
      }
    }
  },
  {
    "type": "mapgen",
    "om_terrain": [ [ "microlab_generic" ] ],
    "method": "json",
    "object": {
      "fill_ter": "t_strconc_floor",
      "rows": [
        "     |    |  ||||||     ",
        " FF c|    |  |?  V(th   ",
        " FF i||22||  |?  n(th   ",
        " 66  2       |    (th   ",
        "     2       2    2     ",
        "||2||||||||||||||||||2||",
        "      FF|------|  |     ",
        "  66    |-r  x-|  2  d  ",
        "  66  h |-r   -|  2  h  ",
        "      cc|-r   -|  | BBB ",
        "22|||||||-    -|  ||||||",
        "  |FF|cc|--55--|YY      ",
        "  |     |||55|||YY      ",
        "22|     |    7 |  |||2||",
        "    U O |      |  (6    ",
        "    U O | 6    2  (6    ",
        "    U O |hd    |  (dh   ",
        "        | d BBB|  (d    ",
        "||||||22||||||||22|||22|",
        " 666n|    2  2    |6    ",
        " h   2    2  2    |   c ",
        "    c( YY |  | BB 2   c ",
        "    c( YY |  | BB |  FF ",
        "     |    |  |    |     "
      ],
      "palettes": [ "microlab" ],
      "mapping": {
        "r": { "item": { "item": "nanomaterial", "chance": 50, "repeat": 2 } },
        "x": { "item": { "item": "standard_template_construct", "repeat": [ 1, 2 ] } }
      },
      "computers": {
        "7": {
          "name": "Nanomaterial Storage Control",
          "access_denied": "ERROR!  Access denied!  Unauthorized access will be met with lethal force!",
          "security": 5,
          "options": [ { "name": "UNLOCK STORAGE", "action": "unlock" } ],
          "failures": [ { "action": "alarm" }, { "action": "damage" }, { "action": "secubots" } ]
        }
      }
    }
  },
  {
    "type": "mapgen",
    "om_terrain": [ [ "microlab_generic" ] ],
    "method": "json",
    "weight": 2500,
    "object": {
      "fill_ter": "t_strconc_floor",
      "rows": [
        "     |    |  | cc |     ",
        "     | cc |  | cc | c c ",
        "  cc | cc 2  2    | c c ",
        "  cc | cc |  | h h| c c ",
        "     |    |  |6666|     ",
        "||22|||||||22||||||2||||",
        "    c|SSS Y  Y    | ccc ",
        "   Yr|6h          |     ",
        "    r|6    CC h8  |     ",
        "    c|     CC  7  |FFrr ",
        "||2|||     CC  7  ||||||",
        "     2  GGGtt  7  2     ",
        "     2  999tt  7  2     ",
        "||2|||        67  ||||2|",
        "    F|  h    h67  |ccr  ",
        "    F|  877777P8  |c    ",
        "   YF|            |c    ",
        "    F|    Y  Y    |cc   ",
        "||22|||||||22|||||||||2|",
        "Fc   |ccc |YY( UUU|ccc  ",
        "  Y  |c   2  2    |c    ",
        "     |c   2  2    |F cc ",
        "     |ccc |  |2(((|F cc ",
        "   cc|    |  |    |     "
      ],
      "palettes": [ "microlab" ],
      "terrain": { "G": "t_generator_broken", "7": "t_conveyor", "8": "t_machinery_heavy", "9": "t_machinery_electronic" },
      "furniture": { "C": "f_crate_c", "P": "f_3d_printer_advanced", "S": "f_server" },
      "mapping": {
        "C": {
          "items": [ { "item": "3d_printing_raw_materials", "chance": 100 }, { "item": "supplies_metal", "chance": 50, "repeat": 2 } ]
        },
        "t": { "items": { "item": "tools_electronics", "chance": 50, "repeat": 2 } }
      }
    }
  }
]
