[
  {
    "type": "mapgen",
    "method": "json",
    "om_terrain": "abstorefront",
    "object": {
      "fill_ter": "t_floor",
      "rows": [
        "sssssssssssssssssssssss'",
        "s||xxxxxxxxDDxxxxxxxx||s",
        "s|...................B|s",
        "s|B..c........B..B...B|s",
        "s|B..c........B..B...B|s",
        "s|B..c..B..B..B..B...B|s",
        "s|cccc..B..B..B..B...B|s",
        "s|B.....B..B..B..B...B|s",
        "s|B..................B|s",
        "s|B..BBBB..BBBBBB.BB.B|s",
        "s|................BB.B|s",
        "s|B..BBBB..BBBBBB....B|s",
        "s|B...............||+||s",
        "s|B...............|B..|s",
        "s|BBBBBBB..BBBBBB.|<..Ds",
        "s||||||||||||||||||||||s",
        "sss4ssssssssssssssssssss",
        "ssssssssssssssssssssssss",
        "                        ",
        "                        ",
        "                        ",
        "                        ",
        "                        ",
        "                        "
      ],
      "terrain": {
        " ": "t_region_groundcover_urban",
        "s": "t_sidewalk",
        "'": "t_sidewalk",
        "+": "t_door_c",
        ".": "t_floor",
        "D": "t_door_locked",
        "x": "t_window_boarded",
        "4": "t_gutter_downspout",
        "<": "t_ladder_up",
        "|": "t_wall_w"
      },
      "furniture": { "B": "f_rack", "c": "f_counter", "'": "f_street_light" },
      "items": { ".": { "item": "trash", "chance": 12 } },
      "vehicles": { ".": { "vehicle": "shopping_cart", "chance": 1, "status": 1 } }
    }
  },
  {
    "type": "mapgen",
    "method": "json",
    "om_terrain": "abstorefront_roof",
    "object": {
      "fill_ter": "t_flat_roof",
      "rows": [
        "                        ",
        " -....................- ",
        " -....................- ",
        " -....................- ",
        " -....................- ",
        " -....................- ",
        " -....................- ",
        " -....................- ",
        " -....................- ",
        " -....................- ",
        " -....................- ",
        " -....................- ",
        " -......&.............- ",
        " -....................- ",
        " -.................>..- ",
        " --5------------------- ",
        "                        ",
        "                        ",
        "                        ",
        "                        ",
        "                        ",
        "                        ",
        "                        ",
        "                        "
      ],
      "palettes": [ "roof_palette" ],
      "terrain": { ">": "t_ladder_down" },
      "place_items": [ { "item": "roof_trash", "x": [ 2, 21 ], "y": [ 3, 14 ], "chance": 50, "repeat": [ 1, 3 ] } ],
      "place_nested": [
        {
          "chunks": [
            [ "null", 20 ],
            [ "roof_4x4_party", 15 ],
            [ "roof_4x4_holdout", 5 ],
            [ "roof_4x4_utility", 40 ],
            [ "roof_5x5_coop", 50 ]
          ],
          "x": [ 3, 15 ],
          "y": [ 3, 7 ]
        }
      ]
    }
  },
  {
    "type": "mapgen",
    "method": "json",
    "om_terrain": "abstorefront_1",
    "object": {
      "fill_ter": "t_floor",
      "rows": [
        "   s________________'   ",
        "   s-____-____-____-s   ",
        "   s-____-____-____-s   ",
        "   s-____-____-____-s   ",
        "   s-____-____-____-s   ",
        "   s-____-____-____-s   ",
        "   s----------------s   ",
        "   ssssssssssssssssss   ",
        "   sssssss||xx||xx||s   ",
        "   ssssssj|B......B|s   ",
        "   ssssssj|B..BB..B|s   ",
        "   ssssssj|B..BB..B|s   ",
        "   s|||D|||B..BB..B|s   ",
        "   s|B........BB..B|s   ",
        "   s|B............B|s   ",
        "   s|B..ccc||+||||||s   ",
        "   s|B..C..+..B|S.T|s   ",
        "   s|B..ccc|..B||+||s   ",
        "   s|B..C..+.......|s   ",
        "   s|B..|BB|...bbll|s   ",
        "   s|||||||||D||||||s   ",
        "   ssssF<sssssRRRF4ss   ",
        "   ssssGssssssRRRFsss   ",
        "       FFFFFFFFFFF      "
      ],
      "terrain": {
        " ": "t_region_groundcover_urban",
        "s": "t_sidewalk",
        "'": "t_sidewalk",
        "j": "t_sidewalk",
        "_": "t_pavement",
        "-": "t_pavement_y",
        "+": "t_door_c",
        ".": "t_floor",
        "D": "t_door_locked",
        "x": "t_window_boarded",
        "F": "t_chainfence",
        "G": "t_chaingate_l",
        "R": "t_sidewalk",
        "4": "t_gutter_downspout",
        "<": "t_ladder_up",
        "|": "t_wall_w"
      },
      "furniture": {
        "B": "f_rack",
        "R": "f_dumpster",
        "l": "f_locker",
        "b": [ [ "f_bench", 9 ], "f_bench_flipped" ],
        "j": [ [ "f_bench", 9 ], "f_bench_flipped" ],
        "C": "f_counter_gate_c",
        "c": "f_counter",
        "'": "f_street_light",
        "T": "f_toilet",
        "S": "f_sink"
      },
      "items": { ".": { "item": "trash", "chance": 15 }, "R": { "item": "trash_dumpster", "chance": 80 } },
      "vehicles": { ".": { "vehicle": "shopping_cart", "chance": 1, "status": 1 } }
    }
  },
  {
    "type": "mapgen",
    "method": "json",
    "om_terrain": "abstorefront_roof_1",
    "object": {
      "fill_ter": "t_flat_roof",
      "rows": [
        "                        ",
        "                        ",
        "                        ",
        "                        ",
        "                        ",
        "                        ",
        "                        ",
        "                        ",
        "          .........-    ",
        "          .........-    ",
        "          .........-    ",
        "          .........-    ",
        "    -..............-    ",
        "    -..............-    ",
        "    -..............-    ",
        "    -..............-    ",
        "    -..............-    ",
        "    -..............-    ",
        "    -..............-    ",
        "    -..............-    ",
        "    --------------5-    ",
        "       #>#              ",
        "                        ",
        "                        "
      ],
      "palettes": [ "roof_palette" ],
      "terrain": { ">": "t_ladder_down" },
      "items": { ".": { "item": "roof_trash", "chance": 1 } },
      "place_nested": [
        {
          "chunks": [ [ "null", 20 ], [ "roof_4x4_party", 20 ], [ "roof_4x4_holdout", 5 ], [ "roof_4x4_utility", 40 ] ],
          "x": 13,
          "y": 10
        }
      ]
    }
  }
]
