[
  {
    "type": "mapgen",
    "method": "json",
    "om_terrain": "animalpound",
    "object": {
      "fill_ter": "t_floor",
      "rows": [
        "            ss____-____'",
        "            ss____-____ ",
        "            ss_^__-____ ",
        "  ssssssssssss____-____ ",
        "  |||||||||||s____-____ ",
        "  |].y|]%C..+s____-____ ",
        "  |%c.|]cC..|s____-____ ",
        " 4|d..|r.C..||||||||||| ",
        " ||||i|R.C........|,,t| ",
        " |<|..............+,,,| ",
        " |.+..............|,,S| ",
        " ||||||||||++|||||||||| ",
        " |=======F|,,|FFSS#kkk| ",
        " |,,,,,,a,|,,|Q,,,,,,,| ",
        " |=======,|,,+,,T,,T,,| ",
        " |,,,,,,a,|,,|,,#,,#,,| ",
        " |=======,+,,|||||||||| ",
        " |,,,,,,a,|,,|FFSS#kkk| ",
        " |=======,|,,|Q,,,,,,,| ",
        " |,,,,,,a,|,,+,,T,,T,,| ",
        " |=======F|,,|,,#,,#,,| ",
        " ||||||||||M|||||||||||4",
        " ssssssssssssssssssssDD ",
        "                        "
      ],
      "vehicles": { "^": { "vehicle": "animalshelter", "chance": 35, "rotation": -90 } },
      "terrain": {
        "_": "t_pavement",
        "^": "t_pavement",
        "-": "t_pavement_y",
        "%": "t_console_broken",
        "+": "t_door_c",
        "M": "t_door_metal_pickable",
        "i": "t_door_locked_interior",
        "|": "t_wall_w",
        ".": "t_floor",
        "<": "t_ladder_up",
        "=": "t_chainfence",
        "a": "t_chaingate_l",
        ",": "t_linoleum_white",
        "t": "t_linoleum_white",
        " ": "t_region_groundcover_urban",
        "4": "t_gutter_downspout",
        "'": "t_region_groundcover_urban",
        "s": "t_sidewalk"
      },
      "furniture": {
        "'": "f_street_light",
        "C": "f_counter",
        "R": "f_locker",
        "]": "f_bookcase",
        "c": "f_chair",
        "d": "f_desk",
        "r": "f_rack",
        "y": "f_indoor_plant"
      },
      "mapping": {
        "D": { "terrain": "t_sidewalk", "furniture": "f_dumpster" },
        "F": { "terrain": "t_linoleum_white", "furniture": "f_locker" },
        "T": { "terrain": "t_linoleum_white", "furniture": "f_table" },
        "#": { "terrain": "t_linoleum_white", "furniture": "f_counter" },
        "S": { "terrain": "t_linoleum_white", "furniture": "f_sink" },
        "k": { "terrain": "t_linoleum_white", "furniture": "f_rack" },
        "Q": { "terrain": "t_linoleum_white", "furniture": "f_trashcan" }
      },
      "toilets": { "t": {  } },
      "items": {
        "D": { "item": "trash_dumpster", "chance": 80 },
        "Q": { "item": "trash", "chance": 35, "repeat": [ 1, 3 ] },
        "R": { "item": "SUS_janitors_closet", "chance": 100 }
      },
      "place_items": [
        { "item": "cleaning", "x": [ 14, 15 ], "y": 12, "chance": 45, "repeat": [ 1, 3 ] },
        { "item": "cleaning", "x": [ 14, 15 ], "y": 17, "chance": 45, "repeat": [ 1, 3 ] },
        { "item": "animalshelter_softdrug", "x": 7, "y": 7, "chance": 50, "repeat": [ 1, 2 ] },
        { "item": "animalshelter_softdrug", "x": [ 19, 21 ], "y": 12, "chance": 50, "repeat": [ 1, 2 ] },
        { "item": "animalshelter_softdrug", "x": [ 19, 21 ], "y": 17, "chance": 50, "repeat": [ 1, 2 ] },
        { "item": "animalshelter_hardrug", "x": 9, "y": 12, "chance": 75, "repeat": [ 1, 3 ] },
        { "item": "animalshelter_hardrug", "x": 9, "y": 20, "chance": 75, "repeat": [ 1, 3 ] },
        { "item": "waitingroom", "x": 7, "y": 5, "chance": 30, "repeat": [ 1, 2 ] },
        { "item": "waitingroom", "x": 7, "y": 6, "chance": 30, "repeat": [ 1, 2 ] },
        { "item": "waitingroom", "x": 3, "y": 5, "chance": 30, "repeat": [ 1, 2 ] },
        { "item": "animalshelter_utility", "x": 9, "y": 12, "chance": 50, "repeat": [ 2, 3 ] },
        { "item": "animalshelter_utility", "x": 9, "y": 20, "chance": 50, "repeat": [ 2, 3 ] },
        { "item": "animalshelter_utility", "x": 14, "y": 12, "chance": 35, "repeat": [ 2, 5 ] },
        { "item": "animalshelter_utility", "x": 14, "y": 17, "chance": 35, "repeat": [ 2, 5 ] },
        { "item": "cubical_office", "x": 3, "y": 7, "chance": 25, "repeat": [ 1, 2 ] },
        { "item": "cubical_office", "x": 9, "y": [ 5, 8 ], "chance": 25, "repeat": [ 1, 2 ] },
        { "item": "vet_clinic_books", "x": 3, "y": 5, "chance": 25, "repeat": 2 },
        { "item": "vet_clinic_books", "x": 7, "y": [ 5, 6 ], "chance": 25, "repeat": 2 }
      ],
      "place_monsters": [
        { "monster": "GROUP_ANIMALPOUND_CATS", "x": 14, "y": 10, "chance": 10, "density": 0.05 },
        { "monster": "GROUP_ANIMALPOUND_CATS", "x": 16, "y": 10, "chance": 10, "density": 0.05 },
        { "monster": "GROUP_ANIMALPOUND_CATS", "x": 18, "y": 10, "chance": 10, "density": 0.05 },
        { "monster": "GROUP_ANIMALPOUND_CATS", "x": 20, "y": 10, "chance": 10, "density": 0.05 },
        { "monster": "GROUP_ANIMALPOUND_DOGS", "x": 3, "y": 11, "chance": 20, "density": 0.05 },
        { "monster": "GROUP_ANIMALPOUND_DOGS", "x": 7, "y": 11, "chance": 20, "density": 0.05 },
        { "monster": "GROUP_ANIMALPOUND_DOGS", "x": 3, "y": 17, "chance": 20, "density": 0.05 },
        { "monster": "GROUP_ANIMALPOUND_DOGS", "x": 7, "y": 17, "chance": 20, "density": 0.05 }
      ]
    }
  },
  {
    "type": "mapgen",
    "method": "json",
    "om_terrain": "animalpound_roof",
    "object": {
      "fill_ter": "t_flat_roof",
      "rows": [
        "                        ",
        "                        ",
        "                        ",
        "                        ",
        "  -----------           ",
        "  -.........-           ",
        "  -..:...&..-           ",
        "  -.........----------- ",
        " -5...................- ",
        " ->...................- ",
        " -....................- ",
        " -....................- ",
        " -....................- ",
        " -....................- ",
        " -....................- ",
        " -....................- ",
        " -....................- ",
        " -....................- ",
        " -....................- ",
        " -....................- ",
        " -....................- ",
        " ---------------------5 ",
        "                        ",
        "                        "
      ],
      "palettes": [ "roof_palette" ],
      "terrain": { ">": "t_ladder_down" },
      "place_items": [ { "item": "roof_trash", "x": [ 4, 6 ], "y": 9, "chance": 50, "repeat": [ 1, 3 ] } ],
      "place_nested": [
        { "chunks": [ [ "roof_2x2_golf", 15 ], [ "null", 80 ] ], "x": 7, "y": 9 },
        { "chunks": [ [ "roof_2x2_utilities", 50 ], [ "null", 50 ] ], "x": 5, "y": 9 },
        {
          "chunks": [ [ "null", 40 ], [ "roof_4x4_party", 5 ], [ "roof_4x4_utility", 45 ], [ "roof_5x5_coop", 10 ] ],
          "x": [ 9, 12 ],
          "y": [ 9, 12 ]
        }
      ]
    }
  }
]
