[
  {
    "type": "mapgen",
    "method": "json",
    "om_terrain": [ "animalpound" ],
    "weight": 400,
    "object": {
      "fill_ter": "t_floor",
      "rows": [
        "'''''''''''~~     ,    `",
        "'''''''''''~~     ,     ",
        "'''''''''''~~     ,     ",
        "''~~~~~~~~~~~~    ,     ",
        "''-----------~    ,     ",
        "''-].y-]%C..+~    ,     ",
        "''-%c.-]cC..-~    ,     ",
        "'4-d..-r.C..-----------'",
        "'----i-R.C........-llt-'",
        "'-<-..............+lll-*",
        "'-.+..............-lls-*",
        "*----------++----------'",
        "*-======|F-ll-FFss#kkk-'",
        "'-llllllal-ll-Qlllllll-*",
        "'-======|l-ll+llTllTll-'",
        "'-llllllal-ll-ll#ll#ll-'",
        "'-======|l+ll----------'",
        "'-llllllal-ll-FFss#kkk-'",
        "'-======|l-ll-Qlllllll-'",
        "'-llllllal-ll+llTllTll-'",
        "*-======|F-ll-ll#ll#ll-'",
        "'----------M-----------4",
        "'~~~~~~~~~~~~~~~~~~~~ff~",
        "''''''''''''''''''''''''"
      ],
      "place_vehicles": [ { "vehicle": "animalshelter", "x": 18, "y": 2, "chance": 25, "rotation": 270 } ],
      "terrain": {
        " ": "t_pavement",
        ",": "t_pavement_y",
        "%": "t_console_broken",
        "*": "t_shrub",
        "+": "t_door_c",
        "M": "t_door_metal_pickable",
        "i": "t_door_locked_interior",
        "-": "t_wall_w",
        ".": "t_floor",
        "<": "t_stairs_up",
        "=": "t_chainfence_h",
        "|": "t_chainfence_v",
        "a": "t_chaingate_l",
        "l": "t_linoleum_white",
        "t": "t_linoleum_white",
        "'": "t_region_groundcover_urban",
        "4": "t_gutter_downspout",
        "`": "t_pavement",
        "~": "t_sidewalk"
      },
      "furniture": {
        "`": "f_street_light",
        "C": "f_counter",
        "D": "f_trashcan",
        "R": "f_locker",
        "]": "f_bookcase",
        "c": "f_chair",
        "d": "f_desk",
        "r": "f_rack",
        "y": "f_indoor_plant"
      },
      "mapping": {
        "f": { "terrain": "t_sidewalk", "furniture": "f_dumpster" },
        "F": { "terrain": "t_linoleum_white", "furniture": "f_locker" },
        "T": { "terrain": "t_linoleum_white", "furniture": "f_table" },
        "#": { "terrain": "t_linoleum_white", "furniture": "f_counter" },
        "s": { "terrain": "t_linoleum_white", "furniture": "f_sink" },
        "k": { "terrain": "t_linoleum_white", "furniture": "f_rack" },
        "Q": { "terrain": "t_linoleum_white", "furniture": "f_trashcan" }
      },
      "items": { "f": { "item": "trash_dumpster", "chance": 80 } },
      "toilets": { "t": {  } },
      "place_items": [
        { "item": "trash", "x": 14, "y": 13, "chance": 35, "repeat": [ 1, 3 ] },
        { "item": "trash", "x": 14, "y": 18, "chance": 35, "repeat": [ 1, 3 ] },
        { "item": "trash", "x": 21, "y": 8, "chance": 35, "repeat": [ 2, 6 ] },
        { "item": "cleaning", "x": [ 14, 15 ], "y": 17, "chance": 45, "repeat": [ 1, 3 ] },
        { "item": "cleaning", "x": 7, "y": 8, "chance": 45, "repeat": [ 1, 3 ] },
        { "item": "cleaning", "x": [ 14, 15 ], "y": 12, "chance": 45, "repeat": [ 1, 3 ] },
        { "item": "animalshelter_softdrug", "x": 7, "y": 7, "chance": 50, "repeat": [ 1, 2 ] },
        { "item": "animalshelter_softdrug", "x": [ 19, 21 ], "y": 12, "chance": 50, "repeat": [ 1, 2 ] },
        { "item": "animalshelter_softdrug", "x": [ 19, 21 ], "y": 17, "chance": 50, "repeat": [ 1, 2 ] },
        { "item": "animalshelter_hardrug", "x": 9, "y": 12, "chance": 75, "repeat": [ 1, 3 ] },
        { "item": "animalshelter_hardrug", "x": 9, "y": 20, "chance": 75, "repeat": [ 1, 3 ] },
        { "item": "waitingroom", "x": 3, "y": 7, "chance": 30, "repeat": [ 1, 2 ] },
        { "item": "waitingroom", "x": 7, "y": 7, "chance": 30, "repeat": [ 1, 2 ] },
        { "item": "animalshelter_utility", "x": 9, "y": 12, "chance": 50, "repeat": [ 2, 3 ] },
        { "item": "animalshelter_utility", "x": 9, "y": 20, "chance": 50, "repeat": [ 1, 3 ] },
        { "item": "animalshelter_utility", "x": 14, "y": 13, "chance": 35, "repeat": [ 2, 5 ] },
        { "item": "animalshelter_utility", "x": 15, "y": 13, "chance": 35, "repeat": [ 2, 5 ] },
        { "item": "cubical_office", "x": 3, "y": 7, "chance": 25, "repeat": [ 1, 2 ] },
        { "item": "cubical_office", "x": 9, "y": [ 5, 8 ], "chance": 25, "repeat": [ 1, 2 ] },
        { "item": "office", "x": 7, "y": 5, "chance": 25, "repeat": [ 1, 2 ] },
        { "item": "vet_clinic_books", "x": 3, "y": 5, "chance": 25, "repeat": 2 },
        { "item": "vet_clinic_books", "x": 7, "y": [ 5, 6 ], "chance": 25, "repeat": 2 }
      ],
      "place_monsters": [
        { "monster": "GROUP_ANIMALPOUND_CATS", "x": 14, "y": 10, "chance": 10, "density": 0.05 },
        { "monster": "GROUP_ANIMALPOUND_CATS", "x": 16, "y": 10, "chance": 10, "density": 0.05 },
        { "monster": "GROUP_ANIMALPOUND_CATS", "x": 18, "y": 10, "chance": 10, "density": 0.05 },
        { "monster": "GROUP_ANIMALPOUND_CATS", "x": 20, "y": 10, "chance": 10, "density": 0.05 },
        { "monster": "GROUP_ANIMALPOUND_DOGS", "x": 3, "y": 11, "chance": 20, "density": 0.05 },
        { "monster": "GROUP_ANIMALPOUND_DOGS", "x": 7, "y": 11, "chance": 20, "density": 0.05 },
        { "monster": "GROUP_ANIMALPOUND_DOGS", "x": 3, "y": 17, "chance": 20, "density": 0.05 },
        { "monster": "GROUP_ANIMALPOUND_DOGS", "x": 7, "y": 17, "chance": 20, "density": 0.05 }
      ]
    }
  },
  {
    "type": "mapgen",
    "method": "json",
    "om_terrain": [ "animalpound_roof" ],
    "weight": 400,
    "object": {
      "fill_ter": "t_flat_roof",
      "rows": [
        "                        ",
        "                        ",
        "                        ",
        "                        ",
        "  -----------           ",
        "  -.........-           ",
        "  -..:...&..-           ",
        "  -.........----------- ",
        " -5...................- ",
        " ->...................- ",
        " -....................- ",
        " -....................- ",
        " -....................- ",
        " -....................- ",
        " -....................- ",
        " -....................- ",
        " -....................- ",
        " -....................- ",
        " -....................- ",
        " -....................- ",
        " -....................- ",
        " ---------------------5 ",
        "                        ",
        "                        "
      ],
      "palettes": [ "roof_palette" ],
      "terrain": { ">": "t_stairs_down" },
      "place_items": [ { "item": "roof_trash", "x": [ 4, 6 ], "y": 9, "chance": 50, "repeat": [ 1, 3 ] } ],
      "place_nested": [
        { "chunks": [ [ "roof_2x2_golf", 15 ], [ "null", 80 ] ], "x": 7, "y": 9 },
        { "chunks": [ [ "roof_2x2_utilities", 50 ], [ "null", 50 ] ], "x": 5, "y": 9 },
        {
          "chunks": [ [ "null", 40 ], [ "roof_4x4_party", 5 ], [ "roof_4x4_utility", 45 ], [ "roof_5x5_coop", 10 ] ],
          "x": [ 9, 12 ],
          "y": [ 9, 12 ]
        }
      ]
    }
  }
]
