[
  {
    "type": "mapgen",
    "method": "json",
    "om_terrain": [ "s_arcade" ],
    "object": {
      "fill_ter": "t_floor",
      "rows": [
        ".______________________'",
        ".______________________.",
        ".______________________.",
        ".______________________.",
        ".______________________.",
        ".ssssssssssssssssssssss.",
        ".ssssssssssssssssssssss.",
        ".ssssssssssssssssssssss.",
        ".sssssssssssssssssslLss.",
        ".||||++|OOO|++|||||||||.",
        ".|F               |S %|.",
        ".|F               ||+||.",
        ".|F  FF     FF        |.",
        ".|F  FF  F  FF    ##  |.",
        ".|F  FF  F  FF    #  T|.",
        ".|F  FF     FF    #  T|.",
        ".|F               #  T|.",
        ".|F    x x x      #  T|.",
        ".|FFFFFx x xFFFF  #B T|.",
        ".||||||||||||||||||||||.",
        ".....................4..",
        "........................",
        "........................",
        "........................"
      ],
      "terrain": {
        "+": "t_door_c",
        ".": "t_region_groundcover_urban",
        "O": "t_window",
        "_": "t_pavement",
        "'": "t_region_groundcover_urban",
        "l": "t_sidewalk",
        "L": "t_sidewalk",
        "s": "t_sidewalk",
        "4": "t_gutter_downspout",
        "|": "t_wall_r"
      },
      "furniture": {
        "'": "f_street_light",
        "#": "f_counter",
        "F": "f_arcade_machine",
        "S": "f_sink",
        "B": "f_stool",
        "T": "f_locker",
        "x": "f_pinball_machine"
      },
      "vendingmachines": { "l": { "item_group": "vending_drink" }, "L": { "item_group": "vending_food" } },
      "toilets": { "%": {  } },
      "place_items": [ { "item": "arcade_prizes", "x": 21, "y": [ 14, 18 ], "chance": 95 } ],
      "place_monsters": [ { "monster": "GROUP_ARCADE", "x": [ 3, 17 ], "y": [ 13, 15 ] } ]
    }
  },
  {
    "type": "mapgen",
    "method": "json",
    "om_terrain": "s_arcade_roof",
    "object": {
      "fill_ter": "t_flat_roof",
      "rows": [
        "                        ",
        "                        ",
        "                        ",
        "                        ",
        "                        ",
        "                        ",
        "                        ",
        "                        ",
        "                        ",
        " -....................- ",
        " -..:.N...............- ",
        " -....................- ",
        " -....................- ",
        " -....................- ",
        " -............&.......- ",
        " -....................- ",
        " -....................- ",
        " -...............X....- ",
        " -....................- ",
        " --------------------5- ",
        "                        ",
        "                        ",
        "                        ",
        "                        "
      ],
      "palettes": [ "roof_palette" ],
      "place_items": [
        { "item": "roof_trash", "x": [ 3, 20 ], "y": [ 11, 18 ], "chance": 50, "repeat": [ 1, 3 ] },
        { "item": "child_items", "x": [ 3, 20 ], "y": [ 11, 18 ], "chance": 50, "repeat": [ 1, 3 ] }
      ],
      "place_nested": [
        { "chunks": [ [ "null", 50 ], [ "roof_4x4_utility", 50 ] ], "x": 3, "y": [ 10, 15 ] },
        {
          "chunks": [ [ "null", 50 ], [ "roof_2x2_utilities", 20 ], [ "roof_2x2_utilities_c", 20 ], [ "roof_2x2_utilities_b", 20 ] ],
          "x": 17,
          "y": [ 12, 15 ]
        }
      ]
    }
  }
]
