[
  {
    "method": "json",
    "object": {
      "fill_ter": "t_dirt",
      "rows": [
        ",,,,,,,,$,,,%,,$,,,,,,,,%,,,$,,,$,,,$,,,,,,,$,,%",
        ",,,$,,,,,,,,,,,,,,$,,,$,,,$,,,,%,,,,,,,$,,,,,,,,",
        ",,11111111111111111111111111111111111111111111$,",
        ",$11111111111111111111111111111111111111111111,,",
        ",/11111111111111111111111111111111111111111111,,",
        ",,11111111111111111111111111111111111111111111,,",
        ",,11111#####111111111111#####11111111111111111,,",
        ",%11111#K..##############.@@#111111111###11111,,",
        ",,11111#K...r#ZZZ.....#d..@@#PPPPPPPPP###11111,%",
        ",$11111#K...r#.Z......+.....#/////////###11111,,",
        ",/11111##r..r#...hh...#..dd##//////////P111111,$",
        ",,11111/#r..##..hnnh..######/////WWWWW/P111111,,",
        ",,11111/#r.....hnnnnh......#/////Ww22W/P111111/,",
        ",/11111/#r.....hnnnnh......+//////wwwW/P111111,/",
        "%,11111/#r......hnnh.......#/////Ww22W/P111111,%",
        ",,11111/#r..##...hh...##..##/////WWWWW/P111111,,",
        "$,11111##r..r#........#h...##//////////P111111,,",
        ",/11111#ZZ..r#ZZ......#hn..h#/////WWWW/P111111/,",
        ",,11111#....r#ZZ......#h..nh#/////Ww2W/P111111,,",
        "//11111#rrr######++######hhh#/////WwwW/P111111,,",
        ",$11111#####/zz//////zzz#####/////W/WW/##11111,,",
        ",/1111111P////////////z////////////////##11111,$",
        ",,1111111P//WWWWW////////////////////////,,/,/,,",
        ",%1111111P//W22wW////WWWWW//////////////////,,,,",
        ",,1111111P//Wwww/////Ww22W//////////////////,/,%",
        "%,1111111P//W22wW/////wwwW/////////////##11111,,",
        ",,1111111P//WWWWW////Ww22W/////////////##11111,,",
        ",/111111##///////////WWWWW/////###.###/P111111,,",
        ",,111111##/////////////////////#rr..r#/P111111,,",
        "$%,,/,/////////////////////////.....r#/P111111/,",
        ",/%,/,/,,//////////////////////......./P111111/,",
        ",,/,///////////W/WW//WW/WW/////......./P111111,$",
        ",,111111##/////WwwW//WwwwW/////.....r#/P111111,,",
        ",,111111##/////Ww2W//W2w2W/////.....r#/P111111$,",
        ",$1111111P/////WWWW//W2w2W/////......./P111111/%",
        ",,1111111P///////////WWWWW/////......./P111111,,",
        ",,1111111P///WWWW//////////////.....r#/P111111,,",
        ",%1111111P///W2wW///zz/////////#rrrrr#/P111111%,",
        ",,1111111P///Www////zz/I///////#######/P111111,,",
        ",%1111111P///WWWW//////////////////////P111111,,",
        ",,111111###////////////////////////////P111111,,",
        "$,111111###PPPPPPPPPPP##//////##PPPPPPP##11111/,",
        ",,111111###11111111111##,/////##1111111##11111$,",
        "%,1111111111111111111111/,/,,/1111111111111111,,",
        ",,1111111111111111111111,,,,,/1111111111111111,,",
        ",%1111111111111111111111/,,,,/111111111111111/,,",
        ",,,,,,%,,,/,,,$,,/,/,,,%/$,/,,%/,,,,,,,,$,,,$,%,",
        "$,,%,,$,,,,,%,,,%,,$,,,,,//,,,,,$,,,,,%,,,%,,,,,"
      ],
      "palettes": [ "bandit_camp" ],
      "place_npcs": [
        { "class": "bandit", "x": 15, "y": 13 },
        { "class": "bandit", "x": 20, "y": 12 },
        { "class": "thug", "x": 20, "y": 20 },
        { "class": "bandit", "x": 35, "y": 13 },
        { "class": "bandit", "x": 39, "y": 22 },
        { "class": "bandit", "x": 11, "y": 30 },
        { "class": "bandit", "x": 16, "y": 33 },
        { "class": "bandit", "x": 14, "y": 38 },
        { "class": "thug", "x": 25, "y": 41 },
        { "class": "bandit", "x": 28, "y": 41 },
        { "class": "thug", "x": 36, "y": 30 }
      ],
      "place_items": [
        { "item": "stash_wood", "x": [ 12, 12 ], "y": [ 8, 10 ], "chance": 85 },
        { "item": "dresser", "x": [ 23, 23 ], "y": [ 8, 8 ], "chance": 85 },
        { "item": "home_hw", "x": [ 12, 12 ], "y": [ 16, 18 ], "chance": 85 },
        { "item": "home_hw", "x": [ 21, 23 ], "y": [ 20, 20 ], "chance": 85 },
        { "item": "home_hw", "x": [ 22, 22 ], "y": [ 21, 21 ], "chance": 80 },
        { "item": "cannedfood", "x": [ 9, 9 ], "y": [ 10, 16 ], "chance": 90 },
        { "item": "cannedfood", "x": [ 14, 16 ], "y": [ 8, 8 ], "chance": 90 },
        { "item": "pasta", "x": [ 8, 10 ], "y": [ 19, 19 ], "chance": 90 },
        { "item": "camping", "x": [ 8, 10 ], "y": [ 13, 13 ], "chance": 75 },
        { "item": "camping", "x": [ 8, 9 ], "y": [ 17, 18 ], "chance": 75 },
        { "item": "electronics", "x": [ 23, 23 ], "y": [ 16, 18 ], "chance": 75 },
        { "item": "bed", "x": [ 26, 27 ], "y": [ 7, 8 ], "chance": 80 },
        { "item": "dresser", "x": [ 25, 26 ], "y": [ 10, 10 ], "chance": 75 },
        { "item": "home_hw", "x": [ 27, 27 ], "y": [ 17, 19 ], "chance": 75 },
        { "item": "electronics", "x": [ 25, 26 ], "y": [ 19, 19 ], "chance": 75 },
        { "item": "cannedfood", "x": [ 20, 21 ], "y": [ 37, 38 ], "chance": 75 },
        { "item": "mechanics", "x": [ 32, 36 ], "y": [ 37, 37 ], "chance": 65 },
        { "item": "mechanics", "x": [ 36, 36 ], "y": [ 28, 29 ], "chance": 65 },
        { "item": "mechanics", "x": [ 36, 36 ], "y": [ 32, 33 ], "chance": 65 },
        { "item": "mechanics", "x": [ 32, 33 ], "y": [ 28, 28 ], "chance": 65 }
      ],
      "place_vehicles": [
        { "vehicle": "motorcycle", "x": 32, "y": 30, "chance": 80, "rotation": 180 },
        { "vehicle": "motorcycle", "x": 32, "y": 32, "chance": 80, "rotation": 180 },
        { "vehicle": "motorcycle", "x": 33, "y": 34, "chance": 80, "rotation": 180 }
      ]
    },
    "om_terrain": [ [ "bandit_camp_1", "bandit_camp_2" ], [ "bandit_camp_3", "bandit_camp_4" ] ],
    "type": "mapgen",
    "weight": 250
  }
]
