[
  {
    "type": "mapgen",
    "method": "json",
    "om_terrain": [ "bunker" ],
    "object": {
      "fill_ter": "t_floor",
      "rows": [
        "   /III/++++++++/III/   ",
        "   /lddI________Iddl/   ",
        "|||/,h?I________I?h,/|||",
        "|  /*///________///*/  |",
        "|       ________       |",
        "| ____________________ |",
        "| ____________________ |",
        "| ____________________ |",
        "| ____________________ |",
        "| ____________________ |",
        "| ____________________ |",
        "| ____________________ |",
        "| ____________________ |",
        "|                      |",
        "|      MMM6  MMMM      |",
        "|      MMMMDDMMMM      |",
        "|      MM,,,,,,MM      |",
        "|      MMMM,,MMMM      |",
        "|      MM,,,,,,MM      |",
        "|      MMMM,,MMMM      |",
        "|      MM,,,,,,MM      |",
        "|||||||MMMM>>MMMM|||||||",
        "       MMMMMMMMMM       ",
        "       MMMMMMMMMM       "
      ],
      "terrain": {
        " ": "t_region_groundcover_urban",
        "*": "t_door_metal_pickable",
        "+": "t_chaingate_l",
        ",": "t_floor",
        "_": "t_pavement",
        "/": "t_concrete_wall",
        "?": "t_console_broken",
        "6": "t_card_military",
        ">": "t_stairs_down",
        "D": "t_door_metal_locked",
        "I": "t_ballistic_glass",
        "M": "t_wall_metal",
        "|": "t_chainfence"
      },
      "furniture": { "d": "f_desk", "h": "f_chair", "l": "f_locker" },
      "items": { "d": { "item": "office_mess", "chance": 50, "repeat": 2 }, "l": { "item": "military_standard_pistols", "chance": 25 } },
      "place_monster": [
        { "group": "GROUP_MAYBE_MIL", "x": [ 1, 22 ], "y": [ 4, 13 ], "repeat": 4 },
        { "monster": "mon_turret_medium", "x": 9, "y": 16 },
        { "monster": "mon_turret_medium", "x": 14, "y": 16 },
        { "monster": "mon_turret_medium", "x": 9, "y": 18 },
        { "monster": "mon_turret_medium", "x": 14, "y": 18 },
        { "monster": "mon_turret_medium", "x": 9, "y": 20 },
        { "monster": "mon_turret_medium", "x": 14, "y": 20 }
      ]
    }
  },
  {
    "type": "mapgen",
    "method": "json",
    "om_terrain": [ "bunker_roof" ],
    "object": {
      "fill_ter": "t_metal_floor_no_roof",
      "rows": [
        "   _____        _____   ",
        "   _____        _____   ",
        "   _____        _____   ",
        "   _____        _____   ",
        "                        ",
        "                        ",
        "                        ",
        "                        ",
        "                        ",
        "                        ",
        "                        ",
        "                        ",
        "                        ",
        "                        ",
        "       ....  ....       ",
        "       .S......R.       ",
        "       ..........       ",
        "       .S....X.X.       ",
        "       ..........       ",
        "       ..........       ",
        "       ..........       ",
        "       ..........       ",
        "       ..........       ",
        "       ..........       "
      ],
      "palettes": [ "roof_palette" ],
      "terrain": {
        ".": "t_metal_floor_no_roof",
        "_": "t_concrete",
        "R": "t_metal_floor_no_roof",
        "S": "t_radio_tower",
        "X": "t_metal_floor_no_roof"
      },
      "furniture": {
        "S": "f_solar_unit"
      }
    }
  },







  {
    "type": "mapgen",
    "method": "json",
    "om_terrain": [ "bunker_basement" ],
    "weight": 1000,
    "object": {
      "rows": [
        "########################",
        "#MMMMMMMMMMMMMMMMMMMMMM#",
        "#MrrrrrrMc  M{{  dc  sM#",
        "#M      Mc  *    d6  sM#",
        "#Mr    rMc  M2       tM#",
        "#Mr    rM   MMMMMMMMMMM#",
        "#Mr    rM   M bblbblbbM#",
        "#Mr    rM   M        lM#",
        "#MM|+6|MM   *   t s   M#",
        "#Mr    rM   *   3 s  2M#",
        "#Mr    rM   M        lM#",
        "#Mr    rM   M bblbblbbM#",
        "#Mr    rM   MMMMMMMMMMM#",
        "#Mr    rM   M   cttc BM#",
        "#M      M   M*M      BM#",
        "#MMM+6MMM     MTCfSo BM#",
        "#M{           MMMMMMMMM#",
        "#M{               *  SM#",
        "#MMM^MMMMMM==MMM*MM2 SM#",
        "#Mr    cd|    M   M   M#",
        "#Ml    cd|    M   M M M#",
        "#Ml     2M << M1M!M&M&M#",
        "#MMMMMMMMMMMMMMMMMMMMMM#",
        "########################"
      ],
      "terrain": {
        " ": "t_floor",
        "r": "t_floor",
        "#": "t_rock",
        "+": "t_door_metal_locked",
        "=": "t_door_metal_c",
        "^": "t_door_metal_pickable",
        "6": "t_card_military",
        "<": "t_stairs_up",
        "M": "t_wall_metal",
        "|": "t_ballistic_glass"
      },
      "furniture": { "r": "f_rack" },
      "items": { "{": { "item": "bunker_basement_books", "chance": 50, "repeat": 3 }, "b": { "item": "army_bed", "chance": 50, "repeat": 3 }, "d": { "item": "office_mess", "chance": 50, "repeat": 3 }, "l": { "item": "army_personal_locker", "chance": 50, "repeat": 3 } },

      "place_loot": [
        { "group": "bunker_basement_loot", "x": 2, "y": [ 4, 7 ], "chance": 75, "repeat": 10 },
        { "group": "bunker_basement_loot", "x": 7, "y": [ 4, 7 ], "chance": 75, "repeat": 10 },

        { "group": "bunker_basement_clothing", "x": [ 2, 7 ], "y": 2, "chance": 75, "repeat": 10 },

        { "group": "bunker_basement_food", "x": 2, "y": [ 9, 13 ], "chance": 75, "repeat": 10 },
        { "group": "bunker_basement_drugs", "x": 7, "y": [ 9, 13 ], "chance": 75, "repeat": 10 },



        { "group": "military_standard_shotguns", "x": 2, "y": 19, "chance": 75 }

      ],

      "place_monster": [
        { "monster": "mon_turret_light", "x": 2, "y": 14 },
        { "monster": "mon_turret_light", "x": 7, "y": 14 }
      ]

    }
  },
  {
    "type": "mapgen",
    "method": "json",
    "nested_mapgen_id": "bunker_mech_spawn",
    "weight": 25,
    "object": {
      "mapgensize": [ 3, 3 ],
      "place_loot": [ { "group": "mech_power_cell_spawn", "x": [ 0, 2 ], "y": 2 } ],
      "place_monster": [ { "monster": [ "mon_mech_combat", "mon_mech_lifter", "mon_mech_recon" ], "x": [ 0, 1 ], "y": [ 0, 1 ] } ]
    }
  },
  {
    "type": "mapgen",
    "method": "json",
    "om_terrain": [ "bunker_basement" ],
    "weight": 250,
    "object": {
      "fill_ter": "t_floor",
      "rows": [
        "########################",
        "#MMMMMMMMMMMMMMMMMMMMMM#",
        "#Ms  6 {{M3 5M ?A2MbCbM#",
        "#Ms ct   ^   +    /   M#",
        "#Mt     2M   MCCCgMbCbM#",
        "#MMMMMMMMM   MMMMMMMMMM#",
        "#MrrrrrrrM   2Mb  23 bM#",
        "#M       +    Ml     lM#",
        "#MLLLLLLLM5   *      bM#",
        "#MMMMMMMMMM   Mb     lM#",
        "#Mc t t t2M   Ml     bM#",
        "#Mt c c cWM   Mlb bl lM#",
        "#Mc       *   MMMMMMMMM#",
        "#MMMM*MMMMM   M}   2 %M#",
        "#M2      TM   *       M#",
        "#MSBOCCfCCM   MYsssY{{M#",
        "#MMMMMMMMMM ~ MMMMMMMMM#",
        "#ML *             *  SM#",
        "#MMMMM^MMMMM+MMM*MM2 SM#",
        "#Ms Mr cd|   5M   M   M#",
        "#Ms Mr cd|    M*M*M*M*M#",
        "#Mt *   2M << M1M1M&M&M#",
        "#MMMMMMMMMMMMMMMMMMMMMM#",
        "########################"
      ],
      "palettes": [ "basement_bunker" ],
      "furniture": {
        "r": "f_rack",
        "f": "f_fridge",
        "s": "f_sofa",
        "t": "f_table",
        "d": "f_desk",
        "c": "f_chair",
        "b": "f_bunkbed",
        "1": "f_shower",
        "S": "f_sink",
        "O": "f_oven",
        "C": "f_counter",
        "T": "f_trashcan",
        "B": "f_cupboard",
        "l": "f_locker",
        "L": "f_locker",
        "Y": "f_table",
        "A": "f_autodoc",
        "?": "f_autodoc_couch",
        "g": "f_glass_fridge",
        "{": "f_bookcase",
        "}": "f_pinball_machine",
        "%": "f_floor_canvas",
        "2": "f_air_conditioner",
        "3": "f_speaker_cabinet"
      },
      "items": {
        "b": { "item": "army_bed", "chance": 50, "repeat": 3 },
        "{": { "item": "bunker_basement_books", "chance": 50, "repeat": 2 },
        "T": { "item": "trash_cart", "chance": 50 },
        "l": { "item": "army_personal_locker", "chance": 50, "repeat": 3 },
        "t": { "item": "dining", "chance": 45 },
        "A": { "item": "autodoc_supplies", "chance": 100 }
      },
      "place_fields": [ { "field": "fd_blood", "x": 2, "y": 3 }, { "field": "fd_blood", "x": 3, "y": 3 } ],
      "place_loot": [
        { "group": "surgery", "x": [ 14, 16 ], "y": 4, "chance": 75, "repeat": 3 },

        { "group": "bunker_basement_drugs", "x": [ 14, 16 ], "y": 4, "chance": 75, "repeat": 5 },

        { "group": "bunker_basement_loot", "x": [ 2, 8 ], "y": 6, "chance": 75, "repeat": 10 },
        { "group": "bunker_basement_clothing", "x": [ 2, 8 ], "y": 8, "chance": 75, "repeat": 10 },



        { "group": "fridge", "x": 7, "y": 15, "chance": 70, "repeat": 3 },
        { "group": "bunker_basement_food", "x": [ 5, 6 ], "y": 15, "chance": 75, "repeat": [ 1, 10 ] },
        { "group": "dining", "x": [ 8, 9 ], "y": 15, "chance": 75, "repeat": [ 1, 2 ] },
        { "group": "oven", "x": 4, "y": 15, "chance": 70 },
        { "group": "cleaning", "x": 2, "y": 17, "chance": 70 },

        { "group": "bionics_mil", "x": 16, "y": 4, "chance": 65 },
        { "group": "bionic_power_storage_mil", "x": 16, "y": 4, "chance": 40 },
        { "group": "bunker_basement_suicide", "x": 3, "y": 3 },

        { "item": "whiskey", "x": 5, "y": 3 },
        { "item": "glass", "x": 5, "y": 3 },
        { "item": "militarymap", "x": 5, "y": 3 },
        { "item": "anesthetic_kit", "x": 17, "y": 4 },
        { "item": "television", "x": 17, "y": 13, "chance": 95 },
        { "item": "stereo", "x": 19, "y": 15, "chance": 80 }
      ],
      "monster": { "~": { "monster": "mon_turret_light" } }
    }
  },
  {
    "type": "mapgen",
    "method": "json",
    "om_terrain": [ "bunker_basement" ],
    "weight": 500,
    "object": {
      "fill_ter": "t_floor",
      "rows": [
        "########################",
        "#MMMMMMMMMMMMMMMMMMMMMM#",
        "#Ms  6 {{M3 5M ?A2MbCbM#",
        "#Ms cY   ^   +    /   M#",
        "#Mt     2M   MCCCgMbCbM#",
        "#MMMMMMMMM   MMMMMMMMMM#",
        "#MrrrrrrrM   2Mb  23 bM#",
        "#M       +    Ml     lM#",
        "#MLLLLLLLM5   *      bM#",
        "#MMMMMMMMMM   Mb     lM#",
        "#Mc t t t2M   Ml     bM#",
        "#Mt c c cWM   Mlb bl lM#",
        "#Mc       *   MMMMMMMMM#",
        "#MMMM*MMMMM   M}   2 %M#",
        "#M2      TM   *       M#",
        "#MSBOCCfCCM   MYsssY{{M#",
        "#MMMMMMMMMM ~ MMMMMMMMM#",
        "#ML *             *  SM#",
        "#MMMMM^MMMMM+MMM*MM2 SM#",
        "#Ms Mr cd|   5M   M   M#",
        "#Ms Mr cd|    M*M*M*M*M#",
        "#Mt *   2M << M1M1M&M&M#",
        "#MMMMMMMMMMMMMMMMMMMMMM#",
        "########################"
      ],
      "palettes": [ "basement_bunker" ],
      "furniture": {
        "r": "f_rack",
        "f": "f_fridge",
        "s": "f_sofa",
        "t": "f_table",
        "d": "f_desk",
        "c": "f_chair",
        "b": "f_bunkbed",
        "1": "f_shower",
        "S": "f_sink",
        "O": "f_oven",
        "C": "f_counter",
        "T": "f_trashcan",
        "B": "f_cupboard",
        "l": "f_locker",
        "L": "f_locker",
        "A": "f_autodoc",
        "Y": "f_table",
        "?": "f_autodoc_couch",
        "g": "f_glass_fridge",
        "{": "f_bookcase",
        "}": "f_pinball_machine",
        "%": "f_floor_canvas",
        "2": "f_air_conditioner",
        "3": "f_speaker_cabinet"
      },
      "items": {
        "b": { "item": "bed", "chance": 60 },
        "{": { "item": "bunker_basement_books", "chance": 80 },
        "T": { "item": "trash_cart", "chance": 50 },
        "l": { "item": "bunker_basement_clothing", "chance": 50 },
        "t": { "item": "dining", "chance": 45 },
        "A": { "item": "autodoc_supplies", "chance": 100 }
      },
      "place_loot": [
        { "group": "surgery", "x": [ 14, 16 ], "y": 4, "chance": 70, "repeat": [ 1, 3 ] },
        { "group": "bunker_basement_drugs", "x": [ 14, 16 ], "y": 4, "chance": 80, "repeat": [ 1, 3 ] },
        { "group": "mags_milspec", "x": [ 2, 6 ], "y": 8, "chance": 100, "repeat": [ 2, 6 ] },
        { "group": "ammo_milspec", "x": [ 2, 6 ], "y": 8, "chance": 100, "repeat": [ 30, 150 ] },
        { "group": "grenades", "x": [ 2, 6 ], "y": 8, "chance": 100, "repeat": [ 10, 30 ] },
        { "group": "mil_hw", "x": [ 7, 8 ], "y": 8, "chance": 100, "repeat": [ 5, 10 ] },
        { "group": "mil_armor", "x": [ 7, 8 ], "y": 6, "chance": 65, "repeat": [ 1, 2 ] },
        { "group": "guns_rifle_milspec", "x": [ 2, 6 ], "y": 6, "chance": 80, "repeat": [ 1, 2 ] },
        { "group": "guns_rifle_milspec", "x": 5, "y": [ 19, 20 ], "chance": 80, "repeat": [ 1, 2 ] },
        { "group": "guns_launcher_milspec", "x": [ 2, 6 ], "y": 6, "chance": 90, "repeat": [ 1, 2 ] },
        { "group": "gear_soldier_sidearm", "x": [ 2, 6 ], "y": 6, "chance": 90, "repeat": [ 1, 2 ] },
        { "group": "sopmod_2", "x": [ 2, 6 ], "y": 6, "chance": 100, "repeat": [ 2, 3 ] },
        { "group": "fridge", "x": 7, "y": 15, "chance": 70, "repeat": 3 },
        { "group": "bunker_basement_food", "x": [ 5, 6 ], "y": 15, "chance": 75, "repeat": [ 1, 2 ] },
        { "group": "dining", "x": [ 8, 9 ], "y": 15, "chance": 75, "repeat": [ 1, 2 ] },
        { "group": "oven", "x": 4, "y": 15, "chance": 70 },
        { "group": "cleaning", "x": 2, "y": 17, "chance": 70 },
        { "group": "bionics_mil", "x": 16, "y": 4, "chance": 65 },
        { "group": "bionic_power_storage_mil", "x": 16, "y": 4, "chance": 40 },
        { "group": "alcohol", "x": 5, "y": 3 },
        { "item": "glass", "x": 5, "y": 3 },
        { "item": "militarymap", "x": 5, "y": 3, "chance": 80 },
        { "item": "anesthetic_kit", "x": 17, "y": 4 },
        { "item": "television", "x": 17, "y": 13, "chance": 95 },
        { "item": "stereo", "x": 19, "y": 15, "chance": 80 }
      ],
      "monster": { "~": { "monster": "mon_turret_light" } }
    }
  }
]
