[
  {
    "type": "mapgen",
    "om_terrain": [ "cs_car_dealership" ],
    "method": "json",
    "object": {
      "fill_ter": "t_floor",
      "rows": [
        ".--==================--`",
        ".-''''''''''''''''''''-.",
        ".-yy''yy'yy''yy'yy''yy-.",
        ".-y''''y'y''''y'y''''y-.",
        ".-y''''y'y''''y'y''''y-.",
        ".-''''''''''''''''''''-.",
        ".-''''''''''''''''''''-.",
        ".-''''''''''''''''''''-.",
        ".-y''''y'y''''y'y''''y-.",
        ".-y''''y'y''''y'y''''y-.",
        ".-yy''yy'yy''yy'yy''yy-.",
        ".-''''''''''''''''''''-.",
        ".-'wOOOwwDw'''''yy''yy-.",
        ".-'wsssVv wOOOw'y''''y-.",
        ".-'w      w   w'y''''y-.",
        ".-'w      w d w'''''''-.",
        ".-'wFttc  D dhw'''''''-.",
        ".-'wwwww  w d w'''''''-.",
        ".-'wL  l  wwwww'y''''y-.",
        ".-'wL Sw  D  Tw'y''''y-.",
        ".-'wwwwwOOwwwww'yy''yy-.",
        ".-'''''''''''4''''''''-.",
        ".-##--~----------------.",
        ".----..................."
      ],
      "terrain": {
        ".": "t_region_groundcover_urban",
        "`": "t_region_groundcover_urban",
        "'": "t_pavement",
        "y": "t_pavement_y",
        " ": "t_floor",
        "w": "t_wall_wood",
        "l": "t_door_locked_interior",
        "D": "t_door_c",
        "-": "t_chainfence",
        "O": "t_window_alarm",
        "=": "t_chaingate_l",
        "~": "t_chaingate_c",
        "#": "t_pavement",
        "4": "t_gutter_downspout"
      },
      "furniture": {
        "`": "f_street_light",
        "#": "f_dumpster",
        "S": "f_sink",
        "L": "f_locker",
        "F": "f_fridge",
        "t": "f_table",
        "c": "f_trashcan",
        "d": "f_desk",
        "h": "f_chair",
        "s": "f_sofa"
      },
      "vendingmachines": { "V": { "item_group": "vending_food" }, "v": { "item_group": "vending_drink" } },
      "place_vehicles": [
        { "vehicle": "oa_vg_cd_vehicles", "x": 4, "y": 5, "rotation": 270, "chance": 70, "fuel": 0 },
        { "vehicle": "oa_vg_cd_vehicles", "x": 11, "y": 5, "rotation": 270, "chance": 70, "fuel": 0 },
        { "vehicle": "oa_vg_cd_vehicles", "x": 18, "y": 5, "rotation": 270, "chance": 70, "fuel": 0 },
        { "vehicle": "oa_vg_cd_vehicles", "x": 18, "y": 15, "rotation": 270, "chance": 70, "fuel": 0 }
      ],
      "items": {
        "s": { "item": "oa_discarded_news", "chance": 20 },
        "c": { "item": "oa_custom_trash", "chance": 70 },
        "#": { "item": "trash_dumpster", "chance": 80 },
        "d": { "item": "oa_ig_cd_desks", "chance": 70 },
        "L": { "item": "oa_ig_cd_lockers", "chance": 70 },
        "F": { "item": "fridgesnacks", "chance": 60, "repeat": [ 0, 6 ] }
      },
      "place_items": [ { "item": "oa_ig_cd_fuel", "chance": 30, "x": 6, "y": 19 } ],
      "place_loot": [ { "item": "microwave", "x": 5, "y": 16, "chance": 20 }, { "item": "coffeemaker", "x": 6, "y": 16, "chance": 20 } ],
      "toilets": { "T": {  } }
    }
  },
  {
    "type": "mapgen",
    "method": "json",
    "om_terrain": "cs_car_dealership_roof",
    "object": {
      "fill_ter": "t_tar_flat_roof",
      "rows": [
        "                        ",
        "                        ",
        "                        ",
        "                        ",
        "                        ",
        "                        ",
        "                        ",
        "                        ",
        "                        ",
        "                        ",
        "                        ",
        "                        ",
        "   --------             ",
        "   -......-----         ",
        "   -..........-         ",
        "   -....A.....-         ",
        "   -..........-         ",
        "   -..........-         ",
        "   -...&......-         ",
        "   -........=.-         ",
        "   ----------5-         ",
        "                        ",
        "                        ",
        "                        "
      ],
      "palettes": [ "roof_palette" ],
      "terrain": { ".": "t_tar_flat_roof" },
      "place_items": [ { "item": "roof_trash", "x": [ 4, 12 ], "y": [ 14, 19 ], "chance": 50, "repeat": [ 1, 3 ] } ]
    }
  }
]
