[
  {
    "type": "mapgen",
    "method": "json",
    "om_terrain": "cs_private_park",
    "object": {
      "fill_ter": "t_floor",
      "rows": [
        "..____________________..",
        ".#########-XX-#########.",
        ".#      Y P__P s ! !  #.",
        ".# ! ! !  !__!  !  Y  #.",
        ".# Y  !   !__! Y !!!Y #.",
        ".#!  Y   Y __ ! ! !   #.",
        ".#  ! Y!A !_________Y #.",
        ".#!   !  ww_________Y #.",
        ".#P  Y  wwwwwwwA !__Y #.",
        ".# ! A wwWWWWWwwwA__! #.",
        ".# ! __==========___  #.",
        ".#! Y__==========___ Y#.",
        ".#   __wwWWWWWWww!Y ! #.",
        ".# ! __AwwWWWWWwA Y ! #.",
        ".# Y __  wwwWwww! Y! !#.",
        ".# Y __ Y YwwwY !  Y !#.",
        ".#  !__   Y  !   ! Y  #.",
        ".#!!!__!!!!    P !Y   #.",
        ".#|||DD|||! Y  !    !!#.",
        ".#a|S,,,L|! Y  !Y ! Y #.",
        ".#,+,,,21G   !   Y    #.",
        ".#t|BE,,1|@@Y P   Y  Y#.",
        ".#################-X-##.",
        "........................"
      ],
      "terrain": {
        ".": "t_region_groundcover_urban",
        " ": "t_region_groundcover_urban",
        "!": "t_region_groundcover_urban",
        "s": "t_region_groundcover_urban",
        "@": "t_region_soil",
        "A": [ [ "t_tree_willow", 12 ], [ "t_tree_dead", 2 ] ],
        "P": [ [ "t_tree_cherry", 12 ], [ "t_tree_dead", 2 ] ],
        "Y": "t_region_tree",
        "-": "t_chainfence",
        "X": "t_chaingate_l",
        ",": "t_floor",
        "_": "t_sidewalk",
        "=": "t_dock",
        "W": "t_water_dp",
        "w": "t_water_sh",
        "|": "t_wall_wood",
        "#": "t_brick_wall",
        "D": "t_door_locked_peep",
        "+": "t_door_c",
        "G": "t_curtains"
      },
      "furniture": {
        "!": "f_region_flower_decorative",
        "@": "f_dumpster",
        "s": "f_bulletin",
        "1": "f_desk",
        "2": "f_chair",
        "a": "f_sink",
        "B": "f_bookcase",
        "E": "f_armchair",
        "F": "f_fridge",
        "L": "f_locker",
        "S": "f_woodstove"
      },
      "items": {
        "@": { "item": "trash_dumpster", "chance": 80 },
        "L": { "item": "tools_earthworking", "chance": 50, "repeat": [ 1, 2 ] },
        "B": { "item": "homebooks", "chance": 60, "repeat": [ 1, 4 ] },
        "1": { "item": "office", "chance": 65 }
      },
      "toilets": { "t": {  } },
      "place_vehicles": [ { "vehicle": "bicycle", "x": 3, "y": 2, "rotation": 0, "chance": 50 } ],
      "place_signs": [ { "signage": "Private Property: No Trespassing", "x": 8, "y": 0 } ]
    }
  },
  {
    "type": "mapgen",
    "method": "json",
    "om_terrain": "cs_private_park_roof",
    "object": {
      "fill_ter": "t_flat_roof",
      "rows": [
        "                        ",
        "                        ",
        "                        ",
        "                        ",
        "                        ",
        "                        ",
        "                        ",
        "                        ",
        "                        ",
        "                        ",
        "                        ",
        "                        ",
        "                        ",
        "                        ",
        "                        ",
        "                        ",
        "                        ",
        "                        ",
        " .........              ",
        " ...=.....              ",
        " .........              ",
        " .........              ",
        " .........              ",
        "                        "
      ],
      "palettes": [ "roof_palette" ]
    }
  }
]
