[
  {
    "type": "mapgen",
    "om_terrain": [ "cs_tire_shop" ],
    "method": "json",
    "weight": 1000,
    "object": {
      "fill_ter": "t_thconc_floor",
      "rows": [
        "   SSy____ySS______SS  '",
        "   SSy____ySS______SS   ",
        "   SSy____ySS______SS   ",
        "   SSy____ySS______SS   ",
        "   SSy____ySS______SS   ",
        "   SSy____ySe______SS   ",
        "   S|:::::::|======|:|  ",
        "   S|.rrrrr.eM#MM#M..|  ",
        "   S|........M#MM#M.t|  ",
        "   S|.rrrrr..M#MM#M.t|  ",
        "   S|........M#MM#M.t|  ",
        "   S|.rrrrr..M#MM#M.t|  ",
        "   S|........M#MM#M.t|  ",
        "   S|.rrrrr..M#MM#M.t|  ",
        "   S|........M#MM#M.t|  ",
        "   S|.rrrrr..MMMMMM..|  ",
        "   SD................|  ",
        "    |.cc||l||||.||..s:  ",
        "    |.ch|L.C|Vv.c|..s:  ",
        "    |...|L.C|...c||D||  ",
        "    |rrr|L.C|hhhh|T.s|4 ",
        "    |:::|||||::::|||||  ",
        "         U<UU           ",
        "                        "
      ],
      "terrain": {
        " ": "t_region_groundcover_urban",
        "'": "t_region_groundcover_urban",
        "U": "t_region_groundcover_barren",
        "_": "t_pavement",
        "S": "t_sidewalk",
        ".": "t_thconc_floor",
        "#": "t_grate_indoor",
        "=": "t_door_metal_locked",
        "|": "t_wall_b",
        "e": "t_gates_mech_control",
        ":": "t_window",
        "l": "t_door_locked",
        "y": "t_pavement_y",
        "D": "t_door_c",
        "M": "t_metal_floor",
        "4": "t_gutter_downspout",
        "<": "t_ladder_up"
      },
      "furniture": {
        "'": "f_street_light",
        "c": "f_counter",
        "L": "f_locker",
        "C": "f_crate_c",
        "h": "f_chair",
        "s": "f_sink",
        "r": "f_rack",
        "v": "f_vending_c",
        "V": "f_vending_c",
        "t": "f_table",
        "U": "f_dumpster"
      },
      "place_vehicles": [ { "vehicle": "oa_vg_ts_vehicles", "x": 15, "y": 10, "rotation": 270, "chance": 50, "fuel": 10 } ],
      "items": {
        "h": { "item": "oa_discarded_news", "chance": 15 },
        "U": { "item": "trash_dumpster", "chance": 80 },
        "t": { "item": "oa_ig_ts_tables", "chance": 15 },
        "r": { "item": "oa_ig_ts_tires", "chance": 70 },
        "L": { "item": "oa_ig_ts_lockers", "chance": 50 },
        "C": { "item": "oa_ig_ts_crates", "chance": 50 }
      },
      "place_items": [
        { "item": "vending_food_items", "chance": 60, "repeat": [ 3, 12 ], "x": 13, "y": 18 },
        { "item": "vending_drink_items", "chance": 60, "repeat": [ 3, 12 ], "x": 14, "y": 18 }
      ],
      "add": [ { "item": "microwave", "x": 16, "y": 18, "chance": 2 }, { "item": "coffeemaker", "x": 16, "y": 19, "chance": 2 } ],
      "toilets": { "T": {  } },
      "place_signs": [ { "signage": "Discount Tires", "x": 22, "y": 1 } ]
    }
  },
  {
    "type": "mapgen",
    "method": "json",
    "om_terrain": "cs_tire_shop_roof",
    "object": {
      "fill_ter": "t_flat_roof",
      "rows": [
        "                        ",
        "                        ",
        "                        ",
        "                        ",
        "                        ",
        "                        ",
        "    ------------------  ",
        "    -................-  ",
        "    -................-  ",
        "    -................-  ",
        "    -................-  ",
        "    -................-  ",
        "    -................-  ",
        "    -................-  ",
        "    -................-  ",
        "    -................-  ",
        "    -................-  ",
        "    -................-  ",
        "    -................-  ",
        "    -................-  ",
        "    -................5  ",
        "    -----####---------  ",
        "         #>##           ",
        "                        "
      ],
      "palettes": [ "roof_palette" ],
      "terrain": { ">": "t_ladder_down" },
      "place_items": [ { "item": "roof_trash", "x": [ 7, 15 ], "y": [ 7, 18 ], "chance": 20, "repeat": [ 1, 3 ] } ],
      "place_nested": [
        {
          "chunks": [
            [ "null", 40 ],
            [ "roof_2x2_utilities_b", 15 ],
            [ "roof_2x2_utilities_c", 5 ],
            [ "roof_2x2_utilities_d", 10 ],
            [ "roof_2x2_utilities", 10 ],
            [ "roof_2x2_golf", 5 ]
          ],
          "x": [ 7, 16 ],
          "y": 17
        },
        {
          "chunks": [
            [ "null", 50 ],
            [ "roof_4x4_party", 5 ],
            [ "roof_4x4_holdout", 5 ],
            [ "roof_4x4_utility", 10 ],
            [ "roof_4x4_utility_1", 10 ],
            [ "roof_6x6_survivor", 10 ],
            [ "roof_6x6_utility", 10 ]
          ],
          "x": [ 6, 15 ],
          "y": [ 9, 12 ]
        }
      ]
    }
  }
]
