[
  {
    "type": "mapgen",
    "method": "json",
    "nested_mapgen_id": "s_restaurant_3_chequered_floor",
    "object": {
      "mapgensize": [ 24, 24 ],
      "rotation": [ 0, 3 ],
      "rows": [
        "                        ",
        "                        ",
        "                        ",
        "                        ",
        "                        ",
        "                        ",
        "                        ",
        "  xoxoxoxoxoxoxoxoxoxo  ",
        "  oxoxoxoxoxoxoxoxoxox  ",
        "  xoxoxoxoxoxoxoxoxoxo  ",
        "  oxoxoxoxoxoxoxoxoxox  ",
        "  xoxoxoxoxoxoxoxoxoxo  ",
        "  oxoxoxoxoxoxoxoxoxox  ",
        "  xoxoxoxoxoxoxoxoxoxo  ",
        "  oxoxoxoxoxoxoxoxoxox  ",
        "  xo                    ",
        "  oxoxoxoxoxoxox        ",
        "  xoxoxoxoxoxoxo        ",
        "  oxoxoxoxoxoxox        ",
        "                        ",
        "                        ",
        "                        ",
        "                        ",
        "                        "
      ],
      "terrain": { "o": "t_linoleum_white", "x": "t_linoleum_gray" }
    }
  },
  {
    "type": "mapgen",
    "method": "json",
    "om_terrain": [ "s_restaurant_3" ],
    "weight": 300,
    "object": {
      "fill_ter": "t_floor",
      "rows": [
        "____,____,____,____,___'",
        "____,____,____,____,____",
        "____,____,____,____,____",
        "____,____,____,____,____",
        "____,____,____,____,____",
        "========================",
        "=|OOOOOOOOOOOOOOO||+|||=",
        "=|HtHHtHHtHHtHHtH....Y|=",
        "=|HtHHtHHtHHtHHtH.....|=",
        "=|...................Y|=",
        "=|U.U.U.U.U.U.U.U.....|=",
        "=|#################...|=",
        "=|................#...|=",
        "=|....................|=",
        "=|..####ffGGGG####....|=",
        "=|..||||||||||||||||+||=",
        "=|..###fffffff##|00|lS|=",
        "=|..............+l2|ll|=",
        "=|..............|00|lT|=",
        "=||||||||||||||||||||||=",
        "==4=====================",
        "                        ",
        "                        ",
        "                        "
      ],
      "terrain": {
        "+": "t_door_c",
        ",": "t_pavement_y",
        " ": "t_region_groundcover_urban",
        ".": "t_floor",
        "'": "t_pavement",
        "=": "t_sidewalk",
        "O": "t_window",
        "_": "t_pavement",
        "4": "t_gutter_downspout",
        "l": "t_linoleum_white",
        "S": "t_linoleum_white",
        "T": "t_linoleum_white",
        "0": "t_linoleum_white",
        "2": "t_linoleum_white",
        "|": "t_wall_w"
      },
      "furniture": {
        "'": "f_street_light",
        "#": "f_counter",
        "G": "f_oven",
        "H": "f_sofa",
        "S": "f_sink",
        "Y": "f_rack_coat",
        "f": "f_fridge",
        "0": "f_locker",
        "2": "f_bench",
        "U": "f_stool",
        "t": "f_table"
      },
      "toilets": { "T": {  } },
      "place_nested": [ { "chunks": [ "s_restaurant_3_chequered_floor" ], "x": 0, "y": 0 } ],
      "items": { "Y": { "item": "coat_rack", "chance": 35, "repeat": [ 1, 4 ] } },
      "place_items": [
        { "item": "diner_food", "x": [ 4, 17 ], "y": 14, "chance": 75, "repeat": [ 1, 8 ] },
        { "item": "diner_back", "x": [ 4, 15 ], "y": 16, "chance": 95, "repeat": [ 1, 8 ] },
        { "item": "coat_rack", "x": [ 17, 18 ], "y": 16, "chance": 45, "repeat": [ 1, 3 ] },
        { "item": "coat_rack", "x": [ 17, 18 ], "y": 18, "chance": 45, "repeat": [ 1, 3 ] }
      ]
    }
  },
  {
    "type": "mapgen",
    "method": "json",
    "om_terrain": [ "s_restaurant_roof_3" ],
    "weight": 300,
    "object": {
      "fill_ter": "t_tar_flat_roof",
      "rows": [
        "                        ",
        "                        ",
        "                        ",
        "                        ",
        "                        ",
        "                        ",
        " |--------------------3 ",
        " |....................3 ",
        " |....................3 ",
        " |....................3 ",
        " |....................3 ",
        " |....................3 ",
        " |....................3 ",
        " |....................3 ",
        " |....................3 ",
        " |....................3 ",
        " |.........&..........3 ",
        " |....................3 ",
        " |.........&..........3 ",
        " |522222222222222222223 ",
        "                        ",
        "                        ",
        "                        ",
        "                        "
      ],
      "terrain": {
        ".": "t_tar_flat_roof",
        " ": "t_open_air",
        "|": "t_gutter_west",
        "2": "t_gutter_south",
        "-": "t_gutter_north",
        "3": "t_gutter_east",
        "5": "t_gutter_drop"
      },
      "furniture": { "&": "f_roof_turbine_vent" },
      "place_items": [ { "item": "roof_trash", "x": [ 4, 16 ], "y": [ 7, 15 ], "chance": 50, "repeat": [ 1, 3 ] } ],
      "place_nested": [
        {
          "chunks": [
            [ "roof_2x2_utilities_b", 20 ],
            [ "roof_2x2_utilities_c", 20 ],
            [ "roof_2x2_utilities_d", 20 ],
            [ "roof_2x2_utilities", 20 ],
            [ "null", 40 ]
          ],
          "x": [ 13, 17 ],
          "y": [ 16, 17 ]
        },
        {
          "chunks": [ [ "roof_4x4_utility_1", 30 ], [ "roof_6x6_utility", 30 ], [ "null", 80 ] ],
          "x": [ 3, 14 ],
          "y": [ 8, 9 ]
        }
      ]
    }
  }
]
