[
  {
    "type": "mapgen",
    "method": "json",
    "om_terrain": [ "fire_station" ],
    "weight": 100,
    "object": {
      "fill_ter": "t_floor",
      "rows": [
        "ssssssppppppppppppppppp'",
        "--O--sPpppppppPpppppppPs",
        "|Acx|sPpppppppPpppppppPs",
        "| cjOsPpppppppPpppppppPs",
        "| jj|sPpppppppPpppppppPs",
        "|r  LsPpppppppPpppppppPs",
        "|r  |sPpppppppPpppppppPI",
        "|  ^|sPpppppppPpppppppPs",
        "|-D----MMMMMMM-MMMMMMM--",
        "|    |w.......t.......w|",
        "|    Dt.......t.......t|",
        "|c#c |t.......t.......t|",
        "|c#c |t.......t.......t|",
        "|c#c |t.......t.......t|",
        "|    |t.......t.......t|",
        "|-+--|t.......t.......t|",
        "|F @@|t.......t.......t|",
        "|#  g|t.......t.......t|",
        "|c @@|t.......t.......t|",
        "|   g|t.......t.......t|",
        "|+|  |ttttttttttttttttt|",
        "|T|o&|ttltltltttltltltt|",
        "|----------------------|",
        "_____________________4__"
      ],
      "palettes": [ "fire_station" ],
      "terrain": { "'": "t_sidewalk", "O": "t_window", "T": "t_thconc_floor", "L": "t_door_locked" },
      "place_items": [
        { "item": "bed", "x": [ 3, 4 ], "y": [ 16, 16 ], "chance": 80 },
        { "item": "bed", "x": [ 3, 4 ], "y": [ 18, 18 ], "chance": 80 },
        { "item": "fireman_doc", "x": [ 1, 1 ], "y": [ 2, 2 ], "chance": 70 },
        { "item": "fireman_gear", "x": [ 1, 1 ], "y": [ 5, 5 ], "chance": 70 },
        { "item": "fireman_gear", "x": [ 1, 1 ], "y": [ 6, 6 ], "chance": 70 },
        { "item": "fridgesnacks", "x": [ 1, 1 ], "y": [ 16, 16 ], "chance": 70 },
        { "item": "novels", "x": [ 1, 1 ], "y": [ 17, 17 ], "chance": 70 },
        { "item": "fireman_pants", "x": [ 4, 4 ], "y": [ 17, 17 ], "chance": 70 },
        { "item": "fireman_boots", "x": [ 4, 4 ], "y": [ 19, 19 ], "chance": 70 },
        { "item": "oven", "x": [ 3, 3 ], "y": [ 21, 21 ], "chance": 70 },
        { "item": "fireman_gear", "x": [ 8, 8 ], "y": [ 21, 21 ], "chance": 70 },
        { "item": "fireman_torso", "x": [ 10, 10 ], "y": [ 21, 21 ], "chance": 70 },
        { "item": "fireman_head", "x": [ 12, 12 ], "y": [ 21, 21 ], "chance": 70 },
        { "item": "fireman_gloves", "x": [ 16, 16 ], "y": [ 21, 21 ], "chance": 70 },
        { "item": "fireman_mask", "x": [ 18, 18 ], "y": [ 21, 21 ], "chance": 70 },
        { "item": "fireman_gear", "x": [ 20, 20 ], "y": [ 21, 21 ], "chance": 70 }
      ],
      "place_monsters": [ { "monster": "GROUP_FIRE", "x": [ 2, 21 ], "y": [ 9, 21 ], "chance": 1 } ],
      "place_vehicles": [ { "vehicle": "fire_engine", "x": 10, "y": 12, "chance": 30, "rotation": 270 } ]
    }
  },
  {
    "type": "mapgen",
    "method": "json",
    "om_terrain": "fire_station_roof",
    "object": {
      "fill_ter": "t_flat_roof",
      "rows": [
        "                        ",
        "-----                   ",
        "-...-                   ",
        "-...-                   ",
        "-...-                   ",
        "-...-                   ",
        "-...-                   ",
        "-...-                   ",
        "-...--------------------",
        "-......................-",
        "-......................-",
        "-.o....................-",
        "-.o....................-",
        "-.o....................-",
        "-......................-",
        "-......................-",
        "-......................-",
        "-......o...o...........-",
        "-......o...o...........-",
        "-......o...o...........-",
        "-......................-",
        "-......................-",
        "---------------------5--",
        "                        "
      ],
      "palettes": [ "roof_palette" ],
      "place_nested": [
        {
          "chunks": [
            [ "null", 20 ],
            [ "roof_2x2_utilities_b", 15 ],
            [ "roof_2x2_utilities_c", 5 ],
            [ "roof_2x2_utilities_d", 40 ],
            [ "roof_2x2_utilities", 50 ],
            [ "roof_4x4_utility", 40 ]
          ],
          "x": [ 4, 18 ],
          "y": [ 10, 17 ]
        }
      ]
    }
  },
  {
    "type": "mapgen",
    "method": "json",
    "om_terrain": [ "fire_station_1" ],
    "weight": 100,
    "object": {
      "fill_ter": "t_floor",
      "rows": [
        "__PpppppppPpppppppP__s_'",
        "_||MMMMMMM|MMMMMMM||_s__",
        "_|w.......t.......w|_s__",
        "_|t.......t.......t|_s_S",
        "_|t.......t.......t|ss__",
        "_|t.......t.......t|Is_a",
        "_|t.......t.......t|ss__",
        "_|t.......t.......t|_s_S",
        "_|t.......t.......t|_s__",
        "_|t.......t.......t|_s_a",
        "_|t.......t.......t|_s_4",
        "_|t.......t.......t||D||",
        "_|t.......t.......t|  ^|",
        "_|tttttttttttttttttD   |",
        "_|rtrtrttt11rr11ttt| #xW",
        "_||||||||D||||||D||| #c|",
        "_ss|ee|HH AAAAAA   + #c|",
        "_s<|tt|H#          +   W",
        "_ss||+|H#        |||||||",
        "_ss|&     c#c    |@@g@@|",
        "___||+|F  c#c    +     h",
        "___|Tt|&ojc#c E5B|@@g@@|",
        "___|||||WW|W|WW|||||||||",
        "________________________"
      ],
      "palettes": [ "fire_station" ],
      "terrain": {
        "S": "t_shrub_rose",
        "a": "t_shrub_lilac",
        "1": "t_thconc_floor",
        "e": "t_thconc_floor",
        "i": "t_thconc_floor",
        "r": "t_thconc_floor",
        "'": "t_region_groundcover_urban",
        "W": "t_window_domestic",
        "h": "t_curtains",
        "<": "t_ladder_up",
        "T": "t_thconc_floor"
      },
      "furniture": { "1": "f_table", "5": "f_ergometer", "B": "f_bookcase", "E": "f_exercise", "H": "f_sofa", "e": "f_shower" },
      "place_items": [
        { "item": "mechanics", "x": 15, "y": 14, "chance": 25 },
        { "item": "mechanics", "x": [ 10, 11 ], "y": 14, "chance": 25 },
        { "item": "fireman_pants", "x": 11, "y": 16, "chance": 70 },
        { "item": "fireman_doc", "x": 16, "y": 21, "chance": 70 },
        { "item": "fireman_head", "x": 14, "y": 16, "chance": 70 },
        { "item": "fireman_torso", "x": 10, "y": 16, "chance": 70 },
        { "item": "tools_mechanic", "x": 12, "y": 14, "chance": 25 },
        { "item": "tools_mechanic", "x": 6, "y": 14, "chance": 25 },
        { "item": "tools_mechanic", "x": 2, "y": 14, "chance": 25 },
        { "item": "SUS_fridge", "x": 7, "y": 20, "chance": 70 },
        { "item": "home_hw", "x": 14, "y": 14, "chance": 70 },
        { "item": "fireman_mask", "x": 15, "y": 16, "chance": 70 },
        { "item": "gym", "x": 15, "y": 21, "chance": 70 },
        { "item": "dining", "x": 11, "y": [ 19, 21 ], "chance": 70 },
        { "item": "fireman_gloves", "x": 13, "y": 16, "chance": 70 },
        { "item": "clutter_bathroom", "x": [ 4, 5 ], "y": 16, "chance": 70 },
        { "item": "snacks", "x": 8, "y": 17, "chance": 70 },
        { "item": "fireman_gear", "x": 13, "y": 14, "chance": 70 },
        { "item": "fireman_boots", "x": 12, "y": 16, "chance": 70 },
        { "item": "dresser", "x": 20, "y": 21, "chance": 70 },
        { "item": "dresser", "x": 20, "y": 19, "chance": 70 },
        { "item": "kitchen", "x": [ 8, 9 ], "y": 21, "chance": 70 },
        { "item": "fireman_gear", "x": 4, "y": 14, "chance": 70 },
        { "item": "bed", "x": 22, "y": 21, "chance": 70 },
        { "item": "bed", "x": 18, "y": 21, "chance": 70 },
        { "item": "bed", "x": 21, "y": 19, "chance": 70 },
        { "item": "bed", "x": 19, "y": 19, "chance": 70 }
      ],
      "place_monsters": [ { "monster": "GROUP_FIRE", "x": 10, "y": 16, "chance": 1 } ],
      "place_vehicles": [
        { "vehicle": "fire_truck", "x": 5, "y": 5, "rotation": 270, "chance": 20 },
        { "vehicle": "fire_engine", "x": 14, "y": 5, "rotation": 270, "chance": 20 }
      ]
    }
  },
  {
    "type": "mapgen",
    "method": "json",
    "om_terrain": "fire_station_roof_1",
    "object": {
      "fill_ter": "t_flat_roof",
      "rows": [
        "                        ",
        " -------------------    ",
        " -.................-    ",
        " -.................-    ",
        " -.................-    ",
        " -.................-    ",
        " -.................-    ",
        " -.................-    ",
        " -.................-    ",
        " -.................-    ",
        " -.................-    ",
        " -.................----5",
        " -.....................-",
        " -.....................-",
        " -.....................-",
        " ---...................-",
        " ###...................-",
        " #>#...................-",
        " ###...................-",
        "   -...................-",
        "   -...................-",
        "   -...................-",
        "   ---------------------",
        "                        "
      ],
      "palettes": [ "roof_palette" ],
      "terrain": { ">": "t_ladder_down" },
      "place_nested": [
        {
          "chunks": [
            [ "null", 20 ],
            [ "roof_2x2_utilities_b", 15 ],
            [ "roof_2x2_utilities_c", 5 ],
            [ "roof_2x2_utilities_d", 40 ],
            [ "roof_2x2_utilities", 50 ],
            [ "roof_2x2_golf", 20 ],
            [ "roof_3x3_wine", 30 ]
          ],
          "x": [ 6, 18 ],
          "y": [ 17, 19 ]
        },
        {
          "chunks": [
            [ "null", 20 ],
            [ "roof_4x4_party", 15 ],
            [ "roof_4x4_holdout", 5 ],
            [ "roof_4x4_utility", 40 ],
            [ "roof_4x4_utility_1", 30 ],
            [ "roof_6x6_survivor", 20 ],
            [ "roof_6x6_utility", 20 ]
          ],
          "x": [ 3, 12 ],
          "y": [ 3, 9 ]
        }
      ]
    }
  }
]
