[
  {
    "type": "mapgen",
    "method": "json",
    "om_terrain": "communitygarden",
    "object": {
      "fill_ter": "t_region_soil",
      "rows": [
        "_______________________'",
        "________________________",
        "__|||||||||++P||||||||__",
        "__|.-----O...........|__",
        "__|.-ttt-O.......###.|__",
        "__|.-ddd-........###.|__",
        "__|..............###.|__",
        "__|..................|__",
        "__|.D.D.D.D..D.D.D.D.|__",
        "__|.D.D.D.D..D.D.D.D.|__",
        "__P.D.D.D.D..D.D.D.D.|__",
        "__+..................+__",
        "__+..................+__",
        "__|.D.D.D.D..D.D.D.D.P__",
        "__|.D.D.D.D..D.D.D.D.|__",
        "__|.D.D.D.D..D.D.D.D.|__",
        "__|..................|__",
        "__|.D.D.D.D..D.D.D.D.|__",
        "__|.D.D.D.D..D.D.D.D.|__",
        "__|.D.D.D.D..D.D.D.D.|__",
        "__|..................|__",
        "__||||||||P++|||||||||__",
        "________________________",
        "________________________"
      ],
      "terrain": {
        "'": "t_region_groundcover_urban",
        "#": "t_dirtmound",
        "+": "t_fencegate_c",
        "-": "t_wall_wood",
        "D": "t_dirtmound",
        ".": "t_region_soil",
        "P": "t_fence",
        "_": "t_region_groundcover_urban",
        "d": "t_dirtfloor",
        "t": "t_dirtfloor",
        "|": "t_fence"
      },
      "furniture": { "'": "f_street_light", "O": "f_standing_tank", "P": "f_sign", "t": "f_table" },
      "items": { "D": { "item": "hydro", "chance": 15 } },
      "place_items": [
        { "chance": 35, "repeat": 2, "item": "supplies_farming", "x": 6, "y": 4 },
        { "chance": 35, "repeat": 2, "item": "garden_shed", "x": 7, "y": 4 },
        { "chance": 40, "repeat": 2, "item": "garden_shed", "x": 5, "y": 4 }
      ],
      "place_signs": [
        { "signage": "<city> Community Garden", "x": 13, "y": 2 },
        { "signage": "<city> Community Garden", "x": 2, "y": 10 },
        { "signage": "<city> Community Garden", "x": 21, "y": 13 },
        { "signage": "<city> Community Garden", "x": 10, "y": 21 }
      ]
    }
  },
  {
    "type": "mapgen",
    "method": "json",
    "om_terrain": "communitygarden_roof",
    "object": {
      "fill_ter": "t_open_air",
      "rows": [
        "                        ",
        "                        ",
        "                        ",
        "    .....               ",
        "    .....               ",
        "    .....               ",
        "                        ",
        "                        ",
        "                        ",
        "                        ",
        "                        ",
        "                        ",
        "                        ",
        "                        ",
        "                        ",
        "                        ",
        "                        ",
        "                        ",
        "                        ",
        "                        ",
        "                        ",
        "                        ",
        "                        ",
        "                        "
      ],
      "terrain": { ".": "t_shingle_flat_roof" }
    }
  },
  {
    "type": "mapgen",
    "method": "json",
    "om_terrain": "communitygarden_1",
    "object": {
      "fill_ter": "t_region_soil",
      "rows": [
        "_______________________'",
        "________________________",
        "__P__##.##....##.##__P__",
        "____.##.##....##.##.____",
        "___..................___",
        "__##.##.##....##.##.##__",
        "__##.##.##....##.##.##__",
        "__....................__",
        "__##.##.##....##.##.##__",
        "__##.##.##....##.##.##__",
        "__....................__",
        "__.........OO.........__",
        "__.........OO.........__",
        "__....................__",
        "__##.##.##....##.##.##__",
        "__##.##.##....##.##.##__",
        "__....................__",
        "__##.##.##....##.##.##__",
        "__##.##.##....##.##.##__",
        "___..................___",
        "____.##.##....##.##.____",
        "__P__##.##....##.##__P__",
        "________________________",
        "________________________"
      ],
      "terrain": {
        "'": "t_region_groundcover_urban",
        "#": "t_dirtmound",
        ".": "t_region_soil",
        "P": "t_region_groundcover_urban",
        "_": "t_region_groundcover_urban"
      },
      "place_item": [ { "item": "hose", "x": 11, "y": 13 } ],
      "furniture": { "'": "f_street_light", "O": "f_standing_tank", "P": "f_sign" },
      "items": { "#": { "item": "hydro", "chance": 15 } },
      "place_signs": [
        { "signage": "<city> Community Garden. Grow your own food!", "x": 2, "y": 2 },
        { "signage": "<city> Community Garden. Grow your own food!", "x": 21, "y": 2 },
        { "signage": "<city> Community Garden. Grow your own food!", "x": 2, "y": 21 },
        { "signage": "<city> Community Garden. Grow your own food!", "x": 21, "y": 21 }
      ]
    }
  },
  {
    "type": "mapgen",
    "method": "json",
    "om_terrain": "communitygarden_2",
    "object": {
      "fill_ter": "t_region_soil",
      "rows": [
        "sssssssssssssssssssssss'",
        "ssssssssssssssssssssssss",
        "_P....................P_",
        "_|...........DD.DD.DD.|_",
        "_|....................|_",
        "_|...........DD.DD.DD.|_",
        "_|...........DD.DD.DD.|_",
        "_|.wwww...............|_",
        "_|.wtda......DD.DD.DD.|_",
        "_|.wttw..OO..DD.DD.DD.|_",
        "_|.wwww..OO..DD.DD.DD.|_",
        "_|....................|_",
        "_|....................|_",
        "_|.------------------.|_",
        "_|.-#d#d##d##d##d#d#-.|_",
        "_|.-#d#d##d##d##d#d#-.|_",
        "_|.+dddddddddddddddd+.|_",
        "_|.+dddddddddddddddd+.|_",
        "_|.-#d#d##d##d##d#d#-.|_",
        "_|.-#d#d##d##d##d#d#-.|_",
        "_|.------------------.|_",
        "_|....................|_",
        "_||||||||||||||||||||||_",
        "________________________"
      ],
      "terrain": {
        "'": "t_sidewalk",
        "#": "t_dirtmoundfloor",
        "+": "t_reinforced_door_glass_c",
        "-": "t_wall_glass",
        ".": "t_region_soil",
        "D": "t_dirtmound",
        "P": "t_region_soil",
        "_": "t_region_groundcover_urban",
        "a": [ "t_door_c", "t_door_o" ],
        "d": "t_dirtfloor",
        "s": "t_sidewalk",
        "t": "t_dirtfloor",
        "w": "t_wall_wood",
        "|": "t_fence"
      },
      "furniture": { "'": "f_street_light", "O": "f_standing_tank", "P": "f_sign", "t": "f_table" },
      "items": { "D": { "item": "hydro", "chance": 15 }, "#": { "item": "hydro", "chance": 15 } },
      "place_items": [
        { "chance": 20, "item": "tools_earthworking", "x": 7, "y": 16 },
        { "chance": 30, "repeat": 3, "item": "tools_earthworking", "x": 5, "y": 9 },
        { "chance": 40, "repeat": 2, "item": "supplies_farming", "x": 4, "y": 8 },
        { "chance": 35, "repeat": 2, "item": "supplies_farming", "x": 4, "y": 9 }
      ],
      "place_signs": [
        { "signage": "<city> Community Garden, sign up for your own plot!", "x": 1, "y": 2 },
        { "signage": "<city> Community Garden, grow your own vegetables!", "x": 22, "y": 2 }
      ]
    }
  },
  {
    "type": "mapgen",
    "method": "json",
    "om_terrain": "communitygarden_2_roof",
    "object": {
      "fill_ter": "t_open_air",
      "rows": [
        "                        ",
        "                        ",
        "                        ",
        "                        ",
        "                        ",
        "                        ",
        "                        ",
        "   ....                 ",
        "   ....                 ",
        "   ....                 ",
        "   ....                 ",
        "                        ",
        "                        ",
        "   oooooooooooooooooo   ",
        "   oooooooooooooooooo   ",
        "   oooooooooooooooooo   ",
        "   oooooooooooooooooo   ",
        "   oooooooooooooooooo   ",
        "   oooooooooooooooooo   ",
        "   oooooooooooooooooo   ",
        "   oooooooooooooooooo   ",
        "                        ",
        "                        ",
        "                        "
      ],
      "terrain": { ".": "t_shingle_flat_roof", "o": "t_glass_roof" }
    }
  }
]
