[
  {
    "method": "json",
    "om_terrain": [ [ "helipad_nw", "helipad_ne" ], [ "helipad_sw", "helipad_se" ] ],
    "type": "mapgen",
    "weight": 500,
    "object": {
      "fill_ter": "t_floor",
      "rows": [
        "FFF.......pppppppp...........................FFF",
        "FTFF|||||F!!!!!!!!FFFFFFFFFFFFFFFFFFFFFFFFFFFFTF",
        "FFG.|4ddw.ppppppppooo........................GFF",
        ".F..|-c?w.ppppppppoio|||||||||||||||||||||||..F.",
        ".F..|m|||.ppppppppooo|%_____________C__B___|..F.",
        ".F..pppppppppppppppppM___C_________C_CC_B__|..F.",
        ".F..pppppppppppppppppM____________CCCCC____|..F.",
        ".F..pppppppppppppppppM_B__C___B__B___C_B___|..F.",
        ".F..pppppyppppyppppppM__________________B__|..F.",
        ".F..pppppyppppyppppppM__B___C___B__C__B____|..F.",
        ".F..pppppyppppyppp...|____C___B____________|..F.",
        ".F..pppppyppppypppooox___________B______%__|..F.",
        ".F..pppppyppppyppp...||||||||m|MMMMMMMMM||||..F.",
        ".F..pppppyppppyppp...|rrrr_|____________%__|..F.",
        ".F..oooooooooooooo...|_____x_______________|..F.",
        ".F..............oo...|rrrr_|___IIIIIIIII_RR|..F.",
        ".F../w//w/ww/ww/xx///|||||||___IUUUUUUUI_sR|..F.",
        ".F../----+-----+--W&W|llll_|___IUUUUUUUI_75|..F.",
        ".F../-?ddWdc--dW--+-W|_____x___IUUUUUUUI___|..F.",
        ".F../z-cfWd?f?dW--WSW|llll_|___IUUUUUUUI_RR|..F.",
        ".F../WWWWWWWWWWWz-WWW|||||||___IUUUUUUUI_sR|..F.",
        ".F../[[[HH##O#SW--+-W|_____m___IUUUUUUUI_85|..F.",
        ".F../----------+--WgW|ggggg|___IUUUUUUUI___|..F.",
        ".F../-cttc---1WW--WWW|||||||___IUUUUUUUI___|..F.",
        ".F../-cttc-z-2W<-----m_____m___IUUUUUUUI%__|..F.",
        ".F..//www/www///xx///||||||||x|MMMMMMMMM||||..F.",
        ".F.......3P.....oo...........o.=========6666..F.",
        ".F..========================================..F.",
        ".F..========================================..F.",
        ".F..========================================..F.",
        ".F..$===============$======$===============$..F.",
        ".F...o,,,,,o..o,,,,,,,,,,,,,,,,,,o..o,,,,,o...F.",
        ".F...o=====o..o==================o..o=====o...F.",
        ".F..==========o===,,========,,===o==========..F.",
        ".F..==========o===,,========,,===o==========..F.",
        ".!..=,=====,==o===,,========,,===o==,=====,=..!.",
        ".!..=,=====,==o===,,========,,===o==,=====,=..!.",
        ".!..=,=====,==o===,,,,,,,,,,,,===o==,=====,=..!.",
        ".!..=,,,,,,,==o===,,,,,,,,,,,,===o==,,,,,,,=..!.",
        ".!..=,,,,,,,==o===,,========,,===o==,,,,,,,=..!.",
        ".!..=,=====,==o===,,========,,===o==,=====,=..!.",
        ".!..=,=====,==o===,,========,,===o==,=====,=..!.",
        ".!..=,=====,==o===,,========,,===o==,=====,=..!.",
        ".F..==========o==================o==========..F.",
        ".F..==========o==================o==========..F.",
        "FFG..........................................GFF",
        "FTFFFFFFFFFFFFFFFFFFFFFFFFFFFFFFFFFFFFFFFFFFFFTF",
        "FFF..........................................FFF"
      ],
      "palettes": [ "helipad_palette" ],
      "toilets": { "&": {  } },
      "gaspumps": { "$": {  } },
      "items": {
        "B": {
          "item": {
            "subtype": "distribution",
            "entries": [
              { "item": "30gal_drum", "prob": 50 },
              { "group": "fuel_barrel", "prob": 20 },
              { "group": "fuel_barrel_full", "prob": 30 }
            ]
          },
          "chance": 75
        },
        "C": {
          "item": {
            "subtype": "distribution",
            "entries": [
              { "group": "military_patrol_food", "prob": 50, "count": [ 3, 5 ] },
              { "group": "infantry_common_gear", "prob": 5, "count": [ 1, 2 ] },
              { "group": "mil_food", "prob": 40, "count": [ 1, 5 ] },
              { "group": "infantry_medical_gear", "prob": 5, "count": [ 1, 2 ] },
              { "group": "supplies_metal", "prob": 150, "count": [ 2, 6 ] },
              { "group": "supplies_mechanics_milspec", "prob": 50, "count": [ 1, 3 ] },
              { "group": "military_helicopter_parts", "prob": 75 }
            ]
          },
          "chance": 75
        },
        "l": {
          "item": {
            "subtype": "distribution",
            "entries": [
              { "group": "military_standard_guns", "prob": 50 },
              { "group": "military_standard_pistols", "prob": 25 },
              { "group": "military_standard_grenades", "prob": 25 },
              { "group": "military_ballistic_armor", "prob": 100 }
            ]
          },
          "chance": 50,
          "repeat": 2
        },
        "r": {
          "item": {
            "subtype": "distribution",
            "entries": [
              { "group": "supplies_plumbing", "prob": 25 },
              { "group": "supplies_electronics", "prob": 25 },
              { "group": "supplies_metal", "prob": 25 },
              { "group": "supplies_mechanics_milspec", "prob": 100 },
              { "group": "hardware", "prob": 50 }
            ]
          },
          "chance": 50,
          "repeat": 4
        },
        "d": { "item": "SUS_office_desk", "chance": 50 },
        "f": { "item": "SUS_office_filing_cabinet", "chance": 90 },
        "4": { "item": "military_standard_shotguns", "chance": 50 },
        "#": { "item": "SUS_utensils", "chance": 50 },
        "t": { "item": "SUS_dishes", "chance": 50 },
        "[": { "item": "SUS_fridge", "chance": 50 },
        "O": { "item": "SUS_oven", "chance": 75 },
        "H": { "item": "SUS_spice_collection", "chance": 75 },
        "&": { "item": "SUS_toilet", "chance": 50 }
      },
      "place_loot": [ { "item": "american_flag", "x": 18, "y": 3, "chance": 75 } ],
      "vendingmachines": { "1": { "item_group": "vending_drink" }, "2": { "item_group": "vending_food" } },
      "place_monster": [
        { "group": "GROUP_MIL_STRONG", "x": [ 24, 42 ], "y": [ 5, 10 ], "repeat": [ 1, 3 ] },
        { "group": "GROUP_MIL_WEAK", "x": [ 28, 40 ], "y": [ 14, 22 ], "repeat": [ 3, 6 ] },
        { "group": "GROUP_ROBOTS_MIL", "x": [ 4, 23 ], "y": [ 27, 30 ], "repeat": 2 }
      ],
      "monster": { "T": { "monster": "mon_turret_medium" } },
      "place_vehicles": [
        { "vehicle": "forklift", "x": 29, "y": 6, "chance": 75, "rotation": 180, "status": 1 },
        { "vehicle": "parkinglotbasic", "x": 6, "y": 9, "chance": 50, "rotation": 270, "status": -1 },
        { "vehicle": "flatbed_truck", "x": 11, "y": 4, "chance": 25, "rotation": 270, "status": -1 },
        { "vehicle": "mil_helicopters", "x": 5, "y": 36, "chance": 50, "rotation": 180, "status": -1 },
        { "vehicle": "mil_helicopters", "x": 42, "y": 36, "chance": 50, "rotation": 0, "status": -1 }
      ]
    }
  },
  {
    "method": "json",
    "om_terrain": [ [ "helipad2f_nw", "helipad2f_ne" ], [ "helipad2f_sw", "helipad2f_se" ] ],
    "type": "mapgen",
    "weight": 500,
    "object": {
      "fill_ter": "t_floor",
      "rows": [
        "************************************************",
        "****RRRRR***************************************",
        "****RRRRR***************************************",
        "****RRRRR************=======================****",
        "****RRRRR************=======================****",
        "*********************=======================****",
        "*********************=======================****",
        "*********************=======================****",
        "*********************=======================****",
        "*********************=======================****",
        "*********************=======================****",
        "*********************=======================****",
        "*********************=======================****",
        "*********************=======================****",
        "*********************=======================****",
        "****/////////////////=======================****",
        "****/bttbWbttbWSjjWh/=======================****",
        "****/b--bWb--bW-----/=======================****",
        "****/L--LWL--LW-LLWh/=======================****",
        "****/W+WWWW+WWW+WWWW/=======================****",
        "****/-----------W&-S/=======================****",
        "****/W+WWWW+WWW-WW+W/=======================****",
        "****/L--LWL--LW-----x=======================****",
        "****/b--bWb--bW-WW+W/=======================****",
        "****/bttbWbttbW>W&-S/===================DD==****",
        "****/////////////////=======================****",
        "************************************************",
        "************************************************",
        "************************************************",
        "************************************************",
        "************************************************",
        "************************************************",
        "************************************************",
        "************************************************",
        "************************************************",
        "************************************************",
        "************************************************",
        "************************************************",
        "************************************************",
        "************************************************",
        "************************************************",
        "************************************************",
        "************************************************",
        "************************************************",
        "************************************************",
        "************************************************",
        "************************************************",
        "************************************************"
      ],
      "palettes": [ "helipad_palette_roof" ],
      "toilets": { "&": {  } },
      "items": {
        "t": { "item": "bedroom", "chance": 50, "repeat": [ 0, 4 ] },
        "b": { "item": "bed", "repeat": [ 0, 3 ], "chance": 90 },
        "h": { "item": "SUS_bathroom_sink", "chance": 50 },
        "S": { "item": "SUS_bathroom_sink", "chance": 90 },
        "L": { "item": "army_personal_locker", "repeat": [ 0, 4 ], "chance": 50 },
        "=": { "item": "roof_trash", "chance": 2 },
        "&": { "item": "SUS_toilet", "chance": 50 }
      },
      "place_monster": [ { "group": "GROUP_MIL_WEAK", "x": [ 6, 17 ], "y": [ 17, 22 ], "repeat": [ 1, 3 ] } ],
      "place_nested": [
        {
          "chunks": [ [ "roof_2x2_infrastructure", 40 ], [ "roof_2x2_infrastructure_2", 30 ], [ "roof_2x2_utilities", 30 ] ],
          "x": [ 24, 42 ],
          "y": [ 4, 13 ]
        },
        {
          "chunks": [ [ "roof_2x2_infrastructure", 40 ], [ "roof_2x2_infrastructure_2", 30 ], [ "roof_2x2_utilities", 30 ] ],
          "x": [ 24, 42 ],
          "y": [ 14, 22 ]
        }
      ]
    }
  }
]
