[
  {
    "type": "mapgen",
    "method": "json",
    "om_terrain": [
      [ "hospital_3", "hospital_2", "hospital_1" ],
      [ "hospital_6", "hospital_5", "hospital_4" ],
      [ "hospital_9", "hospital_8", "hospital_7" ]
    ],
    "weight": 250,
    "object": {
      "fill_ter": "t_dirt",
      "rows": [
        "__________________________[___________________________'########;########",
        "______________________________________________________,#...cT#...#Tc...#",
        "_:____:____:____:_________:____:____:____:____:____:__,#BB...+...+...BB#",
        "_:____:____:____:_________:____:____:____:____:____:__,#BB...+...+...BB#",
        "_:____:____:____:_________:____:____:____:____:____:__,#....l#...#l....#",
        "_:____:____:____:_________:____:____:____:____:____:__,#######...#######",
        "_:____:____:____:_________:____:____:____:____:____:__,#....l#...#l....#",
        "_:____:____:____:_________:____:____:____:____:____:__,#BB...+...+...BB#",
        "G,,,,,,,,,,,,,,,,,,,,,,,,,,,,,,,,,,,,,,,,,,,,,,,,,,,,,,#BB...+...+...BB#",
        "####################//####xxxxxxxxxxxxxxxxxxxxxxxxxx#;;#...cT#...#Tc...#",
        "#&#&#&#&#&#sssss#.........TbbbbTbbbbTbbbbTbbbbTbbbbT#``#######...#######",
        "#.#.#.#.#.#.....#..................................b#``#...cT#...#Tc...#",
        "#+#+#+#+#+#.....+..................................b#``#BB...+...+...BB#",
        "#...............+..................................b#``#BB...+...+...BB#",
        "#...............#..................................b#``#....l#...#l....#",
        "#################F........xCCCCCCCCCx..............T#``#######...#######",
        "#...............#.........x.c.c.c.c.x..............b#``#....l#...#l....#",
        "#...............+........./.........x..............b#``#BB...+...+...BB#",
        "#+#+#+#+#+#.....+........./.........x..............b#``#BB...+...+...BB#",
        "#.#.#.#.#.#.....#.........x.........x..............b#``#...cT#...#Tc...#",
        "#&#&#&#&#&#sssss#.D.....F.#rr###+####.DF.TbbbbTbbbbT#``#######///#######",
        "####################//########r....d#################``#l.rrr#...#rrr.l#",
        "#...ll...x...ll...x....#SSSTf#r...cd#s.&#&.s#s.&#&.s#``#l....!...!....l#",
        "#.TB..BT.x.TB..BT.x....#.....+.....L#...#...#...#...#``#l.rrr#...#rrr.l#",
        "#r.B..B.rxr.B..B.rx....#########!#####+###+###+###+##;;#######...#######",
        "#r......rxr......rx....................................................#",
        "#xxx//xxxxxxx//xxxx....................................................;",
        "#......................................................................#",
        "#......................####################...#######;;#######...#######",
        "#......................x...........l#8....#...#rrr.l#``#l.rrr#...#rrr.l#",
        "#....................../.....A..BT.l#8....!...!....l#``#l....!...!....l#",
        "#....................../.....?..B..r#88888#...#rrr.l#``#l.rrr#...#rrr.l#",
        "#6.....................x...........r#######///#######``#######///#######",
        "##X#################///##############...cT#...#Tc...#``#...cT#...#Tc...#",
        "#H.......H#.......l#...x...........l#BB...+...+...BB#``#BB...+...+...BB#",
        "#H.......H#r.TBBT..#.../.....TBBT...#BB...+...+...BB#``#BB...+...+...BB#",
        "#H.......H#r..BB...#.../......BB...r#....l#...#l....#``#....l#...#l....#",
        "#H.......H#........#...x...........r#######...#######``#######...#######",
        "###########xxx//xxx#...##############....l#...#l....#``#....l#...#l....#",
        "#l........x............x...........R#BB...+...+...BB#``#BB...+...+...BB#",
        "#R.TB..A../............/.....7.....R#BB...+...+...BB#``#BB...+...+...BB#",
        "#R..B..?../............/.....*.....R#...cT#...#Tc...#``#...cT#...#Tc...#",
        "#.........x............x.......22..R#######...#######``#######...#######",
        "###########xxx//xxx#...##############...cT#...#Tc...#``#...cT#...#Tc...#",
        "##----#####........#...x...........r#BB...+...+...BB#``#BB...+...+...BB#",
        "##----#<.##r..BB...#.../......BB...r#BB...+...+...BB#``#BB...+...+...BB#",
        "##----#<.##r.TBBT..#.../.....TBBT...#....l#...#l....#``#....l#...#l....#",
        "##---5#..##.......l#...x...........l#######...#######``#######...#######",
        "##x//x##!############///#############....l#...#l....#``#....l#...#l....#",
        ";``````````````````;....bbb.bbb.bbb.#BB...+...+...BB#``#BB...+...+...BB#",
        ";``````````````````;...............b#BB...+...+...BB#``#BB...+...+...BB#",
        "######;;############...............b#...cT#...#Tc...#``#...cT#...#Tc...#",
        "#&..#....LLLLLLLLLL#...............b#######...#######``#######...#######",
        "#...+..............!................#...cT#...#Tc...#``#...cT#...#Tc...#",
        "#..s#.....bbb.rrrr.#...............b#BB...+...+...BB#``#BB...+...+...BB#",
        "#####....###########...............b#BB...#...+...BB#``#BB...#...+...BB#",
        "#kddd...C#d..ddd..d#...............b#....l#...#l....#``#....l#...#l....#",
        "w..c....C#dc..c..cd#................#######///#######;;#######///#######",
        "#.......C#d.......d#.............................................#88888#",
        "w........+.........!.............................................!....8#",
        "#SSSSSS.f#lllkkkrrr#.............................................#....8#",
        "####################xxxxxxxxxxxx///x##+###+###+###+##;;#######///#######",
        "x...................................#...#...#...#...#``#...cT#...#Tc...#",
        "x..bbbb..bbbb..bbbb..bbbb..bbbb....4#s.&#&.s#s.&#&.s#``#BB...+...+...BB#",
        "x..TTTT..TTTT..TTTT..TTTT..TTTT....4#################``#BB...+...+...BB#",
        "x..bbbb..bbbb..bbbb..bbbb..bbbb....4#44444#ssss#ssss#``#....l#...#l....#",
        "x...................................#...............#``#######...#######",
        "x..bbbb..bbbb..bbbb..bbbb..bbbb.....+......99999999.;``#....l#...#l....#",
        "x..TTTT..TTTT..TTTT..TTTT..TTTT.....+......99999999.;``#BB...+...+...BB#",
        "x..bbbb..bbbb..bbbb..bbbb..bbbb.....#...............#``#BB...+...+...BB#",
        "x...............................444.#44444#oooo#ffff#``#...cT#...#Tc...#",
        "xxxxxxxxxxxxxxxxxxxxxxxxxxxxxx#######################;;#################"
      ],
      "palettes": [ "hospital" ],
      "terrain": { "<": "t_stairs_up", "H": "t_floor", "X": "t_door_metal_locked", "G": "t_gutter_downspout" },
      "furniture": { "H": "f_locker" },
      "vendingmachines": { "D": { "item_group": "vending_drink" }, "F": { "item_group": "vending_food" } },
      "computers": {
        "6": {
          "name": "Medical Supply Access",
          "security": 2,
          "options": [ { "name": "Unlock Door", "action": "unlock" } ],
          "failures": [ { "action": "shutdown" }, { "action": "alarm" } ]
        },
        "7": {
          "name": "Centrifuge",
          "options": [ { "name": "Analyze blood", "action": "blood_anal" } ],
          "failures": [ { "action": "destroy_blood" } ]
        }
      },
      "items": {
        "b": { "item": "magazines", "chance": 50 },
        "B": { "item": "hospital_bed", "chance": 80 },
        "f": { "item": "fridge", "chance": 90 },
        "d": { "item": "office", "chance": 80 },
        "C": { "item": "office", "chance": 20 },
        "S": { "item": "bed", "chance": 60 },
        "r": { "item": "hospital_medical_items", "chance": 70 },
        "R": { "item": "hospital_lab", "chance": 70 },
        "l": { "item": "surgery", "chance": 80 },
        "L": { "item": "allclothes", "chance": 90 },
        "8": { "item": "cleaning", "chance": 70 },
        "9": { "item": "produce", "chance": 40 },
        "T": { "item": "snacks", "chance": 50 },
        "2": { "item": "hospital_samples", "chance": 50 },
        "k": { "item": "doctors_books", "chance": 75, "repeat": 4 },
        "H": [
          { "item": "harddrugs", "chance": 60 },
          { "item": "gear_medical", "chance": 60, "repeat": [ 1, 3 ] },
          { "item": "drugs_analgesic", "chance": 60, "repeat": [ 1, 3 ] },
          { "item": "drugs_rare", "chance": 60 },
          { "item": "surgery", "chance": 60 }
        ]
      },
      "place_loot": [ { "group": "autodoc_installation_programs_basic", "x": 1, "y": [ 34, 37 ], "chance": 75, "repeat": 4 } ],
      "place_monster": [
        { "group": "GROUP_HOSPITAL", "x": [ 0, 23 ], "y": [ 0, 23 ], "repeat": [ 15, 20 ] },
        { "group": "GROUP_HOSPITAL", "x": [ 25, 46 ], "y": [ 1, 22 ], "repeat": [ 15, 20 ] },
        { "group": "GROUP_HOSPITAL", "x": [ 49, 70 ], "y": [ 1, 22 ], "repeat": [ 15, 20 ] },
        { "group": "GROUP_HOSPITAL", "x": [ 1, 22 ], "y": [ 25, 46 ], "repeat": [ 15, 20 ] },
        { "group": "GROUP_HOSPITAL", "x": [ 25, 46 ], "y": [ 25, 46 ], "repeat": [ 15, 20 ] },
        { "group": "GROUP_HOSPITAL", "x": [ 49, 70 ], "y": [ 25, 46 ], "repeat": [ 15, 20 ] },
        { "group": "GROUP_HOSPITAL", "x": [ 1, 22 ], "y": [ 49, 70 ], "repeat": [ 15, 20 ] },
        { "group": "GROUP_HOSPITAL", "x": [ 25, 46 ], "y": [ 49, 70 ], "repeat": [ 15, 20 ] },
        { "group": "GROUP_HOSPITAL", "x": [ 49, 70 ], "y": [ 49, 70 ], "repeat": [ 15, 20 ] }
      ]
    }
  },
  {
    "type": "mapgen",
    "method": "json",
    "om_terrain": [
      [ "hospital_3_roof", "hospital_2_roof", "hospital_1_roof" ],
      [ "hospital_6_roof", "hospital_5_roof", "hospital_4_roof" ],
      [ "hospital_9_roof", "hospital_8_roof", "hospital_7_roof" ]
    ],
    "weight": 250,
    "object": {
      "fill_ter": "t_flat_roof",
      "rows": [
        "                                                       -----------------",
        "                                                       -...............-",
        "                                                       -...............-",
        "                                                       -...............-",
        "                                                       -...............-",
        "                                                       -...............-",
        "                                                       -...............-",
        "                                                       -...............-",
        "                                                       -...............-",
        "5-------------------------------------------------------...............-",
        "-......................................................................-",
        "-......................................................................-",
        "-......................................................................-",
        "-......................................................................-",
        "-......................................................................-",
        "-......................................................................-",
        "-......................................................................-",
        "-......................................................................-",
        "-......................................................................-",
        "-......................................................................-",
        "-......................................................................-",
        "-......................................................................-",
        "-......................................................................-",
        "-......................................................................-",
        "-......................................................................-",
        "-......................................................................-",
        "-......................................................................-",
        "-......................................................................-",
        "-......................................................................-",
        "-......................................................................-",
        "-......................................................................-",
        "-......................................................................-",
        "-......................................................................-",
        "-......................................................................-",
        "-......................................................................-",
        "-......................................................................-",
        "-......................................................................-",
        "-......................................................................-",
        "-......................................................................-",
        "-......................................................................-",
        "-......................................................................-",
        "-......................................................................-",
        "-......................................................................-",
        "-######................................................................-",
        "-#7777####.............................................................-",
        "-#7777#>_#.............................................................-",
        "-#7777#>_#.............................................................-",
        "-#777E#__#.............................................................-",
        "-#x//x##;#.............................................................-",
        "-.4444444444444........................................................-",
        "-.4444444444444........................................................-",
        "-....44.````````.......................................................-",
        "-....44``````````......................................................-",
        "-....44`,``````,`......................................................-",
        "-....44`,``````,`......................................................-",
        "-....44`,``````,`......................................................-",
        "-....44`,,,,,,,,`......................................................-",
        "-....44`,,,,,,,,`......................................................-",
        "-....44`,``````,`......................................................-",
        "-....44`,``````,`......................................................-",
        "-....44`,``````,`......................................................-",
        "-......``````````......................................................-",
        "-.......````````.......................................................-",
        "-......................................................................-",
        "-......................................................................-",
        "-......................................................................-",
        "-......................................................................-",
        "-......................................................................-",
        "-......................................................................-",
        "-......................................................................-",
        "-......................................................................-",
        "------------------------------------------------------------------------"
      ],
      "palettes": [ "roof_palette" ],
      "terrain": {
        ">": "t_stairs_down",
        "#": "t_wall",
        "_": "t_floor",
        ",": "t_concrete_y",
        "`": "t_concrete",
        "7": "t_elevator",
        "/": "t_door_glass_c",
        ";": "t_door_locked",
        "x": "t_wall_glass",
        "4": "t_sidewalk",
        "E": "t_elevator_control"
      },
      "place_nested": [
        {
          "chunks": [
            [ "null", 25 ],
            [ "roof_2x2_infrastructure", 25 ],
            [ "roof_2x2_infrastructure_1", 25 ],
            [ "roof_2x2_infrastructure_2", 25 ]
          ],
          "x": [ 1, 18 ],
          "y": [ 10, 18 ]
        },
        {
          "chunks": [
            [ "null", 20 ],
            [ "roof_2x2_infrastructure", 25 ],
            [ "roof_2x2_infrastructure_1", 25 ],
            [ "roof_2x2_infrastructure_2", 25 ]
          ],
          "x": [ 24, 42 ],
          "y": [ 10, 18 ]
        },
        {
          "chunks": [
            [ "null", 25 ],
            [ "roof_2x2_utilities", 10 ],
            [ "roof_2x2_utilities_b", 5 ],
            [ "roof_2x2_utilities_c", 5 ],
            [ "roof_2x2_utilities_d", 5 ],
            [ "roof_4x4_utility", 15 ],
            [ "roof_4x4_utility_1", 10 ],
            [ "roof_6x6_utility", 25 ]
          ],
          "x": [ 56, 65 ],
          "y": [ 1, 18 ]
        },
        {
          "chunks": [
            [ "null", 25 ],
            [ "roof_2x2_utilities", 10 ],
            [ "roof_2x2_utilities_b", 5 ],
            [ "roof_2x2_utilities_c", 5 ],
            [ "roof_2x2_utilities_d", 5 ],
            [ "roof_4x4_utility", 15 ],
            [ "roof_4x4_utility_1", 10 ],
            [ "roof_6x6_utility", 25 ]
          ],
          "x": [ 48, 65 ],
          "y": [ 24, 42 ]
        },
        {
          "chunks": [
            [ "null", 25 ],
            [ "roof_2x2_utilities", 10 ],
            [ "roof_2x2_utilities_b", 5 ],
            [ "roof_2x2_utilities_c", 5 ],
            [ "roof_2x2_utilities_d", 5 ],
            [ "roof_4x4_utility", 15 ],
            [ "roof_4x4_utility_1", 10 ],
            [ "roof_6x6_utility", 25 ]
          ],
          "x": [ 48, 65 ],
          "y": [ 48, 65 ]
        },
        {
          "chunks": [
            [ "null", 40 ],
            [ "roof_2x2_golf", 15 ],
            [ "roof_4x4_party", 15 ],
            [ "roof_4x4_holdout", 15 ],
            [ "roof_4x4_survivor", 15 ]
          ],
          "x": [ 1, 20 ],
          "y": [ 64, 67 ]
        },
        { "chunks": [ [ "null", 40 ], [ "roof_16x16_help", 60 ] ], "x": [ 25, 30 ], "y": [ 48, 55 ] }
      ],
      "place_vehicles": [ { "vehicle": "helicopters", "x": 10, "y": 56, "chance": 80, "rotation": 270 } ]
    }
  }
]
