[
  {
    "type": "mapgen",
    "method": "json",
    "om_terrain": [
      [
        "industrial_center_warehouse",
        "industrial_center_light_industry",
        "industrial_center_pump_station",
        "industrial_center_substation"
      ],
      [
        "industrial_center_loading_bay",
        "industrial_center_nw_road",
        "industrial_center_ne_road",
        "industrial_center_medical_center"
      ],
      [
        "industrial_center_west_road",
        "industrial_center_sw_road",
        "industrial_center_se_road",
        "industrial_center_data_center"
      ],
      [
        "industrial_center_parking_lot_1",
        "industrial_center_south_access",
        "industrial_center_parking_lot_2",
        "industrial_center_admin"
      ]
    ],
    "weight": 250,
    "object": {
      "rows": [
        "[[[[[[[[[[[[[[[[[[[[[[[[[[[[[[[[[[[[[[[[[[[[[[[[[[[[[[[[[[[[[[[[[[[[[[[[[[[[[[[[[[[[[[[[[[[[[[[[",
        "[                                                                       [''''''''''''''''''3'''[",
        "[ |||||||||||||||==|||      ||||||||||            WWWwWWwWWwWWwWWWWWWW  [''''''''''''''''''''''[",
        "[ |CCCCCCCCCCC|Bdd..c|      |r;;zqqqq|            Wrr;;;;;;;;;;{{r[rrW  [''''''''''''''''''0'''[",
        "[ |CCC;CCC;CCC|..h..c||||||||r;;;;;;;|    4       Wr;;;;;;;;;;;;;;[;;W  [''''''''''''''''325'3'[",
        "[ |CC;;;C;;;CC=h.....|r;rr;r|r;;;;;;n|||||||      wr;;;;;;;;;;;;;;&;mw  WWWWWWWWW''''''''''''''[",
        "[ |CC;;;;C;;;C=h..||||r;;;;r|;;;;;;;n|{;n;S|      Wpp%%p%%p%%p%%;;[;;W  wd.....cW''''''''319'3'[",
        "[ |C;;;;;;;;;C|h..+..|r;;;;r|EE;;;;;n|{;n;;|      Wp;%%;%%;%%;%%;;[rrW  wda....cW''''''''''''''[",
        "[ |CC;;CC;;;;;|...|sT|;;;;;;|EE;;;;;n|{;;;}|      wp;;;;;;;;;;;;;;WWWW  wi.....6w'''''319375'3'[",
        "[ |C;;;;C;;;;C||+||||||[&&[|||||++||||||+||||||   Wp;;;;;;;;;;;;;;WrrW  WWWW..a6w''''''''''''''[",
        "[ |;;;;;;;;;;CC;;;;;;;|;;;;;;;;;;;;{{|;;;;;;;;|   WGG;;;;;rrrr;;;;!;;W  WscW...6w''''28''''''''[",
        "[ |;;;;;;;;;CCC;;;;;;;+;;;;;;;;;;;;;;|;;;;;q;;|   wGG;;;WWWWWWWW;;WrrW  W..+...cW'''''3''''''3'[",
        "[ |;;C;;;;;;;;;;;;;;;;+;;;;;q;k;;;;;;+;;;;;qk;|   Wp;;;;W<]]UU]W;;WWWW  WT.W...cW'''''''888''''[",
        "[ |;;;;;;;;;;;;;;;;;;;|;;;;;q66qq;;;;|;;;;;6;;|   WGG;;;W]]]UU]W;;WrrW  WWWWWDWWW'''''''888''''[",
        "[ |C;;;;;;;;;;;;;;;CC||;;;;;;;;;;;;;;||;;;;qq||   wGG;;;WU]]]]]W;;!;;W  ['4'''''''''''3'888''''[",
        "[ |CC;;;;;;;;;;;;;CCC|;;;;;;;;;;;;;;;;|;;;;;;|    W;;;;;WUU]]]]W;;WrrW  [''''''''''''28''''''3'[",
        "[ |CC;;;;;;;;;;;;;;CC|;/y;;/x;;/H;;GG;|n;;;;n|    WWWW+WWU]]]]]WW+WWWW  [''''''''''''''''''''''[",
        "[ |C;;;;;;;;;;;;;CCCC|;/y;;/x;;/H;;GG;|n;;;;n|    Wd6...W]]]]]]Wr;;;{W  ['''''''''''''319325'3'[",
        "[ |CC;;;;;;;;;;;;CCCC|;;;;;;;;;;;;;;;;|;;;;;;|    Whd..hw]]]]]]Wr;;;{W  [[&&[''''''''''''''9'''[",
        "[ |CCC;;;;;;;;;;;;;CC||||||||||||||||||=|++|=|    W.d...w]]]]]]D;;;;{W  ]]''[''''''''''''''1'''[",
        "[ |C;;;;;;;;;;;;;;;;;|]]                 ]]      4W...BBW]]]]]]Wrrr;{W  ]]''[''''''''''''375'3'[",
        "[ |CC;C;;;;;;;;;;;;;;+]]                 ]]       WWwwwWW]]]]]]WWWWWWW  ]]''[''''''''''''''0'''[",
        "[ |CCC;;;;;;;;;;;;;;;|]]                 ]]         ]]]]]]]]]]]]RRR]    ]]''[[[[[[[[[[[[[[[[[[[[",
        "[ ||C;;;;;;;;;;;;;;C||]]                 ]]         ]]]]]]]]]]]]]]]]    ]]                     [",

        "[  |;;;;;;;;;;;;;;;C| ]]                 ]] -======-]]____________]]    ]]                     [",
        "[ 4|C;;;;;;;;;;;;;LC| ]]                 ]]t-bbvVbb-]]____________]]    ]]                 4   [",
        "[  |||MMMMMMMMMMMM||| ]]]]]]]]]]]]]]]]]]]]]]]]]]]]]]]]____________]]]]]]]]|||||||||||||||||||| [",
        "[   I_____________LI  ]]]]]]]]]]]]]]]]]]]]]]]]]]]]]]]]____________]]]]]]]]|.....|^..*|..c|ssc| [",
        "[   _:____________:_  ]],,]]____________________________________________]]|.d...+....+..c|...| [",
        "[   _:____________:_  ]],,]]____________________________________________]]|hd.h.|..h.+..c||+|| [",
        "[   _:____________:_  ]],,]]____________________________________________]]|||||||66di|..c|..c| [",
        "[   _:____________:_  ]],,]]____________________________________________]]|....T||||||..h|..c| [",
        "[   I______________I  ]],,]]____________________________________________]]|j...s|...s|..h|...| [",
        "[ ____________________]],,]]____________________________________________]]|||+|||.h.c|...|.).| [",
        "[ ____________________]],,]]____________________________________________]]|h...h|.e.c|...+.(.| [",
        "[ ____________________]],,]]____________:::_:::_:::_:::_____________::::]]=h...h|a...|...|...| [",
        "[ ____________________]],,]]____________:::_:::_:::_:::_________________]]=h....|||+|||+|||||| [",
        "[ ____________________]],,]]____________________________________________]]=h....+....D......f| [",
        "[ ____________________]],,]]____________________________________________]]|.....+....D......c| [",
        "[ ____________________]],,]]____________________________________________]]=.....|||+||||||..c| [",
        "[ ____________________]],,]]____________________________________________]]|..cc.|s...|lll|..s| [",
        "[ ____________________]],,]]_______::______________________::___________]]g..c*.|c.ea|...|..^| [",
        "[ ____________________]],,]]_______::______________________::___________]]g..ch.|c.h.|l..M...| [",
        "[ ____________________]],,]]_______::______________________::_______::::]]|..c..|....|l..|...| [",
        "[ ]]_______::_:::::_]]]],,]]_________________######_____________________]]=..c..|^lll|l.A|A..| [",
        "[ ]]_______::_______]]]],,]]_______::_______##,,,,##_______::___________]]||===||||||||||||D|| [",
        "[ ]]_______::_______]],,,,]]_______::_______#,,,,,,#_______::___________]]]]]]]]]]]]]]]]]]]]   [",
        "[ ]]________________]],,,,]]_______::_______#,,,,,,#_______::___________]]                     [",

        "[ ]]________________]],,,,]]________________#,,,,,,#____________________]]                     [",
        "[ ]]_______::_______]],,,,]]_______::_______#,,,,,,#_______::___________]]WWWWWWWWWWWWWWWWWW   [",
        "[ ]]_______::_______]]]]]]]]_______::_______##,,,,##_______::___________]]Wda.iiiiii.d66d.iW   [",
        "[ ]]_:::::_::_______]]]]]]]]_:::::_::________######________::_______::::]]Wd...........a..iW   [",
        "[ ]]____________________________________________________________________]]Wd..............iW   [",
        "[ ]]________________:___________________________________________________]]W..$$$$e...$$$$.iW   [",
        "[ ]]________________:___________________________________________________]]W6.$$$$e...$$$$..W   [",
        "[ ]]________________:___________________________________________________]]W6..............*W   [",
        "[ ]]________________:___________________________________________________]]WWWWWWWWWW+WWWWWWW   [",
        "[ ]]________________:___________________________________________________]]      ]]W...6..W     [",
        "[ ]]____________________________________________________________________]]      ]]=...dh.W     [",
        "[ ]]________________:::_:::_________________:::_:::_________________::::]]]]]]]]]]g...d..W     [",
        "[ ]]________________:::_:::_________________:::_:::_____________________]]]]]]]]]]g...dd.W     [",
        "[ ]]____________________________________________________________________]]      ]]=......W     [",
        "[ ]]______________________:_____________________________________________]]      ]]W...BBBW     [",
        "[ ]]______________________:_____________________________________________]]   WWWWWWW+WWWWWWW   [",
        "[ ]]______________________:_____________________________________________]]   Whhh.......WsTW   [",
        "[ ]]______________________:_____________________________________________]]   W..........+..W4  [",
        "[ ]]______________________:_____________________________________________]]   wh.ee......WWWWWW [",
        "[ ]]____________________________________________________________________]]   wh.ee......W....W [",
        "[ ]]________________]]]]]]]]________________]]]]]]]]________________]]]]]]   W..........+...<W [",
        "[ ]]_______::_:::::_]]]]]]]]_______::_:::::_]]]]]]]]_______::_:::::_]]]]]]   Wheh^h*ccF.W....W [",
        "[ ]]_______::_______]],,,,]]_______::_______]],,,,]]_______::_______]]]]WWwwWWWWWWWWWWWWWW++WW [",
        "[ ]]_______::_______]],,,,]]_______::_______]],,,,]]_______::_______]]]]W....Ws..+TWi.ddW....W [",

        "[ ]]________________]]]],,]]________________]],,]]]]________________]]]]w.PP.Wc..WWW..hdW...^w [",
        "[ ]]________________]]]],,]]_______::_______]],,]]]]________________]]]]w.PP.Ws..+TW...dW...^w [",
        "[ ____________________]],,]]_______::_______]],,]]____________________]]w.PP.Wc..WWWW+WWW....w [",
        "[ ____________________]],,]]_______::_______]],,]]____________________]]W....Ws..+TW....c....W [",
        "[ ____________________]],,]]________________]],,]]____________________]]W...*WWW+WWW...hc....W [",
        "[ ____________________]],,]]_______::_______]],,]]____________________]]Wh..sWl...lW....c....W [",
        "[ ____________________]],,]]_______::_______]],,]]____________________]]we..BWl...lW........BW [",
        "[ :::::::______:::::::]],,]]_______::_______]],,]]:::::::______:::::::]]we..cWl....WWWWW....hw [",
        "[ ____________________]],,]]________________]],,]]____________________]]wh..FWl........W....hw [",
        "[ ____________________]],,]]_______::_______]],,]]____________________]]W...cWl........+....hw [",
        "[ ____________________]]  ]]_______::_______]]  ]]____________________]]W...cWl........W.BhheW [",
        "[ ____________________]] t]]_______::_______]]t ]]____________________]]WW+WWW.........WWwwwWW [",
        "[ :::::::______:::::::]]--]]________________]]--]]:::::::______:::::::]]W.............hW4      [",
        "[ ____________________]]=b]]_______::_______]]b=]]____________________]]+.........BB..ew       [",
        "[ ____________________]]=b]]_______::_______]]b=]]____________________]]+.........BB..ew       [",
        "[ ____________________]]=V]]_______::_______]]V=]]____________________]]W.^^..........hW       [",
        "[ ____________________]]=v]]________________]]v=]]____________________]]WWWWWW+WWWWWwwWW       [",
        "[ :::::::______:::::::]]=b]]_______::_______]]b=]]:::::::______:::::::]]W..lW...h.W            [",
        "[ ____________________]]=b]]_______::_______]]b=]]____________________]]D..eW.....w       ]]]  [",
        "[ ____________________]]--]]_______::_______]]--]]____________________]]W..eW..dddw       ]I]  [",
        "[ ____________________]]]]]]________________]]]]]]____________________]]W..lWi..hdW       ]]]  [",
        "[ ____________________]]]]]]_______::_______]]]]]]____________________]]WWWWWWWwwWW            [",
        "[                         ||_______::_______||                                                 [",
        "[[[[[[[[[[[[[[[[[[[[[[[[[[||_______::_______||[[[[[[[[[[[[[[[[[[[[[[[[[[[[[[[[[[[[[[[[[[[[[[[[[["
      ],
      "palettes": [ "industrial_center_palette" ],
      "place_loot": [ { "item": "american_flag", "x": 90, "y": 91, "chance": 25 } ]
    }
  },
  {
    "type": "mapgen",
    "method": "json",
    "om_terrain": [ "industrial_center_warehouse_roof" ],
    "weight": 250,
    "object": {
      "fill_ter": "t_tar_flat_roof",
      "rows": [
        "                        ",
        "                        ",
        "  |2222222222222222223  ",
        "  |..................322",
        "  |.............:.......",
        "  |..R..................",
        "  |.....................",
        "  |.....................",
        "  |.....................",
        "  |.....................",
        "  |.....................",
        "  |.....................",
        "  |.....................",
        "  |.....................",
        "  |.....................",
        "  |.........&...........",
        "  |.....................",
        "  |.....................",
        "  |.....................",
        "  |..=...............3--",
        "  |..................3  ",
        "  |..................3  ",
        "  |..................3  ",
        "  ||................33  "
      ],
      "palettes": [ "roof_palette" ],
      "terrain": { ".": "t_tar_flat_roof" },
      "nested": { "R": { "chunks": [ "roof_2x2_infrastructure_1" ] } }
    }
  },
  {
    "type": "mapgen",
    "method": "json",
    "om_terrain": [ "industrial_center_light_industry_roof" ],
    "weight": 250,
    "object": {
      "fill_ter": "t_tar_flat_roof",
      "rows": [
        "                        ",
        "                        ",
        "    |222222223          ",
        "    |........3          ",
        "2222|........3222253    ",
        "...................3    ",
        "...................3    ",
        "...................3    ",
        "...................3223 ",
        "......................3 ",
        "......................3 ",
        "......................3 ",
        "......................3 ",
        ".....................33 ",
        ".....AA..............3  ",
        ".....................3  ",
        ".....................3  ",
        ".....=...............3  ",
        "---------------------3  ",
        "                        ",
        "                        ",
        "                        ",
        "                        ",
        "                        "
      ],
      "palettes": [ "roof_palette" ],
      "terrain": { ".": "t_tar_flat_roof" },
      "place_nested": [
        {
          "chunks": [
            [ "null", 20 ],
            [ "roof_2x2_utilities_b", 15 ],
            [ "roof_2x2_utilities_c", 5 ],
            [ "roof_2x2_utilities_d", 40 ],
            [ "roof_2x2_utilities", 50 ]
          ],
          "x": 6,
          "y": 4
        },
        {
          "chunks": [
            [ "null", 20 ],
            [ "roof_2x2_utilities_b", 15 ],
            [ "roof_2x2_utilities_c", 5 ],
            [ "roof_2x2_utilities_d", 40 ],
            [ "roof_2x2_utilities", 50 ]
          ],
          "x": [ 8, 18 ],
          "y": [ 11, 15 ]
        }
      ]
    }
  },
  {
    "type": "mapgen",
    "method": "json",
    "om_terrain": [ "industrial_center_pump_station_roof" ],
    "weight": 250,
    "object": {
      "fill_ter": "t_flat_roof",
      "rows": [
        "                        ",
        "                        ",
        "  |2222222222222222223  ",
        "  |..................3  ",
        "  |..................3  ",
        "  |..................3  ",
        "  |..................3  ",
        "  |..................3  ",
        "  |..................3  ",
        "  |..................3  ",
        "  |..................3  ",
        "  |.....##-----|.....3  ",
        "  |.....#>     |.....3  ",
        "  |.....3      |.....3  ",
        "  |.....3      |.....3  ",
        "  |.....3      |.....3  ",
        "  |.....3      |.....3  ",
        "  |.....3      |.....3  ",
        "  |.Z...3      |..U..3  ",
        "  |.....3      |.....3  ",
        "  5.....3      |.....3  ",
        "  |-----3      |-----3  ",
        "                        ",
        "                        "
      ],
      "palettes": [ "roof_palette" ],
      "terrain": { ">": "t_ladder_down" },
      "nested": { "U": { "chunks": [ "roof_2x2_infrastructure" ] }, "Z": { "chunks": [ "roof_2x2_infrastructure_2" ] } },
      "place_nested": [
        {
          "chunks": [
            [ "null", 20 ],
            [ "roof_4x4_party", 15 ],
            [ "roof_4x4_utility", 40 ],
            [ "roof_4x4_utility_1", 30 ],
            [ "roof_6x6_survivor", 20 ],
            [ "roof_6x6_utility", 20 ]
          ],
          "x": [ 5, 12 ],
          "y": [ 4, 6 ]
        }
      ]
    }
  },
  {
    "type": "mapgen",
    "method": "json",
    "om_terrain": [ "industrial_center_substation_roof" ],
    "weight": 250,
    "object": {
      "fill_ter": "t_tar_flat_roof",
      "rows": [
        "                        ",
        "                        ",
        "                        ",
        "                        ",
        "                        ",
        "|22222223               ",
        "|.......3               ",
        "|.......3               ",
        "|.......3               ",
        "|.......3               ",
        "|.......3               ",
        "|.......3               ",
        "|.......3               ",
        "|-5-----3               ",
        "                        ",
        "                        ",
        "                        ",
        "                        ",
        "                        ",
        "                        ",
        "                        ",
        "                        ",
        "                        ",
        "                        "
      ],
      "palettes": [ "roof_palette" ],
      "terrain": { ".": "t_tar_flat_roof" }
    }
  },
  {
    "type": "mapgen",
    "method": "json",
    "om_terrain": [ "industrial_center_loading_bay_roof" ],
    "weight": 250,
    "object": {
      "fill_ter": "t_flat_roof",
      "rows": [
        "   |................3   ",
        "   4................3   ",
        "   |----------------3   ",
        "                        ",
        "                        ",
        "                        ",
        "                        ",
        "                        ",
        "                        ",
        "                        ",
        "                        ",
        "                        ",
        "                        ",
        "                        ",
        "                        ",
        "                        ",
        "                        ",
        "                        ",
        "                        ",
        "                        ",
        "                        ",
        "                        ",
        "                        ",
        "                        "
      ],
      "palettes": [ "roof_palette" ],
      "terrain": { ".": "t_tar_flat_roof" }
    }
  },
  {
    "type": "mapgen",
    "method": "json",
    "om_terrain": [ "industrial_center_medical_center_roof" ],
    "weight": 250,
    "object": {
      "fill_ter": "t_tar_flat_roof",
      "rows": [
        "                        ",
        "                        ",
        "  |2222222222222222523  ",
        "  |..................3  ",
        "  |..................3  ",
        "  |..................3  ",
        "  |..................3  ",
        "  |..................3  ",
        "  |..................3  ",
        "  |..................3  ",
        "  |..................3  ",
        "  |...............&..3  ",
        "  |..................3  ",
        "  |.................=3  ",
        "  |..................3  ",
        "  |..................3  ",
        "  |..................3  ",
        "  |..................3  ",
        "  |..................3  ",
        "  |..................3  ",
        "  |..................3  ",
        "  |------------------3  ",
        "                        ",
        "                        "
      ],
      "palettes": [ "roof_palette" ],
      "terrain": { ".": "t_tar_flat_roof" },
      "place_items": [ { "item": "roof_trash", "x": [ 4, 18 ], "y": [ 5, 18 ], "chance": 50, "repeat": [ 1, 3 ] } ],
      "place_nested": [
        {
          "chunks": [
            [ "null", 20 ],
            [ "roof_2x2_utilities_b", 15 ],
            [ "roof_2x2_utilities_c", 5 ],
            [ "roof_2x2_utilities_d", 40 ],
            [ "roof_2x2_utilities", 50 ],
            [ "roof_2x2_golf", 10 ],
            [ "roof_3x3_wine", 5 ],
            [ "roof_4x4_utility_1", 30 ],
            [ "roof_4x4_party", 5 ],
            [ "roof_4x4_utility", 40 ],
            [ "roof_4x4_survivor", 5 ],
            [ "roof_6x6_utility", 20 ]
          ],
          "x": [ 8, 14 ],
          "y": [ 5, 15 ]
        }
      ]
    }
  },
  {
    "type": "mapgen",
    "method": "json",
    "om_terrain": [ "industrial_center_data_center_roof" ],
    "weight": 250,
    "object": {
      "fill_ter": "t_flat_roof",
      "rows": [
        "                        ",
        "  |22222222222222223    ",
        "  |................3    ",
        "  |................3    ",
        "  |..AA............3    ",
        "  |..AA............3    ",
        "  |................3    ",
        "  |................3    ",
        "  |-------|......3-3    ",
        "          |......3      ",
        "          |......3      ",
        "          |......3      ",
        "          |......3      ",
        "          |......3      ",
        "          |......3      ",
        "     |----|......322    ",
        "     |.............2    ",
        "     |.............2    ",
        "     |.............523  ",
        "     |............####  ",
        "     |............+_>#  ",
        "     |............####  ",
        "|2222|...............3  ",
        "|....................3  "
      ],
      "palettes": [ "roof_palette" ],
      "terrain": { "#": "t_wall", "_": "t_floor", "+": "t_door_locked", ">": "t_ladder_down" },
      "place_nested": [ { "chunks": [ [ "null", 20 ], [ "roof_4x4_utility", 40 ], [ "roof_6x6_utility", 20 ] ], "x": [ 7, 9 ], "y": 17 } ]
    }
  },
  {
    "type": "mapgen",
    "method": "json",
    "om_terrain": [ "industrial_center_admin_roof" ],
    "weight": 250,
    "object": {
      "fill_ter": "t_flat_roof",
      "rows": [
        "|....................3  ",
        "|....................3  ",
        "|....................3  ",
        "|....................3  ",
        "|.................R..3  ",
        "|....................3  ",
        "|....................3  ",
        "|....................3  ",
        "|..A..............U..3  ",
        "|..A.................3  ",
        "|....................3  ",
        "|..............5-----3  ",
        "|..............3        ",
        "|..............3        ",
        "|..............3        ",
        "|..............3        ",
        "|.........3----3        ",
        "|.........3             ",
        "|.........3             ",
        "|.........3             ",
        "|.........3             ",
        "|---------3             ",
        "                        ",
        "                        "
      ],
      "palettes": [ "roof_palette" ],
      "nested": { "U": { "chunks": [ "roof_2x2_infrastructure" ] }, "R": { "chunks": [ "roof_2x2_infrastructure_1" ] } },
      "place_nested": [
        {
          "chunks": [
            [ "null", 20 ],
            [ "roof_2x2_utilities_b", 15 ],
            [ "roof_2x2_utilities_c", 5 ],
            [ "roof_2x2_utilities_d", 40 ],
            [ "roof_2x2_utilities", 50 ]
          ],
          "x": [ 2, 7 ],
          "y": [ 17, 18 ]
        }
      ]
    }
  },
  {
    "type": "mapgen",
    "method": "json",
    "om_terrain": [ "industrial_center_pump_station_basement" ],
    "weight": 250,
    "object": {
      "fill_ter": "t_rock_floor",
      "rows": [
        "          !!!!          ",
        "    ~~~~~~~~~~   c..ll  ",
        "    ~~~~~~~~~~   c....  ",
        "    ~~    ~~~~      ..  ",
        "    ~~    ~~~~~~~~~|__  ",
        "    ~~    ~~~~~~~~~|<_  ",
        "    pppppppppppp~~~|__  ",
        "    p________________   ",
        "    p_        _~~~~     ",
        "    p_        _~~~~     ",
        "    p_        _~~~~     ",
        "    p_        _~~~~     ",
        "    p_        _~~~~     ",
        "    p__________~~~~     ",
        "    p_~~~~~~~~~~~~~     ",
        "                        ",
        "                        ",
        "                        ",
        "                        ",
        "                        ",
        "                        ",
        "                        ",
        "                        ",
        "                        "
      ],
      "palettes": [ "industrial_center_palette" ],
      "terrain": {
        " ": "t_rock",
        "_": "t_bridge",
        "|": "t_railing",
        "!": "t_bars",
        ".": "t_rock_floor",
        "c": "t_rock_floor",
        "l": "t_rock_floor"
      },
      "items": {
        "l": { "item": "sewage_plant", "chance": 50, "repeat": 2 },
        "c": { "item": "plumbing_clothing", "chance": 50, "repeat": 2 }
      },
      "place_monsters": [ { "monster": "GROUP_SEWER", "x": [ 1, 22 ], "y": [ 1, 22 ], "density": 0.1 } ]
    }
  }
]
