[
  {
    "id": "lake_bed",
    "type": "item_group",
    "subtype": "distribution",
    "entries": [ { "group": "fishing_items_trash", "prob": 6 } ]
  },
  {
    "type": "palette",
    "id": "lake_bed_palette",
    "terrain": {
      "~": [
        "t_lake_bed",
        "t_lake_bed",
        "t_lake_moss",
        "t_lake_pondweed",
        "t_lake_liverwort",
        "t_lake_bed",
        "t_lake_trunk",
        "t_lake_bed",
        "t_lake_bed"
      ]
    },
    "furniture": { "f": "f_fog", "h": "f_hot_spring", "r": "f_rubble_rock" },
    "monster": { "Z": { "monster": "mon_zhark" }, "s": { "monster": "mon_zombie_swimmer" } }
  },
  {
    "type": "mapgen",
    "method": "json",
    "om_terrain": [ "lake_surface" ],
    "object": { "fill_ter": "t_water_dp" }
  },
  {
    "type": "mapgen",
    "method": "json",
    "om_terrain": [ "lake_water_cube" ],
    "object": { "fill_ter": "t_water_cube" }
  },
  {
    "type": "mapgen",
    "method": "json",
    "om_terrain": [ "lake_bed" ],
    "object": {
      "fill_ter": "t_lake_bed",
      "rows": [
        "~~~~~~~~~~~~~~~~~~~~~~~~",
        "~~~~~~~~~~~~~~~~~~~~~~~~",
        "~~~~~~~~~~~~~~~~~~~~~~~~",
        "~~~~~~~~~~~~~~~~~~~~~~~~",
        "~~~~~~~~~~~~~~~~~~~~~~~~",
        "~~~~~~~~~~~~~~~~~~~~~~~~",
        "~~~~~~~~~~~~~~~~~~~~~~~~",
        "~~~~~~~~~~~~~~~~~~~~~~~~",
        "~~~~~~~~~~~~~~~~~~~~~~~~",
        "~~~~~~~~~~~~~~~~~~~~~~~~",
        "~~~~~~~~~~~~~~~~~~~~~~~~",
        "~~~~~~~~~~~~~~~~~~~~~~~~",
        "~~~~~~~~~~~~~~~~~~~~~~~~",
        "~~~~~~~~~~~~~~~~~~~~~~~~",
        "~~~~~~~~~~~~~~~~~~~~~~~~",
        "~~~~~~~~~~~~~~~~~~~~~~~~",
        "~~~~~~~~~~~~~~~~~~~~~~~~",
        "~~~~~~~~~~~~~~~~~~~~~~~~",
        "~~~~~~~~~~~~~~~~~~~~~~~~",
        "~~~~~~~~~~~~~~~~~~~~~~~~",
        "~~~~~~~~~~~~~~~~~~~~~~~~",
        "~~~~~~~~~~~~~~~~~~~~~~~~",
        "~~~~~~~~~~~~~~~~~~~~~~~~",
        "~~~~~~~~~~~~~~~~~~~~~~~~"
      ],
      "palettes": [ "lake_bed_palette" ],
      "items": { "~": { "item": "lake_bed", "chance": 2 } },
      "place_furniture": [
        { "furn": "f_boulder_small", "x": [ 3, 21 ], "y": [ 3, 21 ], "repeat": [ 1, 5 ] },
        { "furn": "f_boulder_medium", "x": [ 3, 21 ], "y": [ 3, 21 ], "repeat": [ 1, 5 ] },
        { "furn": "f_boulder_large", "x": [ 3, 21 ], "y": [ 3, 21 ], "repeat": [ 1, 5 ] }
      ]
    }
  },
  {
    "type": "mapgen",
    "method": "json",
    "om_terrain": [ "lake_bed_hot_spring" ],
    "weight": 100,
    "object": {
      "fill_ter": "t_lake_bed",
      "rows": [
        "~~~~~~~~~~~~~~~~~~~~~~~~",
        "~~~~~~~~~~~~~~~~~~~~~~~~",
        "~~~~~~~~~~~~~~~~~~~~~~~~",
        "~~~~~~~~~~~~~~~~~~~~~~~~",
        "~~~~~~~~~~~~~~~~~~~~~~~~",
        "~~~~~~~~~~~~~~~~~~~~~~~~",
        "~~~~~~~~~~~~~~~~~~~~~~~~",
        "~~~~~~~~~~~~~~~~~~~~~~~~",
        "~~~~~~~~~~~~~~~~~~~~~~~~",
        "~~~~~~~~~~~~~~~~~~~~~~~~",
        "~~~~~~~~~~~~~~~~~~~~~~~~",
        "~~~~~~~~~~~~~~~~~~~~~~~~",
        "~~~~~~~~~~~~~~~~~~~~~~~~",
        "~~~~~~~~~~~~~~~~~~~~~~~~",
        "~~~~~~~~~~~~~~~~~~~~~~~~",
        "~~~~~~~~~~~~~~~~~~~~~~~~",
        "~~~~~~~~~~~~~~~~~~~~~~~~",
        "~~~~~~~~~~~~~~~~~~~~~~~~",
        "~~~~~~~~~~~~~~~~~~~~~~~~",
        "~~~~~~~~~~~~~~~~~~~~~~~~",
        "~~~~~~~~~~~~~~~~~~~~~~~~",
        "~~~~~~~~~~~~~~~~~~~~~~~~",
        "~~~~~~~~~~~~~~~~~~~~~~~~",
        "~~~~~~~~~~~~~~~~~~~~~~~~"
      ],
      "palettes": [ "lake_bed_palette" ],
      "place_vehicles": [ { "vehicle": "shopping_cart", "x": [ 3, 21 ], "y": [ 3, 16 ], "chance": 100, "repeat": [ 2, 3 ] } ],
      "items": { "~": { "item": "lake_bed", "chance": 2 } },
      "place_furniture": [
        { "furn": "f_boulder_small", "x": [ 3, 21 ], "y": [ 3, 21 ], "repeat": [ 1, 3 ] },
        { "furn": "f_boulder_medium", "x": [ 3, 21 ], "y": [ 3, 21 ], "repeat": [ 1, 3 ] },
        { "furn": "f_boulder_large", "x": [ 3, 21 ], "y": [ 3, 21 ], "repeat": [ 1, 3 ] },
        { "furn": "f_hot_spring", "x": [ 3, 21 ], "y": [ 3, 21 ], "repeat": [ 3, 8 ] }
      ]
    }
  },
  {
    "type": "mapgen",
    "method": "json",
    "om_terrain": [ "lake_bed_mystery_fog" ],
    "weight": 100,
    "object": {
      "fill_ter": "t_lake_bed",
      "rows": [
        "~~~~~~~~~~~~~~~~~~~~~~~~",
        "~~~~~~~~~~~~~~~~~~~~~~~~",
        "~~~~~~~~~~~~~~~~~~~~~~~~",
        "~~~~~~~~~~~~~~~~~~~~~~~~",
        "~~~~~~~~~~~~~~~~~~~~~~~~",
        "~~~~~~~~~~~~~~~~~~~~~~~~",
        "~~~~~~~~~~~~~~~~~~~~~~~~",
        "~~~~~~~~~~~~~~~~~~~~~~~~",
        "~~~~~~~~~~~~~~~~~~~~~~~~",
        "~~~~~~~~~~~~~~~~~~~~~~~~",
        "~~~~~~~~~~~~~~~~~~~~~~~~",
        "~~~~~~~~~~~~~~~~~~~~~~~~",
        "~~~~~~~~~~~~~~~~~~~~~~~~",
        "~~~~~~~~~~~~~~~~~~~~~~~~",
        "~~~~~~~~~~~~~~~~~~~~~~~~",
        "~~~~~~~~~~~~~~~~~~~~~~~~",
        "~~~~~~~~~~~~~~~~~~~~~~~~",
        "~~~~~~~~~~~~~~~~~~~~~~~~",
        "~~~~~~~~~~~~~~~~~~~~~~~~",
        "~~~~~~~~~~~~~~~~~~~~~~~~",
        "~~~~~~~~~~~~~~~~~~~~~~~~",
        "~~~~~~~~~~~~~~~~~~~~~~~~",
        "~~~~~~~~~~~~~~~~~~~~~~~~",
        "~~~~~~~~~~~~~~~~~~~~~~~~"
      ],
      "palettes": [ "lake_bed_palette" ],
      "items": { "~": { "item": "lake_bed", "chance": 2 } },
      "place_traps": [ 
        { "trap": "tr_portal", "x": 11, "y": 11 },
      { "trap": "tr_portal", "x": 12, "y": 11 },
      { "trap": "tr_portal", "x": 11, "y": 12 },
      { "trap": "tr_portal", "x": 12, "y": 12 }
     ],
      "place_furniture": [
        { "furn": "f_boulder_small", "x": [ 3, 21 ], "y": [ 3, 21 ], "repeat": [ 1, 3 ] },
        { "furn": "f_boulder_medium", "x": [ 3, 21 ], "y": [ 3, 21 ], "repeat": [ 1, 3 ] },
        { "furn": "f_boulder_large", "x": [ 3, 21 ], "y": [ 3, 21 ], "repeat": [ 1, 3 ] }
      ]
    }
  },
  {
    "type": "mapgen",
    "method": "json",
    "om_terrain": [ "lake_bed_safes" ],
    "weight": 100,
    "object": {
      "fill_ter": "t_lake_bed",
      "rows": [
        "~~~~~~~~~~~~~~~~~~~~~~~~",
        "~~~~~~~~~~~~~~~~~~~~~~~~",
        "~~~~~~~~~~~~~~~~~~~~~~~~",
        "~~~~~~~~~~~~~~~~~~~~~~~~",
        "~~~~~~~~~~~~~~~~~~~~~~~~",
        "~~~~~~~~~~~~~~~~~~~~~~~~",
        "~~~~~~~~~~~~~~~~~~~~~~~~",
        "~~~~~~~~~~~~~~~~~~~~~~~~",
        "~~~~~~~~~~~~~~~~~~~~~~~~",
        "~~~~~~~~~~~~~~~~~~~~~~~~",
        "~~~~~~~~~~~~~~~~~~~~~~~~",
        "~~~~~~~~~~~~$~~~~~~~~~~~",
        "~~~~~~~~~~~~~~~~~~~~~~~~",
        "~~~~~~~~~~~~~~~~~~~~~~~~",
        "~~~~~~~~~~~~~~~~~~~~~~~~",
        "~~~~~~~~~~~~~~~~~~~~~~~~",
        "~~~~~~~~~~~~~~~~~~~~~~~~",
        "~~~~~~~~~~~~~~~~~~~~~~~~",
        "~~~~~~~~~~~~~~~~~~~~~~~~",
        "~~~~~~~~~~~~~~~~~~~~~~~~",
        "~~~~~~~~~~~~~~~~~~~~~~~~",
        "~~~~~~~~~~~~~~~~~~~~~~~~",
        "~~~~~~~~~~~~~~~~~~~~~~~~",
        "~~~~~~~~~~~~~~~~~~~~~~~~"
      ],
      "palettes": [ "lake_bed_palette" ],
      "furniture": { "$": "f_safe_l" },
      "items": { "~": { "item": "lake_bed", "chance": 2 } },
      "place_items": [ { "chance": 100, "item": "mansion_safe", "x": [ 12, 12 ], "y": [ 11, 11 ] } ],
      "place_furniture": [
        { "furn": "f_boulder_small", "x": [ 3, 21 ], "y": [ 3, 21 ], "repeat": [ 1, 3 ] },
        { "furn": "f_boulder_medium", "x": [ 3, 21 ], "y": [ 3, 21 ], "repeat": [ 1, 3 ] },
        { "furn": "f_boulder_large", "x": [ 3, 21 ], "y": [ 3, 21 ], "repeat": [ 1, 3 ] }
      ]
    }
  },
  {
    "type": "mapgen",
    "method": "json",
    "om_terrain": [ "lake_bed_toxic_dump" ],
    "weight": 100,
    "object": {
      "fill_ter": "t_lake_bed",
      "rows": [
        "~~~~~~~~~~~~~~~~~~~~~~~~",
        "~~~~~~~~~~~~~~~~~~~~~~~~",
        "~~~~~~~~~~~~~~~~~~~~~~~~",
        "~~~~~~~~~~~~~~~~~~~~~~~~",
        "~~~~~~~~~~~~~~~~~~~~~~~~",
        "~~~~~~~~~~~~~~~~~~W~~~~~",
        "~~~~~W~~~~~~~~~~~~~~~~~~",
        "~~~~~~~~~~~~~~~~~~~~~~~~",
        "~~~~~~~~~~~~~~~W~~~~~~~~",
        "~~~~~~~~~~~WW~~~~~~~~~~~",
        "~~~~~~W~~~WWWW~~~~~~~~~~",
        "~~~~~~~~~WWZWWW~~~~~~~~~",
        "~~~~~~~~~~WWWW~~~~~~~~~~",
        "~~~~~~~~~~~WW~~~W~~~~~~~",
        "~~~~~~~~W~~~~~~~~~~~~~~~",
        "~~~~~~~~~~~~~~~~~~~~~~~~",
        "~~~~~~~~~~~~~~~~~~~~~~~~",
        "~~~W~~~~~~~~~~~~~~W~~~~~",
        "~~~~~~~~~~~~~~~~~~~~~~~~",
        "~~~~~~~~~~~~~~~~~~~~~~~~",
        "~~~~~~~~~~~~~~~~~~~~~~~~",
        "~~~~~~~~~~~~~~~~~~~~~~~~",
        "~~~~~~~~~~~~~~~~~~~~~~~~",
        "~~~~~~~~~~~~~~~~~~~~~~~~"
      ],
      "palettes": [ "lake_bed_palette" ],
      "set": [ { "square": "radiation", "amount": [ 20, 60 ], "x": 3, "y": 3, "x2": 21, "y2": 16 } ],
      "items": { "~": { "item": "lake_bed", "chance": 2 }, "W": { "item": "toxic_waste", "chance": 20 } },
      "place_furniture": [ { "furn": "f_rubble_rock", "x": [ 3, 21 ], "y": [ 3, 21 ], "repeat": [ 3, 8 ] } ]
    }
  },
  {
    "type": "overmap_terrain",
    "id": [ "lake_bed_mystery_fog" ],
    "name": "mysterious fog",
    "sym": "?",
    "color": "white",
    "see_cost": 1
  },
  {
    "type": "overmap_terrain",
    "id": [ "lake_bed_hot_spring" ],
    "name": "hot spring",
    "sym": "h",
    "color": "red",
    "see_cost": 1
  },
  {
    "type": "overmap_terrain",
    "id": [ "lake_bed_toxic_dump" ],
    "name": "underwater toxic waste dump",
    "sym": "D",
    "color": "green",
    "see_cost": 1
  },
  {
    "type": "overmap_terrain",
    "id": [ "lake_bed_safes" ],
    "name": "dumped mansion safe",
    "sym": "S",
    "color": "blue",
    "see_cost": 1
  }
]
