[
  {
    "type": "mapgen",
    "method": "json",
    "om_terrain": [ [ "cargo_ship_a", "cargo_ship_b", "cargo_ship_c" ] ],
    "weight": 100,
    "object": {
      "fill_ter": "t_bulkhead_floor_underwater",
      "rows": [
        "~~~~~~~~~~~~~~~~~~~~~~~~~~~~~~~~~~~~~~~~~~~~~~~~~~~~~~~~~~~~~~~~~~~~~~~~",
        "~~~~~~~~~~~~~~~~~~~~~~~~~~~~~~~~~~~~~~~~~~~~~~~~~~~~~~~~~~~~~~~~~~~~~~~~",
        "~~~~~~~~~~~~~~~~~~~~~~~~~~~~~~~~~~~~~~~~~~~~~~~~~~~~~~~~~~~~~~~~~~~~~~~~",
        "~~~~~~aaaaaaaaaaaaaaaaaaaaaaaaaaaaaaaaaaaaaaaaaaaaaaaaaaa||||o|||||o||~~",
        "~~~~aaa                                                  oiiiiiDFiiid||~",
        "~~aaa   ||||||||  ||||||||  ||||||||  ||||||||  |||||||| +iiiiiiiiiiii||",
        "aaa     |...m..j  |g...g.k  |...g..k  |m.mm..j  |m.....j |iiiiiiiiiiiiio",
        "a       |mm....j  |ggg...k  |gg...gk  |m....mj  |m.m.m.j ||||+||||||+|||",
        "a       ||||||||  ||||||||  ||||||||  ||||||||  |||||||| |iiiiiii|@@i@@|",
        "a                                                        oiQiiiQi|iiiii|",
        "a       ||||||||  ||||||||  ||||||||  ||||||||  |||||||| |iQiiiQi|@@i@@o",
        "a       |gg.g..k  |g..gggj  |gg....k  |g....gk  |..g...j |iQiiiii|iiiii|",
        "a       |g....gk  |g.....j  |g..gg.k  |g.gg..k  |g....gj |iQii||||@@i@@|",
        "a       ||||||||  ||||||||  ||||||||  ||||||||  |||||||| |iQii|St|iiiiio",
        "a                                                        oiQii|ii|@@i@@|",
        "a       ||||||||  ||||||||  ||||||||  ||||||||  |||||||| |iiii|Ui|iiiii|",
        "a       |..mm.mj  |...g..k  |......j  |g...ggj  |gg..g.k ||||+||+|||+|||",
        "aaa     |m.....j  |.g...gk  |mm.m.mj  |g.g...j  |......k |iiiiiiiiiiiiio",
        "~~aaa   ||||||||  ||||||||  ||||||||  ||||||||  |||||||| +iiiiiiiiiiii||",
        "~~~~aaa                                                  oiiiiiDFiiid||~",
        "~~~~~~aaaaaaaaaaaaaaaaaaaaaaaaaaaaaaaaaaaaaaaaaaaaaaaaaaa||||o|||||o||~~",
        "~~~~~~~~~~~~~~~~~~~~~~~~~~~~~~~~~~~~~~~~~~~~~~~~~~~~~~~~~~~~~~~~~~~~~~~~",
        "~~~~~~~~~~~~~~~~~~~~~~~~~~~~~~~~~~~~~~~~~~~~~~~~~~~~~~~~~~~~~~~~~~~~~~~~",
        "~~~~~~~~~~~~~~~~~~~~~~~~~~~~~~~~~~~~~~~~~~~~~~~~~~~~~~~~~~~~~~~~~~~~~~~~"
      ],
      "place_monster": [
        { "group": "GROUP_UNDERWATER_PEST", "x": 2, "y": 14, "repeat": [ 2, 5 ] },
        { "group": "GROUP_UNDERWATER_PEST", "x": 66, "y": 12, "repeat": [ 2, 5 ] }
      ],
      "palettes": [ "lake_bed_palette" ],
      "vendingmachines": { "D": { "item_group": "vending_drink" }, "F": { "item_group": "vending_food" } },
      "toilets": { "t": {  } },
      "gaspumps": { "!": {  } },
      "items": {
        "Q": { "item": "cannedfood", "chance": 100 },
        "S": { "item": "SUS_bathroom_cabinet", "chance": 100 },
        "g": { "item": "crate_stack", "chance": 100 },
        "m": { "item": "crate_ship_cargo", "chance": 100 }
      },
      "furniture": {
        "C": "f_workbench",
        "c": "f_cupboard",
        "1": "f_control_station",
        "A": "f_air_compressor",
        "f": "f_tourist_table",
        "&": "f_cleat",
        "@": "f_bed",
        "B": "f_sample_freezer",
        "E": "f_shaker",
        "G": "f_stool",
        "H": "f_counter",
        "I": "f_IV_pole",
        "J": "f_curtain",
        "K": "f_fridge",
        "Q": "f_rack",
        "S": "f_sink",
        "U": "f_shower",
        "W": "f_water_purifier",
        "b": "f_bench",
        "h": "f_camp_chair",
        "l": "f_foot_locker",
        "g": "f_crate_c",
        "m": "f_crate_c"
      },
      "terrain": {
        "~": "t_lake_bed",
        " ": "t_bulkhead_floor_underwater_no_roof",
        "`": "t_bulkhead_roof",
        "+": "t_door_metal_bulkhead_c_underwater",
        "#": "t_metal_pontoon_dp",
        "2": "t_machinery_electronic",
        "*": "t_water_pool",
        "-": "t_water_cube",
        ".": "t_metal_floor_underwater",
        "j": "t_door_metal_locked_underwater",
        "k": "t_door_metal_locked_o_underwater",
        "<": "t_ladder_up",
        "|": "t_wall_bulkhead_underwater",
        ">": "t_ladder_down",
        "A": "t_metal_floor_underwater",
        "P": "t_concrete_dock_deep_pile",
        "^": "t_lake_bed_concrete",
        "o": "t_porthole",
        "y": "t_lake_bed_concrete_yellow",
        "@": "t_bulkhead_floor_underwater",
        "a": "t_metal_railing_underwater",
        "M": "t_card_military",
        "d": "t_stairs_up_underwater",
        "e": "t_stairs_down_underwater",
        "g": "t_metal_floor_underwater",
        "i": "t_bulkhead_floor_underwater"
      }
    }
  },
  {
    "type": "mapgen",
    "method": "json",
    "om_terrain": [ [ "cargo_ship_1_a", "cargo_ship_1_b", "cargo_ship_1_c" ] ],
    "weight": 100,
    "object": {
      "fill_ter": "t_bulkhead_floor_underwater",
      "rows": [
        "~~~~~~~~~~~~~~~~~~~~~~~~~~~~~~~~~~~~~~~~~~~~~~~~~~~~~~~~~~~~~~~~~~~~~~~~",
        "~~~~~~~~~~~~~~~~~~~~~~~~~~~~~~~~~~~~~~~~~~~~~~~~~~~~~~~~~~~~~~~~~~~~~~~~",
        "~~~~~~~~~~~~~~~~~~~~~~~~~~~~~~~~~~~~~~~~~~~~~~~~~~~~~~~~~~~~~~~~~~~~~~~~",
        "~~~~~~~~~~~~~~~~~~~~~~~~~~~~~~~~~~~~~~~~~~~~~~~~~~~~~~~~~||||o|||||o||~~",
        "~~~~~~~~~~~~~~~~~~~~~~~~~~~~~~~~~~~~~~~~~~~~~~~~~~~~~~~~~| 22 22    e||~",
        "~~~~~~~~||||||||~~||||||||~~||||||||~~||||||||~~||||||||~o            ||",
        "~~~~~~~~|g..g..k~~|mm.m..i~~|m.m...i~~|.....gk~~|m.mm..i~|             o",
        "~~~~~~~~|gg...gk~~|m....mi~~|m...mmi~~|g.gg..k~~|m....mi~||||+||      W|",
        "~~~~~~~~||||||||~~||||||||~~||||||||~~||||||||~~||||||||~|     |      2|",
        "~~~~~~~~~~~~~~~~~~~~~~~~~~~~~~~~~~~~~~~~~~~~~~~~~~~~~~~~~o     |2     E|",
        "~~~~~~~~||||||||~~||||||||~~||||||||~~||||||||~~||||||||~o CC  |       o",
        "~~~~~~~~|m....mi~~|..gg..k~~|gg...gi~~|...g..k~~|g..g..i~o CG  |W      |",
        "~~~~~~~~|m.mm..i~~|g....gk~~|g..g..i~~|.g...gk~~|gg...gi~o CG  |A      |",
        "~~~~~~~~||||||||~~||||||||~~||||||||~~||||||||~~||||||||~o CC  |       o",
        "~~~~~~~~~~~~~~~~~~~~~~~~~~~~~~~~~~~~~~~~~~~~~~~~~~~~~~~~~o     |2     2|",
        "~~~~~~~~||||||||~~||||||||~~||||||||~~||||||||~~||||||||~|     |      A|",
        "~~~~~~~~|gg...gk~~|..m...i~~|g...g.i~~|mmm...i~~|gg...gk~||||+||      2|",
        "~~~~~~~~|g..g..k~~|m...mmi~~|ggg...i~~|....mmi~~|g..g..k~|             o",
        "~~~~~~~~||||||||~~||||||||~~||||||||~~||||||||~~||||||||~o            ||",
        "~~~~~~~~~~~~~~~~~~~~~~~~~~~~~~~~~~~~~~~~~~~~~~~~~~~~~~~~~| 22 22    e||~",
        "~~~~~~~~~~~~~~~~~~~~~~~~~~~~~~~~~~~~~~~~~~~~~~~~~~~~~~~~~||||o|||||o||~~",
        "~~~~~~~~~~~~~~~~~~~~~~~~~~~~~~~~~~~~~~~~~~~~~~~~~~~~~~~~~~~~~~~~~~~~~~~~",
        "~~~~~~~~~~~~~~~~~~~~~~~~~~~~~~~~~~~~~~~~~~~~~~~~~~~~~~~~~~~~~~~~~~~~~~~~",
        "~~~~~~~~~~~~~~~~~~~~~~~~~~~~~~~~~~~~~~~~~~~~~~~~~~~~~~~~~~~~~~~~~~~~~~~~"
      ],
      "place_monster": [ { "group": "GROUP_UNDERWATER_PEST", "x": 66, "y": 12, "repeat": [ 2, 5 ] } ],
      "vendingmachines": { "D": { "item_group": "vending_drink" }, "F": { "item_group": "vending_food" } },
      "toilets": { "t": {  } },
      "gaspumps": { "!": {  } },
      "items": {
        "Q": { "item": "cannedfood", "chance": 100 },
        "S": { "item": "SUS_bathroom_cabinet", "chance": 100 },
        "g": { "item": "crate_stack", "chance": 100 },
        "m": { "item": "crate_ship_cargo", "chance": 80 }
      },
      "furniture": {
        "C": "f_workbench",
        "c": "f_cupboard",
        "1": "f_control_station",
        "A": "f_air_compressor",
        "f": "f_tourist_table",
        "&": "f_cleat",
        "@": "f_bed",
        "B": "f_sample_freezer",
        "E": "f_shaker",
        "G": "f_stool",
        "H": "f_counter",
        "I": "f_IV_pole",
        "J": "f_curtain",
        "K": "f_fridge",
        "Q": "f_rack",
        "S": "f_sink",
        "U": "f_shower",
        "W": "f_water_purifier",
        "b": "f_bench",
        "h": "f_camp_chair",
        "l": "f_foot_locker",
        "g": "f_crate_c",
        "m": "f_crate_c"
      },
      "terrain": {
        " ": "t_bulkhead_floor_underwater",
        "`": "t_bulkhead_roof",
        ";": "t_lake_bed",
        "+": "t_door_metal_bulkhead_c_underwater",
        "#": "t_metal_pontoon_dp",
        "2": "t_machinery_electronic",
        "*": "t_water_pool",
        "-": "t_water_cube",
        ".": "t_metal_floor_underwater",
        "<": "t_ladder_up",
        "|": "t_wall_bulkhead_underwater",
        ">": "t_ladder_down",
        "~": "t_water_cube",
        "A": "t_metal_floor_underwater",
        "P": "t_concrete_dock_deep_pile",
        "^": "t_lake_bed_concrete",
        "o": "t_porthole",
        "y": "t_lake_bed_concrete_yellow",
        "a": "t_metal_railing_underwater",
        "d": "t_stairs_up_underwater",
        "e": "t_stairs_down_underwater",
        "i": "t_door_metal_locked_underwater",
        "k": "t_door_metal_locked_o_underwater"
      }
    }
  },
  {
    "type": "mapgen",
    "method": "json",
    "om_terrain": [ [ "cargo_ship_2_a", "cargo_ship_2_b", "cargo_ship_2_c" ] ],
    "weight": 100,
    "object": {
      "fill_ter": "t_water_cube",
      "rows": [
        "~~~~~~~~~~~~~~~~~~~~~~~~~~~~~~~~~~~~~~~~~~~~~~~~~~~~~~~~~~~~~~~~~~~~~~~~",
        "~~~~~~~~~~~~~~~~~~~~~~~~~~~~~~~~~~~~~~~~~~~~~~~~~~~~~~~~~~~~~~~~~~~~~~~~",
        "~~~~~~~~~~~~~~~~~~~~~~~~~~~~~~~~~~~~~~~~~~~~~~~~~~~~~~~~~~~~~~~~~~~~~~~~",
        "~~~~~~~~~~~~~~~~~~~~~~~~~~~~~~~~~~~~~~~~~~~~~~~~~~~~~~~~~`````````````~~",
        "~~~~~~~~~~~~~~~~~~~~~~~~~~~~~~~~~~~~~~~~~~~~~~~~~~~~~~~~~``````````````~",
        "~~~~~~~~````````~~````````~~````````~~````````~~````````~```````````````",
        "~~~~~~~~````````~~````````~~````````~~````````~~````````~```````````````",
        "~~~~~~~~````````~~````````~~````````~~````````~~````````~```````````````",
        "~~~~~~~~````````~~````````~~````````~~````````~~````````~```````````````",
        "~~~~~~~~~~~~~~~~~~~~~~~~~~~~~~~~~~~~~~~~~~~~~~~~~~~~~~~~~```````````````",
        "~~~~~~~~````````~~````````~~````````~~````````~~````````~```````````````",
        "~~~~~~~~````````~~````````~~````````~~````````~~````````~```````````````",
        "~~~~~~~~````````~~````````~~````````~~````````~~````````~```````````````",
        "~~~~~~~~````````~~````````~~````````~~````````~~````````~```````````````",
        "~~~~~~~~~~~~~~~~~~~~~~~~~~~~~~~~~~~~~~~~~~~~~~~~~~~~~~~~~```````````````",
        "~~~~~~~~````````~~````````~~````````~~````````~~````````~```````````````",
        "~~~~~~~~````````~~````````~~````````~~````````~~````````~```````````````",
        "~~~~~~~~````````~~````````~~````````~~````````~~````````~```````````````",
        "~~~~~~~~````````~~````````~~````````~~````````~~````````~```````````````",
        "~~~~~~~~~~~~~~~~~~~~~~~~~~~~~~~~~~~~~~~~~~~~~~~~~~~~~~~~~``````````````~",
        "~~~~~~~~~~~~~~~~~~~~~~~~~~~~~~~~~~~~~~~~~~~~~~~~~~~~~~~~~`````````````~~",
        "~~~~~~~~~~~~~~~~~~~~~~~~~~~~~~~~~~~~~~~~~~~~~~~~~~~~~~~~~~~~~~~~~~~~~~~~",
        "~~~~~~~~~~~~~~~~~~~~~~~~~~~~~~~~~~~~~~~~~~~~~~~~~~~~~~~~~~~~~~~~~~~~~~~~",
        "~~~~~~~~~~~~~~~~~~~~~~~~~~~~~~~~~~~~~~~~~~~~~~~~~~~~~~~~~~~~~~~~~~~~~~~~"
      ],
      "vendingmachines": { "D": { "item_group": "vending_drink" }, "F": { "item_group": "vending_food" } },
      "toilets": { "t": {  } },
      "gaspumps": { "!": {  } },
      "furniture": {
        "C": "f_workbench",
        "c": "f_cupboard",
        "1": "f_control_station",
        "A": "f_air_compressor",
        "f": "f_tourist_table",
        "&": "f_cleat",
        "@": "f_bed",
        "B": "f_sample_freezer",
        "E": "f_shaker",
        "G": "f_stool",
        "H": "f_counter",
        "I": "f_IV_pole",
        "J": "f_curtain",
        "K": "f_fridge",
        "Q": "f_rack",
        "S": "f_sink",
        "U": "f_shower",
        "W": "f_water_purifier",
        "b": "f_bench",
        "h": "f_camp_chair",
        "l": "f_foot_locker"
      },
      "terrain": {
        " ": "t_bulkhead_floor_underwater",
        "`": "t_bulkhead_roof",
        ";": "t_lake_bed",
        "+": "t_door_metal_bulkhead_c",
        "#": "t_metal_pontoon_dp",
        "2": "t_machinery_electronic",
        "*": "t_water_pool",
        "-": "t_water_cube",
        ".": "t_metal_floor_underwater",
        "<": "t_ladder_up",
        "|": "t_wall_bulkhead_underwater",
        ">": "t_ladder_down",
        "~": "t_water_cube",
        "A": "t_metal_floor_underwater",
        "P": "t_concrete_dock_deep_pile",
        "^": "t_lake_bed_concrete",
        "o": "t_porthole",
        "y": "t_lake_bed_concrete_yellow",
        "a": "t_metal_railing_underwater",
        "d": "t_stairs_up_underwater",
        "e": "t_stairs_down_underwater"
      }
    }
  }
]
