[
  {
    "type": "palette",
    "id": "lake_bed_palette",
    "terrain": { "~": [ [ "t_lake_bed", 75 ], [ "t_lake_moss", 20 ], [ "t_lake_trunk", 5 ] ] },
    "furniture": {
      "f": "f_fog",
      "h": "f_hot_spring",
      "r": "f_rubble_rock",
      "w": "f_wreckage",
      "~": [
        [ "f_null", 75 ],
        [ "f_lake_liverwort", 5 ],
        [ "f_lake_hornwort", 5 ],
        [ "f_lake_eelgrass", 5 ],
        [ "f_lake_detritus", 5 ],
        [ "f_lake_pondweed", 5 ],
        [ "f_rubble_rock", 2 ],
        [ "f_boulder_small", 1 ],
        [ "f_boulder_medium", 1 ],
        [ "f_boulder_large", 1 ]
      ]
    }
  },
  {
    "type": "mapgen",
    "method": "json",
    "om_terrain": [ "lake_surface" ],
    "object": { "fill_ter": "t_water_dp" }
  },
  {
    "type": "mapgen",
    "method": "json",
    "om_terrain": [ "lake_water_cube" ],
    "object": { "fill_ter": "t_water_cube" }
  },
  {
    "type": "mapgen",
    "method": "json",
    "om_terrain": [ "lake_bed" ],
    "object": {
      "fill_ter": "t_lake_bed",
      "rows": [
        "~~~~~~~~~~~~~~~~~~~~~~~~",
        "~~~~~~~~~~~~~~~~~~~~~~~~",
        "~~~~~~~~~~~~~~~~~~~~~~~~",
        "~~~~~~~~~~~~~~~~~~~~~~~~",
        "~~~~~~~~~~~~~~~~~~~~~~~~",
        "~~~~~~~~~~~~~~~~~~~~~~~~",
        "~~~~~~~~~~~~~~~~~~~~~~~~",
        "~~~~~~~~~~~~~~~~~~~~~~~~",
        "~~~~~~~~~~~~~~~~~~~~~~~~",
        "~~~~~~~~~~~~~~~~~~~~~~~~",
        "~~~~~~~~~~~~~~~~~~~~~~~~",
        "~~~~~~~~~~~~~~~~~~~~~~~~",
        "~~~~~~~~~~~~~~~~~~~~~~~~",
        "~~~~~~~~~~~~~~~~~~~~~~~~",
        "~~~~~~~~~~~~~~~~~~~~~~~~",
        "~~~~~~~~~~~~~~~~~~~~~~~~",
        "~~~~~~~~~~~~~~~~~~~~~~~~",
        "~~~~~~~~~~~~~~~~~~~~~~~~",
        "~~~~~~~~~~~~~~~~~~~~~~~~",
        "~~~~~~~~~~~~~~~~~~~~~~~~",
        "~~~~~~~~~~~~~~~~~~~~~~~~",
        "~~~~~~~~~~~~~~~~~~~~~~~~",
        "~~~~~~~~~~~~~~~~~~~~~~~~",
        "~~~~~~~~~~~~~~~~~~~~~~~~"
      ],
      "palettes": [ "lake_bed_palette" ],
      "items": { "~": { "item": "lake_bed", "chance": 1 } }
    }
  },
  {
    "type": "mapgen",
    "method": "json",
    "om_terrain": [ "lake_bed_hot_spring" ],
    "weight": 100,
    "object": {
      "fill_ter": "t_lake_bed",
      "rows": [
        "~~~~~~~~~~~~~~~~~~~~~~~~",
        "~~~~~~~~~~~~~~~~~~~~~~~~",
        "~~~~~~~~~~~~~~~~~~~~~~~~",
        "~~~~~~~~~~~~~~~~~~~~~~~~",
        "~~~~~~~~~~~~~~~~~~~~~~~~",
        "~~~~~~~~~~~~~~~~~~~~~~~~",
        "~~~~~~~~~~~~~~~~~~~~~~~~",
        "~~~~~~~~~~~~~~~~~~~~~~~~",
        "~~~~~~~~~~~~~~~~~~~~~~~~",
        "~~~~~~~~~~~~~~~~~~~~~~~~",
        "~~~~~~~~~~~~~~~~~~~~~~~~",
        "~~~~~~~~~~~~~~~~~~~~~~~~",
        "~~~~~~~~~~~~~~~~~~~~~~~~",
        "~~~~~~~~~~~~~~~~~~~~~~~~",
        "~~~~~~~~~~~~~~~~~~~~~~~~",
        "~~~~~~~~~~~~~~~~~~~~~~~~",
        "~~~~~~~~~~~~~~~~~~~~~~~~",
        "~~~~~~~~~~~~~~~~~~~~~~~~",
        "~~~~~~~~~~~~~~~~~~~~~~~~",
        "~~~~~~~~~~~~~~~~~~~~~~~~",
        "~~~~~~~~~~~~~~~~~~~~~~~~",
        "~~~~~~~~~~~~~~~~~~~~~~~~",
        "~~~~~~~~~~~~~~~~~~~~~~~~",
        "~~~~~~~~~~~~~~~~~~~~~~~~"
      ],
      "palettes": [ "lake_bed_palette" ],
      "items": { "~": { "item": "lake_bed", "chance": 1 } },
      "place_monster": [ { "group": "GROUP_UNDERWATER_PEST", "x": [ 1, 23 ], "y": [ 1, 23 ] } ],
      "place_furniture": [ { "furn": "f_hot_spring", "x": [ 3, 21 ], "y": [ 3, 21 ], "repeat": [ 3, 8 ] } ]
    }
  },
  {
    "type": "mapgen",
    "method": "json",
    "om_terrain": [ "lake_bed_safes" ],
    "weight": 100,
    "object": {
      "fill_ter": "t_lake_bed",
      "rows": [
        "~~~~~~~~~~~~~~~~~~~~~~~~",
        "~~~~~~~~~~~~~~~~~~~~~~~~",
        "~~~~~~~~~~~~~~~~~~~~~~~~",
        "~~~~~~~~~~~~~~~~~~~~~~~~",
        "~~~~~~~~~~~~~~~~~~~~~~~~",
        "~~~~~~~~~~~~~~~~~~~~~~~~",
        "~~~~~~~~~~~~~~~~~~~~~~~~",
        "~~~~~~~~~~~~~~~~~~~~~~~~",
        "~~~~~~~~~~~~~~~~~~~~~~~~",
        "~~~~~~~~~$~~~~~~~~~~~~~~",
        "~~~~~~~~~~~~~~~~~~~~~~~~",
        "~~~~~~~~~~~~~~~~~~~~~~~~",
        "~~~~~~~~~~~~~~~~~~~~~~~~",
        "~~~~~~~~~~~~~~~$~~~~~~~~",
        "~~~~~~~~~~~~~~~~~~~~~~~~",
        "~~~~~~~~~~~~~~~~~~~~~~~~",
        "~~~~~~~~~~~~~~~~~~~~~~~~",
        "~~~~~~~~~~~~~~~~~~~~~~~~",
        "~~~~~~~~~~~~~~~~~~~~~~~~",
        "~~~~~~~~~~~~~~~~~~~~~~~~",
        "~~~~~~~~~~~~~~~~~~~~~~~~",
        "~~~~~~~~~~~~~~~~~~~~~~~~",
        "~~~~~~~~~~~~~~~~~~~~~~~~",
        "~~~~~~~~~~~~~~~~~~~~~~~~"
      ],
      "palettes": [ "lake_bed_palette" ],
      "furniture": { "$": "f_safe_l" },
      "items": { "~": { "item": "lake_bed", "chance": 3 } },
      "place_items": [ { "chance": 75, "item": "vault", "x": 9, "y": 9 }, { "chance": 75, "item": "vault", "x": 15, "y": 13 } ],
      "place_furniture": [
        { "furn": "f_wreckage", "x": [ 3, 21 ], "y": [ 3, 8 ], "repeat": [ 0, 1 ] },
        { "furn": "f_wreckage", "x": [ 3, 21 ], "y": [ 16, 21 ], "repeat": [ 0, 1 ] },
        { "furn": "f_wreckage", "x": [ 3, 8 ], "y": [ 3, 21 ], "repeat": [ 0, 1 ] },
        { "furn": "f_wreckage", "x": [ 16, 21 ], "y": [ 3, 21 ], "repeat": [ 0, 1 ] }
      ]
    }
  },
  {
    "type": "mapgen",
    "method": "json",
    "om_terrain": [ "lake_bed_lab_entrance_roof" ],
    "weight": 100,
    "object": {
      "fill_ter": "t_water_cube",
      "rows": [
        "~~~~~~~~~~~~~~~~~~~~~~~~",
        "~~~~~~~~~~~~~~~~~~~~~~~~",
        "~~~~~~~~~~~~~~~~~~~~~~~~",
        "~~~~~~~~~~~~~~~~~~~~~~~~",
        "~~~~~~~~~~~~~~~~~~~~~~~~",
        "~~~~~~~~~~~~~~~~~~~~~~~~",
        "~~~~~~~~~~~~~~~~~~~~~~~~",
        "~~~~~~~~~~~WWW~~~~~~~~~~",
        "~~~~~~~~~~~WWW~~~~~~~~~~",
        "~~~~~~~~~~WWWWW~~~~~~~~~",
        "~~~~~~~~WWWWWWWWW~~~~~~~",
        "~~~~~~~~WWWWWWWWW~~~~~~~",
        "~~~~~~~~WWWWWWWWW~~~~~~~",
        "~~~~~~~~~~WWWWW~~~~~~~~~",
        "~~~~~~~~~~~WWW~~~~~~~~~~",
        "~~~~~~~~~~~WWW~~~~~~~~~~",
        "~~~~~~~~~~~~~~~~~~~~~~~~",
        "~~~~~~~~~~~~~~~~~~~~~~~~",
        "~~~~~~~~~~~~~~~~~~~~~~~~",
        "~~~~~~~~~~~~~~~~~~~~~~~~",
        "~~~~~~~~~~~~~~~~~~~~~~~~",
        "~~~~~~~~~~~~~~~~~~~~~~~~",
        "~~~~~~~~~~~~~~~~~~~~~~~~",
        "~~~~~~~~~~~~~~~~~~~~~~~~"
      ],
      "terrain": { "W": "t_bulkhead_roof", "~": "t_water_cube" }
    }
  },
  {
    "type": "mapgen",
    "method": "json",
    "om_terrain": [ "lake_bed_lab_entrance" ],
    "weight": 100,
    "//": "D and S should eventually be replaced with card reader door/keypad",
    "object": {
      "fill_ter": "t_lake_bed",
      "rows": [
        "~~~~~~~~~~~~~~~~~~~~~~~~",
        "~~~~~~~~~~~~~~~~~~~~~~~~",
        "~~~~~~~~~~~~~~~~~~~~~~~~",
        "~~~~~~~~~~~~~~~~~~~~~~~~",
        "~~~~~~~~~~~~~~~~~~~~~~~~",
        "~~~~~~~~~~~~~~~~~~~~~~~~",
        "~~~~~~~~~~~~~~~~~~~~~~~~",
        "~~~~~~~~~~~SDW~~~~~~~~~~",
        "~~~~~~~~~~~W.W~~~~~~~~~~",
        "~~~~~~~~~~WWdWW~~~~~~~~~",
        "~~~~~~~~WWW...WWS~~~~~~~",
        "~~~~~~~~D.d.M.d.D~~~~~~~",
        "~~~~~~~~SWW...WWW~~~~~~~",
        "~~~~~~~~~~WWdWW~~~~~~~~~",
        "~~~~~~~~~~~W.W~~~~~~~~~~",
        "~~~~~~~~~~~WDS~~~~~~~~~~",
        "~~~~~~~~~~~~~~~~~~~~~~~~",
        "~~~~~~~~~~~~~~~~~~~~~~~~",
        "~~~~~~~~~~~~~~~~~~~~~~~~",
        "~~~~~~~~~~~~~~~~~~~~~~~~",
        "~~~~~~~~~~~~~~~~~~~~~~~~",
        "~~~~~~~~~~~~~~~~~~~~~~~~",
        "~~~~~~~~~~~~~~~~~~~~~~~~",
        "~~~~~~~~~~~~~~~~~~~~~~~~"
      ],
      "palettes": [ "lake_bed_palette" ],
      "items": { "~": { "item": "lake_bed", "chance": 1 } },
      "terrain": {
        "M": "t_manhole_cover",
        "W": "t_wall_bulkhead",
        ".": "t_bulkhead_floor",
        "d": "t_door_metal_bulkhead_c",
        "D": "t_door_metal_bulkhead_c",
        "S": "t_wall_bulkhead"
      }
    }
  },
  {
    "type": "mapgen",
    "method": "json",
    "om_terrain": [ "lake_bed_lab_entrance_airlock" ],
    "weight": 100,
    "object": {
      "fill_ter": "t_lake_bed",
      "rows": [
        "~~~~~~~~~~~~~~~~~~~~~~~~",
        "~~~~~~~~~~~~~~~~~~~~~~~~",
        "~~~~~~~~~~~~~~~~~~~~~~~~",
        "~~~~~~~~~~~~~~~~~~~~~~~~",
        "~~~~~~~~~~~~~~~~~~~~~~~~",
        "~~~~~~~~~~~~~~~~~~~~~~~~",
        "~~~~~~~~~~~~~~~~~~~~~~~~",
        "~~~~~~~~~~~~~~~~~~~~~~~~",
        "~~~~~~~~~~~~~~~~~~~~~~~~",
        "~~~~~~~~~~WWdWW~~~~~~~~~",
        "~~~~~~~~~~W...W~~~~~~~~~",
        "~~~~~~~~~~d.l.d~~~~~~~~~",
        "~~~~~~~~~~W...W~~~~~~~~~",
        "~~~~~~~~~~WWdWW~~~~~~~~~",
        "~~~~~~~~~~~~~~~~~~~~~~~~",
        "~~~~~~~~~~~~~~~~~~~~~~~~",
        "~~~~~~~~~~~~~~~~~~~~~~~~",
        "~~~~~~~~~~~~~~~~~~~~~~~~",
        "~~~~~~~~~~~~~~~~~~~~~~~~",
        "~~~~~~~~~~~~~~~~~~~~~~~~",
        "~~~~~~~~~~~~~~~~~~~~~~~~",
        "~~~~~~~~~~~~~~~~~~~~~~~~",
        "~~~~~~~~~~~~~~~~~~~~~~~~",
        "~~~~~~~~~~~~~~~~~~~~~~~~"
      ],
      "terrain": {
        "W": "t_concrete_wall",
        "~": "t_thconc_floor",
        ".": "t_thconc_floor",
        "d": "t_door_metal_bulkhead_c",
        "l": "t_ladder_up"
      }
    }
  },
  {
    "type": "mapgen",
    "method": "json",
    "om_terrain": [ "lake_bed_toxic_dump" ],
    "weight": 100,
    "object": {
      "fill_ter": "t_lake_bed",
      "rows": [
        "~~~~~~~~~~~~~~~~~~~~~~~~",
        "~~~~~~~~~~~~~~~~~~~~~~~~",
        "~~~~~~~~~~~~~~~~~~~~~~~~",
        "~~~~~~~~~~~~~~~~~~~~~~~~",
        "~~~~~~~~~~~~~~~~~~~~~~~~",
        "~~~~~~~~~~~~~~~~~~W~~~~~",
        "~~~~~W~~~~~~~~~~~~~~~~~~",
        "~~~~~~~~~~~~~~~~~~~~~~~~",
        "~~~~~~~~~~~~~~~W~~~~~~~~",
        "~~~~~~~~~~~WW~~~~~~~~~~~",
        "~~~~~~W~~~WWWW~~~~~~~~~~",
        "~~~~~~~~~WWWWWW~~~~~~~~~",
        "~~~~~~~~~~WWWW~~~~~~~~~~",
        "~~~~~~~~~~~WW~~~W~~~~~~~",
        "~~~~~~~~W~~~~~~~~~~~~~~~",
        "~~~~~~~~~~~~~~~~~~~~~~~~",
        "~~~~~~~~~~~~~~~~~~~~~~~~",
        "~~~W~~~~~~~~~~~~~~W~~~~~",
        "~~~~~~~~~~~~~~~~~~~~~~~~",
        "~~~~~~~~~~~~~~~~~~~~~~~~",
        "~~~~~~~~~~~~~~~~~~~~~~~~",
        "~~~~~~~~~~~~~~~~~~~~~~~~",
        "~~~~~~~~~~~~~~~~~~~~~~~~",
        "~~~~~~~~~~~~~~~~~~~~~~~~"
      ],
      "palettes": [ "lake_bed_palette" ],
      "set": [ { "square": "radiation", "amount": [ 20, 60 ], "x": 3, "y": 3, "x2": 21, "y2": 16 } ],
      "items": { "~": { "item": "lake_bed", "chance": 3 }, "W": { "item": "underwater_toxic_waste", "chance": 20 } },
      "place_monster": [ { "monster": "mon_zhark", "x": 2, "y": 14 }, { "monster": "mon_zhark", "x": 7, "y": 14 } ],
      "place_furniture": [ { "furn": "f_wreckage", "x": [ 3, 21 ], "y": [ 3, 21 ], "repeat": [ 3, 8 ] } ]
    }
  }
]
