[
  {
    "type": "mapgen",
    "method": "json",
    "om_terrain": [ [ "cargo_ship_a", "cargo_ship_b", "cargo_ship_c" ] ],
    "weight": 100,
    "object": {
      "fill_ter": "t_lake_bed",
      "rows": [
        ";;;;;;;;;;;;;;;;;;;;;;;;;;;;;;;;;;;;;;;;;;;;;;;;;;;;;;;;;;;;;;;;;;;;;;;;",
        ";;;;;;;;;;;;;;;;;;;;;;;;;;;;;;;;;;;;;;;;;;;;;;;;;;;;;;;;;;;;;;;;;;;;;;;;",
        ";;;;;;;;;;;;;;;;;;;;;;;;;;;;;;;;;;;;;;;;;;;;;;;;;;;;;;;;;;;;;;;;;;;;;;;;",
        ";;;;;;aaaaaaaaaaaaaaaaaaaaaaaaaaaaaaaaaaaaaaaaaaaaaaaaaaa||||o|||||o||;;",
        ";;;;aaa                                                  oiiiiiDFiiid||;",
        ";;aaa   ||||||||  ||||||||  ||||||||  ||||||||  |||||||| +iiiiiiiiiiii||",
        "aaa     |...g..j  |g...g.k  |...g..k  |g.gg..j  |g.....j |iiiiiiiiiiiiio",
        "a       |gg....j  |ggg...k  |gg...gk  |g....gj  |g.g.g.j ||||+||||||+|||",
        "a       ||||||||  ||||||||  ||||||||  ||||||||  |||||||| |iiiiiii|@@i@@|",
        "a                                                        oiQiiiQi|iiiii|",
        "a       ||||||||  ||||||||  ||||||||  ||||||||  |||||||| |iQiiiQi|@@i@@o",
        "a       |gg.g..k  |g..gggj  |gg....k  |g....gk  |..g...j |iQiiiii|iiiii|",
        "a       |g....gk  |g.....j  |g..gg.k  |g.gg..k  |g....gj |iQii||||@@i@@|",
        "a       ||||||||  ||||||||  ||||||||  ||||||||  |||||||| |iQii|St|iiiiio",
        "a                                                        oiQii|ii|@@i@@|",
        "a       ||||||||  ||||||||  ||||||||  ||||||||  |||||||| |iiii|Ui|iiiii|",
        "a       |..gg.gj  |...g..k  |......j  |g...ggj  |gg..g.k ||||+||+|||+|||",
        "aaa     |g.....j  |.g...gk  |gg.g.gj  |g.g...j  |......k |iiiiiiiiiiiiio",
        ";;aaa   ||||||||  ||||||||  ||||||||  ||||||||  |||||||| +iiiiiiiiiiii||",
        ";;;;aaa                                                  oiiiiiDFiiid||;",
        ";;;;;;aaaaaaaaaaaaaaaaaaaaaaaaaaaaaaaaaaaaaaaaaaaaaaaaaaa||||o|||||o||;;",
        ";;;;;;;;;;;;;;;;;;;;;;;;;;;;;;;;;;;;;;;;;;;;;;;;;;;;;;;;;;;;;;;;;;;;;;;;",
        ";;;;;;;;;;;;;;;;;;;;;;;;;;;;;;;;;;;;;;;;;;;;;;;;;;;;;;;;;;;;;;;;;;;;;;;;",
        ";;;;;;;;;;;;;;;;;;;;;;;;;;;;;;;;;;;;;;;;;;;;;;;;;;;;;;;;;;;;;;;;;;;;;;;;"
      ],
      "vendingmachines": { "D": { "item_group": "vending_drink" }, "F": { "item_group": "vending_food" } },
      "toilets": { "t": {  } },
      "gaspumps": { "!": {  } },
      "items": {
        "Q": { "item": "cannedfood", "chance": 100 },
        "S": { "item": "SUS_bathroom_cabinet", "chance": 100 },
        "g": { "item": "crate_parts", "chance": 100 }
      },
      "furniture": {
        "C": "f_workbench",
        "c": "f_cupboard",
        "1": "f_control_station",
        "A": "f_air_compressor",
        "f": "f_tourist_table",
        "&": "f_cleat",
        "@": "f_bed",
        "B": "f_sample_freezer",
        "E": "f_shaker",
        "G": "f_stool",
        "H": "f_counter",
        "I": "f_IV_pole",
        "J": "f_curtain",
        "K": "f_fridge",
        "Q": "f_rack",
        "S": "f_sink",
        "U": "f_shower",
        "W": "f_water_purifier",
        "b": "f_bench",
        "h": "f_camp_chair",
        "l": "f_foot_locker",
        "g": "f_crate_c"
      },
      "terrain": {
        " ": "t_bulkhead_floor_underwater_no_roof",
        "`": "t_bulkhead_roof",
        ";": "t_lake_bed",
        "+": "t_door_metal_bulkhead_c_underwater",
        "#": "t_metal_pontoon_dp",
        "2": "t_machinery_electronic",
        "*": "t_water_pool",
        "-": "t_water_cube",
        ".": "t_metal_floor_underwater",
        "j": "t_door_metal_locked_underwater",
        "k": "t_door_metal_locked_o_underwater",
        "<": "t_ladder_up",
        "|": "t_wall_bulkhead_underwater",
        ">": "t_ladder_down",
        "~": "t_water_cube",
        "A": "t_metal_floor_underwater",
        "P": "t_concrete_dock_deep_pile",
        "^": "t_lake_bed_concrete",
        "o": "t_porthole",
        "y": "t_lake_bed_concrete_yellow",
        "@": "t_bulkhead_floor_underwater",
        "a": "t_metal_railing_underwater",
        "d": "t_stairs_up_underwater",
        "e": "t_stairs_down_underwater",
        "g": "t_metal_floor_underwater",
        "i": "t_bulkhead_floor_underwater"
      }
    }
  },
  {
    "type": "mapgen",
    "method": "json",
    "om_terrain": [ [ "cargo_ship_1_a", "cargo_ship_1_b", "cargo_ship_1_c" ] ],
    "weight": 100,
    "object": {
      "fill_ter": "t_lake_bed",
      "rows": [
        "~~~~~~~~~~~~~~~~~~~~~~~~~~~~~~~~~~~~~~~~~~~~~~~~~~~~~~~~~~~~~~~~~~~~~~~~",
        "~~~~~~~~~~~~~~~~~~~~~~~~~~~~~~~~~~~~~~~~~~~~~~~~~~~~~~~~~~~~~~~~~~~~~~~~",
        "~~~~~~~~~~~~~~~~~~~~~~~~~~~~~~~~~~~~~~~~~~~~~~~~~~~~~~~~~~~~~~~~~~~~~~~~",
        "~~~~~~~~~~~~~~~~~~~~~~~~~~~~~~~~~~~~~~~~~~~~~~~~~~~~~~~~~||||o|||||o||~~",
        "~~~~~~~~~~~~~~~~~~~~~~~~~~~~~~~~~~~~~~~~~~~~~~~~~~~~~~~~~| 22 22    e||~",
        "~~~~~~~~||||||||~~||||||||~~||||||||~~||||||||~~||||||||~o            ||",
        "~~~~~~~~|g..g..k~~|gg.g..i~~|g.g...i~~|.....gk~~|g.gg..i~|             o",
        "~~~~~~~~|gg...gk~~|g....gi~~|g...ggi~~|g.gg..k~~|g....gi~||||+||      W|",
        "~~~~~~~~||||||||~~||||||||~~||||||||~~||||||||~~||||||||~|     |      2|",
        "~~~~~~~~~~~~~~~~~~~~~~~~~~~~~~~~~~~~~~~~~~~~~~~~~~~~~~~~~o     |2     E|",
        "~~~~~~~~||||||||~~||||||||~~||||||||~~||||||||~~||||||||~o CC  |       o",
        "~~~~~~~~|g....gi~~|..gg..k~~|gg...gi~~|...g..k~~|g..g..i~o CG  |W      |",
        "~~~~~~~~|g.gg..i~~|g....gk~~|g..g..i~~|.g...gk~~|gg...gi~o CG  |A      |",
        "~~~~~~~~||||||||~~||||||||~~||||||||~~||||||||~~||||||||~o CC  |       o",
        "~~~~~~~~~~~~~~~~~~~~~~~~~~~~~~~~~~~~~~~~~~~~~~~~~~~~~~~~~o     |2     2|",
        "~~~~~~~~||||||||~~||||||||~~||||||||~~||||||||~~||||||||~|     |      A|",
        "~~~~~~~~|gg...gk~~|..g...i~~|g...g.i~~|ggg...i~~|gg...gk~||||+||      2|",
        "~~~~~~~~|g..g..k~~|g...ggi~~|ggg...i~~|....ggi~~|g..g..k~|             o",
        "~~~~~~~~||||||||~~||||||||~~||||||||~~||||||||~~||||||||~o            ||",
        "~~~~~~~~~~~~~~~~~~~~~~~~~~~~~~~~~~~~~~~~~~~~~~~~~~~~~~~~~| 22 22    e||~",
        "~~~~~~~~~~~~~~~~~~~~~~~~~~~~~~~~~~~~~~~~~~~~~~~~~~~~~~~~~||||o|||||o||~~",
        "~~~~~~~~~~~~~~~~~~~~~~~~~~~~~~~~~~~~~~~~~~~~~~~~~~~~~~~~~~~~~~~~~~~~~~~~",
        "~~~~~~~~~~~~~~~~~~~~~~~~~~~~~~~~~~~~~~~~~~~~~~~~~~~~~~~~~~~~~~~~~~~~~~~~",
        "~~~~~~~~~~~~~~~~~~~~~~~~~~~~~~~~~~~~~~~~~~~~~~~~~~~~~~~~~~~~~~~~~~~~~~~~"
      ],
      "vendingmachines": { "D": { "item_group": "vending_drink" }, "F": { "item_group": "vending_food" } },
      "toilets": { "t": {  } },
      "gaspumps": { "!": {  } },
      "items": {
        "Q": { "item": "cannedfood", "chance": 100 },
        "S": { "item": "SUS_bathroom_cabinet", "chance": 100 },
        "g": { "item": "crate_parts", "chance": 100 }
      },
      "furniture": {
        "C": "f_workbench",
        "c": "f_cupboard",
        "1": "f_control_station",
        "A": "f_air_compressor",
        "f": "f_tourist_table",
        "&": "f_cleat",
        "@": "f_bed",
        "B": "f_sample_freezer",
        "E": "f_shaker",
        "G": "f_stool",
        "H": "f_counter",
        "I": "f_IV_pole",
        "J": "f_curtain",
        "K": "f_fridge",
        "Q": "f_rack",
        "S": "f_sink",
        "U": "f_shower",
        "W": "f_water_purifier",
        "b": "f_bench",
        "h": "f_camp_chair",
        "l": "f_foot_locker",
        "g": "f_crate_c"
      },
      "terrain": {
        " ": "t_bulkhead_floor_underwater",
        "`": "t_bulkhead_roof",
        ";": "t_lake_bed",
        "+": "t_door_metal_bulkhead_c_underwater",
        "#": "t_metal_pontoon_dp",
        "2": "t_machinery_electronic",
        "*": "t_water_pool",
        "-": "t_water_cube",
        ".": "t_metal_floor_underwater_no_roof",
        "<": "t_ladder_up",
        "|": "t_wall_bulkhead_underwater",
        ">": "t_ladder_down",
        "~": "t_water_cube",
        "A": "t_metal_floor_underwater_no_roof",
        "P": "t_concrete_dock_deep_pile",
        "^": "t_lake_bed_concrete",
        "o": "t_porthole",
        "y": "t_lake_bed_concrete_yellow",
        "a": "t_metal_railing_underwater",
        "d": "t_stairs_up_underwater",
        "e": "t_stairs_down_underwater",
        "i": "t_door_metal_locked_underwater",
        "k": "t_door_metal_locked_o_underwater"
      }
    }
  },
  {
    "type": "mapgen",
    "method": "json",
    "om_terrain": [ [ "cargo_ship_2_a", "cargo_ship_2_b", "cargo_ship_2_c" ] ],
    "weight": 100,
    "object": {
      "fill_ter": "t_lake_bed",
      "rows": [
        "~~~~~~~~~~~~~~~~~~~~~~~~~~~~~~~~~~~~~~~~~~~~~~~~~~~~~~~~~~~~~~~~~~~~~~~~",
        "~~~~~~~~~~~~~~~~~~~~~~~~~~~~~~~~~~~~~~~~~~~~~~~~~~~~~~~~~~~~~~~~~~~~~~~~",
        "~~~~~~~~~~~~~~~~~~~~~~~~~~~~~~~~~~~~~~~~~~~~~~~~~~~~~~~~~~~~~~~~~~~~~~~~",
        "~~~~~~~~~~~~~~~~~~~~~~~~~~~~~~~~~~~~~~~~~~~~~~~~~~~~~~~~~`````````````~~",
        "~~~~~~~~~~~~~~~~~~~~~~~~~~~~~~~~~~~~~~~~~~~~~~~~~~~~~~~~~``````````````~",
        "~~~~~~~~````````~~````````~~````````~~````````~~````````~```````````````",
        "~~~~~~~~````````~~````````~~````````~~````````~~````````~```````````````",
        "~~~~~~~~````````~~````````~~````````~~````````~~````````~```````````````",
        "~~~~~~~~````````~~````````~~````````~~````````~~````````~```````````````",
        "~~~~~~~~~~~~~~~~~~~~~~~~~~~~~~~~~~~~~~~~~~~~~~~~~~~~~~~~~```````````````",
        "~~~~~~~~````````~~````````~~````````~~````````~~````````~```````````````",
        "~~~~~~~~````````~~````````~~````````~~````````~~````````~```````````````",
        "~~~~~~~~````````~~````````~~````````~~````````~~````````~```````````````",
        "~~~~~~~~````````~~````````~~````````~~````````~~````````~```````````````",
        "~~~~~~~~~~~~~~~~~~~~~~~~~~~~~~~~~~~~~~~~~~~~~~~~~~~~~~~~~```````````````",
        "~~~~~~~~````````~~````````~~````````~~````````~~````````~```````````````",
        "~~~~~~~~````````~~````````~~````````~~````````~~````````~```````````````",
        "~~~~~~~~````````~~````````~~````````~~````````~~````````~```````````````",
        "~~~~~~~~````````~~````````~~````````~~````````~~````````~```````````````",
        "~~~~~~~~~~~~~~~~~~~~~~~~~~~~~~~~~~~~~~~~~~~~~~~~~~~~~~~~~``````````````~",
        "~~~~~~~~~~~~~~~~~~~~~~~~~~~~~~~~~~~~~~~~~~~~~~~~~~~~~~~~~`````````````~~",
        "~~~~~~~~~~~~~~~~~~~~~~~~~~~~~~~~~~~~~~~~~~~~~~~~~~~~~~~~~~~~~~~~~~~~~~~~",
        "~~~~~~~~~~~~~~~~~~~~~~~~~~~~~~~~~~~~~~~~~~~~~~~~~~~~~~~~~~~~~~~~~~~~~~~~",
        "~~~~~~~~~~~~~~~~~~~~~~~~~~~~~~~~~~~~~~~~~~~~~~~~~~~~~~~~~~~~~~~~~~~~~~~~"
      ],
      "vendingmachines": { "D": { "item_group": "vending_drink" }, "F": { "item_group": "vending_food" } },
      "toilets": { "t": {  } },
      "gaspumps": { "!": {  } },
      "furniture": {
        "C": "f_workbench",
        "c": "f_cupboard",
        "1": "f_control_station",
        "A": "f_air_compressor",
        "f": "f_tourist_table",
        "&": "f_cleat",
        "@": "f_bed",
        "B": "f_sample_freezer",
        "E": "f_shaker",
        "G": "f_stool",
        "H": "f_counter",
        "I": "f_IV_pole",
        "J": "f_curtain",
        "K": "f_fridge",
        "Q": "f_rack",
        "S": "f_sink",
        "U": "f_shower",
        "W": "f_water_purifier",
        "b": "f_bench",
        "h": "f_camp_chair",
        "l": "f_foot_locker"
      },
      "terrain": {
        " ": "t_bulkhead_floor_underwater",
        "`": "t_bulkhead_roof",
        ";": "t_lake_bed",
        "+": "t_door_metal_bulkhead_c",
        "#": "t_metal_pontoon_dp",
        "2": "t_machinery_electronic",
        "*": "t_water_pool",
        "-": "t_water_cube",
        ".": "t_metal_floor_underwater",
        "<": "t_ladder_up",
        "|": "t_wall_bulkhead_underwater",
        ">": "t_ladder_down",
        "~": "t_water_cube",
        "A": "t_metal_floor_underwater",
        "P": "t_concrete_dock_deep_pile",
        "^": "t_lake_bed_concrete",
        "o": "t_porthole",
        "y": "t_lake_bed_concrete_yellow",
        "a": "t_metal_railing_underwater",
        "d": "t_stairs_up_underwater",
        "e": "t_stairs_down_underwater"
      }
    }
  },
  {
    "type": "overmap_terrain",
    "id": [
      "cargo_ship_a",
      "cargo_ship_b",
      "cargo_ship_c",
      "cargo_ship_1_a",
      "cargo_ship_1_b",
      "cargo_ship_1_c",
      "cargo_ship_2_a",
      "cargo_ship_2_b",
      "cargo_ship_2_c"
    ],
    "name": "sunken cargo ship",
    "sym": "S",
    "color": "light_gray",
    "see_cost": 1
  },
  {
    "type": "overmap_special",
    "id": "sunken_cargo_ship",
    "rotate": false,
    "overmaps": [
      { "point": [ 0, 0, -5 ], "overmap": "cargo_ship_a_east", "locations": [ "lake_bed" ] },
      { "point": [ 0, 1, -5 ], "overmap": "cargo_ship_b_east", "locations": [ "lake_bed" ] },
      { "point": [ 0, 2, -5 ], "overmap": "cargo_ship_c_east", "locations": [ "lake_bed" ] },
      { "point": [ 0, 0, -4 ], "overmap": "cargo_ship_1_a_east", "locations": [ "lake_water_cube" ] },
      { "point": [ 0, 1, -4 ], "overmap": "cargo_ship_1_b_east", "locations": [ "lake_water_cube" ] },
      { "point": [ 0, 2, -4 ], "overmap": "cargo_ship_1_c_east", "locations": [ "lake_water_cube" ] },
      { "point": [ 0, 0, -3 ], "overmap": "cargo_ship_2_a_east", "locations": [ "lake_water_cube" ] },
      { "point": [ 0, 1, -3 ], "overmap": "cargo_ship_2_b_east", "locations": [ "lake_water_cube" ] },
      { "point": [ 0, 2, -3 ], "overmap": "cargo_ship_2_c_east", "locations": [ "lake_water_cube" ] }
    ],
    "locations": [ "lake_surface" ],
    "occurrences": [ 1, 3 ],
    "flags": [ "LAKE" ]
  }
]
