[
  {
    "type": "mapgen",
    "method": "json",
    "om_terrain": [ "mil_surplus" ],
    "weight": 300,
    "object": {
      "fill_ter": "t_floor",
      "rows": [
        "...........~~..........!",
        "...........~~...........",
        "..-''''''--++--''''''--.",
        "..|             QrQ@  |.",
        "..| #         b     b |.",
        "..| #           *]*   |.",
        "..| #        @  *8*   |.",
        "..| #           ***   |.",
        "..|                   |.",
        "..| A A A B B B C C C |.",
        "..| A A A B B B C C C |.",
        "..| A A A F E E C C C |.",
        "..| A A A F E E C C C |.",
        "..| A A A F E E C C C |.",
        "..| A A A F E E C C C |.",
        "..| A A A F F F C C C |.",
        "..| A A A F F F F F F |.",
        "..| A A A F D D F F F |.",
        "..| A A A F D D F F F |.",
        "..| A A A F D D F F F |.",
        "..|                   |.",
        "..|-+-----+--------+- |.",
        "..|&  |4YYYUÜÜÜU<|LL|@|.",
        "..|----YYYYYYYYYY-----|."
      ],
      "palettes": [ "mil_surplus" ],
      "place_monsters": [ { "monster": "GROUP_ZOMBIE_GUNSTORE", "x": [ 2, 21 ], "y": 1, "chance": 2, "repeat": [ 1, 2 ] } ]
    }
  },
  {
    "type": "mapgen",
    "method": "json",
    "om_terrain": "mil_surplus_roof",
    "object": {
      "fill_ter": "t_flat_roof",
      "rows": [
        "                        ",
        "                        ",
        "  --------------------- ",
        "  -...................- ",
        "  -...................- ",
        "  -...................- ",
        "  -...................- ",
        "  -...................- ",
        "  -...................- ",
        "  -...................- ",
        "  -...................- ",
        "  -...................- ",
        "  -...................- ",
        "  -...................- ",
        "  -...................- ",
        "  -...................- ",
        "  -...................- ",
        "  -...................- ",
        "  -...................- ",
        "  -...................- ",
        "  -...................- ",
        "  -.R.5-------####....- ",
        "  -...-     ####>#....- ",
        "  -----          ------ "
      ],
      "palettes": [ "roof_palette" ],
      "terrain": { ">": "t_ladder_down" },
      "nested": { "U": { "chunks": [ "roof_2x2_infrastructure" ] }, "R": { "chunks": [ "roof_2x2_infrastructure_1" ] } },
      "place_nested": [
        {
          "chunks": [
            [ "null", 20 ],
            [ "roof_2x2_utilities_b", 15 ],
            [ "roof_2x2_utilities_c", 5 ],
            [ "roof_2x2_utilities_d", 40 ],
            [ "roof_2x2_utilities", 40 ]
          ],
          "x": [ 4, 18 ],
          "y": [ 5, 6 ]
        },
        {
          "chunks": [
            [ "null", 20 ],
            [ "roof_4x4_utility", 40 ],
            [ "roof_6x6_survivor", 20 ],
            [ "roof_4x4_holdout", 5 ],
            [ "roof_6x6_utility", 20 ]
          ],
          "x": [ 3, 13 ],
          "y": [ 8, 14 ]
        }
      ]
    }
  },
  {
    "type": "mapgen",
    "method": "json",
    "om_terrain": [ "mil_surplus_1" ],
    "weight": 300,
    "object": {
      "fill_ter": "t_floor",
      "rows": [
        "...........~~..........!",
        "...........~~...........",
        ".--``````--++--``````--.",
        ".|###           @  @  |.",
        ".| S#                 |.",
        ".|  #          A BB C |.",
        ".|L                   |.",
        ".|---   A  A  A    ---|.",
        ".|& |   A  A  A    / ^|.",
        ".|  +   A  A  A    ---|.",
        ".|  |   A  A  A    / ^|.",
        ".|---   A  A  A    ---|.",
        ".|                    |.",
        ".| DDDBBBB    C C F F |.",
        ".|            C C F F |.",
        ".| CCCCCCC    C C F F |.",
        ".|            C C F F |.",
        ".| CCCCCCC    C C F F |.",
        ".|                    |.",
        ".| EEEEEEE    FFFFFFF |.",
        ".|                    |.",
        ".| #######    ####### |4",
        ".----------------------.",
        "...................ÜÜÜ.."
      ],
      "palettes": [ "mil_surplus" ],
      "place_monsters": [ { "monster": "GROUP_ZOMBIE_GUNSTORE", "x": [ 2, 21 ], "y": 1, "chance": 2, "repeat": [ 1, 2 ] } ]
    }
  },
  {
    "type": "mapgen",
    "method": "json",
    "om_terrain": "mil_surplus_roof_1",
    "object": {
      "fill_ter": "t_flat_roof",
      "rows": [
        "                        ",
        "                        ",
        " ---------------------- ",
        " -....................- ",
        " -....................- ",
        " -....................- ",
        " -....................- ",
        " -....................- ",
        " -....................- ",
        " -....................- ",
        " -....................- ",
        " -....................- ",
        " -....................- ",
        " -....................- ",
        " -....................- ",
        " -....................- ",
        " -....................- ",
        " -....................- ",
        " -....................- ",
        " -..................Z.- ",
        " -..........R.........- ",
        " -................... 5 ",
        " ---------------------- ",
        "                        "
      ],
      "palettes": [ "roof_palette" ],
      "nested": {
        "U": { "chunks": [ "roof_2x2_infrastructure" ] },
        "R": { "chunks": [ "roof_2x2_infrastructure_1" ] },
        "Z": { "chunks": [ "roof_2x2_infrastructure_2" ] }
      },
      "place_nested": [
        {
          "chunks": [
            [ "null", 20 ],
            [ "roof_2x2_utilities_b", 15 ],
            [ "roof_2x2_utilities_c", 5 ],
            [ "roof_2x2_utilities_d", 40 ],
            [ "roof_2x2_utilities", 50 ]
          ],
          "x": [ 4, 18 ],
          "y": [ 4, 6 ]
        },
        {
          "chunks": [ [ "null", 20 ], [ "roof_4x4_utility", 40 ], [ "roof_6x6_utility", 20 ] ],
          "x": [ 5, 13 ],
          "y": [ 8, 11 ]
        }
      ]
    }
  },
  {
    "method": "json",
    "om_terrain": "mil_surplus_2",
    "type": "mapgen",
    "weight": 100,
    "object": {
      "fill_ter": "t_floor",
      "rows": [
        "___d___ud___________~~__",
        "__|-'''''''-|_______~~__",
        "_u|####     +~~~~~~~~~__",
        "_u|         +~~~~~~~~~__",
        "_u| FFF     ----------|_",
        "d_|        ^|    FFFFF|_",
        "__|####     +  h     F|_",
        "__|----     --######--|d",
        "__|###                |_",
        "__|      ##           |_",
        "_u|      ##           |u",
        "_u|###        AB CD  E|u",
        "_d|----       AB CD  E|_",
        "__|###   FF   AB CD  E|_",
        "__|#     FF   AB CD  E|_",
        "__|#          AB CD  E|_",
        "__|#          AB CD  E|d",
        "_u|b   |----| AB CD  E|u",
        "__|b   |LLLL| AB CD  E|_",
        "__|||| |    |        E|_",
        "__|& + +    |---------|4",
        "d_|% |^| h  +~~____ÜÜÜ__",
        "__|---------|~~_________",
        "____u_u_______________d_"
      ],
      "palettes": [ "mil_surplus" ],
      "toilets": { "&": {  } },
      "place_monsters": [ { "monster": "GROUP_ZOMBIE_GUNSTORE", "x": [ 13, 21 ], "y": [ 2, 3 ], "chance": 2, "repeat": [ 1, 2 ] } ]
    }
  },
  {
    "type": "mapgen",
    "method": "json",
    "om_terrain": "mil_surplus_roof_2",
    "object": {
      "fill_ter": "t_flat_roof",
      "rows": [
        "                        ",
        "  --------------------- ",
        "  -...................- ",
        "  -...................- ",
        "  -...................- ",
        "  -...................- ",
        "  -...................- ",
        "  -...................- ",
        "  -...................- ",
        "  -...................- ",
        "  -...................- ",
        "  -...................- ",
        "  -...................- ",
        "  -...................- ",
        "  -...................- ",
        "  -...................- ",
        "  -...................- ",
        "  -...................- ",
        "  -...................- ",
        "  -...................- ",
        "  -..R...U..----------5 ",
        "  -.........-           ",
        "  -----------           ",
        "                        "
      ],
      "palettes": [ "roof_palette" ],
      "nested": { "U": { "chunks": [ "roof_2x2_infrastructure" ] }, "R": { "chunks": [ "roof_2x2_infrastructure_1" ] } },
      "place_nested": [
        {
          "chunks": [
            [ "null", 20 ],
            [ "roof_2x2_utilities_b", 15 ],
            [ "roof_2x2_utilities_c", 5 ],
            [ "roof_2x2_utilities_d", 40 ],
            [ "roof_2x2_utilities", 50 ]
          ],
          "x": [ 5, 18 ],
          "y": [ 3, 6 ]
        },
        {
          "chunks": [ [ "null", 20 ], [ "roof_4x4_utility", 40 ], [ "roof_6x6_utility", 20 ] ],
          "x": [ 3, 13 ],
          "y": [ 8, 13 ]
        }
      ]
    }
  }
]
