[
  {
    "id": "mussto_windinst",
    "type": "item_group",
    "items": [
      [ "tuba", 10 ],
      [ "trumpet", 25 ],
      [ "flute", 25 ],
      [ "clarinet", 25 ],
      [ "saxophone", 25 ],
      [ "harmonica_holder", 25 ],
      [ "bagpipes", 5 ]
    ]
  },
  {
    "id": "mussto_stringinst",
    "type": "item_group",
    "items": [ [ "acoustic_guitar", 100 ], [ "violin", 80 ], [ "ukulele", 90 ], [ "banjo", 100 ], [ "guitar_electric", 100 ] ]
  },
  {
    "id": "light_reading",
    "type": "item_group",
    "items": [
      [ "novel_coa", 10 ],
      [ "child_book", 50 ],
      [ "manual_dodge_kid", 25 ],
      [ "tall_tales", 20 ],
      [ "story_book", 4 ],
      [ "novel_pulp", 16 ],
      [ "fairy_tales", 20 ],
      [ "mag_comic", 20 ]
    ]
  },
  {
    "type": "mapgen",
    "method": "json",
    "om_terrain": "s_music",
    "//": "Real decent place for a quick morale boost, relatively rare.",
    "object": {
      "fill_ter": "t_linoleum_gray",
      "rows": [
        "zs______,______,______'z",
        "zs______,______,______sz",
        "zs______,______,______sz",
        "zs______,______,______sz",
        "zs______,______,______sz",
        "zs______,______,______sz",
        "zssssssssssssssssssssssz",
        "z||----||----|++||----|z",
        " |^.CC....CC.....#.EcC- ",
        " -...............#....- ",
        " -E..###rr...rr..#....- ",
        " -c..###rr...rr..####.- ",
        " |...........rr.......| ",
        " |1..######..........C| ",
        " |...######...........| ",
        " -...........|+||+||+|| ",
        " -E..rrrrrr..|g7|g7|g7| ",
        " -c..rrrrrr..|gg|gg|gg| ",
        " |...........|Kh|Kh|Kh| ",
        " |D|||D|L|||||||||||||| ",
        " |.S|S.|sUUUs         4 ",
        " |T#|#T|sssss           ",
        " |H|||H|sssss           ",
        "                        "
      ],
      "terrain": {
        "+": "t_door_glass_c",
        ",": "t_pavement_y",
        ".": "t_linoleum_gray",
        "-": "t_wall_glass",
        "D": "t_door_c",
        "H": "t_curtains",
        "L": "t_door_locked",
        "_": "t_pavement",
        "'": "t_sidewalk",
        "U": "t_sidewalk",
        "s": "t_sidewalk",
        " ": "t_region_groundcover_urban",
        "z": "t_region_shrub_decorative",
        "g": "t_carpet_green",
        "h": "t_carpet_green",
        "K": "t_carpet_green",
        "7": "t_carpet_green",
        "4": "t_gutter_downspout",
        "|": "t_wall_b"
      },
      "furniture": {
        "'": "f_street_light",
        "#": "f_counter",
        "C": "f_displaycase",
        "E": "f_desk",
        "S": "f_sink",
        "^": "f_indoor_plant",
        "c": "f_chair",
        "U": "f_dumpster",
        "h": "f_chair",
        "K": "f_desk",
        "r": "f_rack",
        "7": "f_speaker_cabinet"
      },
      "items": { "U": { "item": "trash_dumpster", "chance": 80 } },
      "vendingmachines": { "1": { "item_group": "vending_drink" } },
      "toilets": { "T": {  } },
      "place_loot": [
        { "group": "mussto_stringinst", "x": [ 5, 10 ], "y": 10, "chance": 70, "repeat": [ 1, 3 ] },
        { "group": "mussto_windinst", "x": [ 5, 10 ], "y": 11, "chance": 80, "repeat": [ 1, 3 ] },
        { "group": "mussto_stringinst", "x": [ 5, 10 ], "y": 13, "chance": 70, "repeat": [ 1, 3 ] },
        { "group": "mussto_windinst", "x": [ 5, 10 ], "y": 14, "chance": 80, "repeat": [ 1, 3 ] },
        { "group": "mussto_stringinst", "x": [ 5, 10 ], "y": 16, "chance": 70, "repeat": [ 1, 3 ] },
        { "group": "mussto_windinst", "x": [ 5, 10 ], "y": 17, "chance": 80, "repeat": [ 1, 3 ] },
        { "group": "light_reading", "x": [ 13, 14 ], "y": [ 10, 12 ], "chance": 90, "repeat": [ 4, 10 ] },
        { "group": "musicstore_showpiece", "x": 21, "y": 8, "chance": 95 },
        { "item": "amplifier_head", "x": 15, "y": 17, "chance": 80 },
        { "item": "amplifier_head", "x": 18, "y": 17, "chance": 80 },
        { "item": "amplifier_head", "x": 21, "y": 17, "chance": 80 }
      ]
    }
  },
  {
    "type": "mapgen",
    "method": "json",
    "om_terrain": "s_music_roof",
    "object": {
      "fill_ter": "t_flat_roof",
      "rows": [
        "                        ",
        "                        ",
        "                        ",
        "                        ",
        "                        ",
        "                        ",
        "                        ",
        " ---------------------- ",
        " -....................- ",
        " -....................- ",
        " -....................- ",
        " -....................- ",
        " -....................- ",
        " -....................- ",
        " -....................- ",
        " -....................- ",
        " -....................- ",
        " -....................- ",
        " -.&..................- ",
        " -.....---------------5 ",
        " -.....-                ",
        " -.....-                ",
        " -------                ",
        "                        "
      ],
      "palettes": [ "roof_palette" ],
      "place_items": [ { "item": "roof_trash", "x": [ 2, 21 ], "y": [ 9, 18 ], "chance": 50, "repeat": [ 1, 3 ] } ],
      "place_nested": [
        {
          "chunks": [ [ "null", 5 ], [ "roof_2x2_utilities_d", 30 ], [ "roof_2x2_utilities", 50 ], [ "roof_6x6_survivor", 5 ] ],
          "x": [ 3, 15 ],
          "y": [ 9, 12 ]
        }
      ]
    }
  }
]
