[
  {
    "type": "mapgen",
    "method": "json",
    "om_terrain": [ "natural_spring" ],
    "weight": 200,
    "object": {
      "fill_ter": "t_region_groundcover",
      "rows": [
        "                        ",
        "                        ",
        "                        ",
        "                        ",
        "          ????          ",
        "         ??????         ",
        "        ???**???        ",
        "       ???****???       ",
        "      ???**//**???      ",
        "     ???**/~~/**???     ",
        "    ???**/~~~~/**???    ",
        "    ??**/~~~~~~/**??    ",
        "    ??**/~~~~~~/**??    ",
        "    ???**/~~~~/**???    ",
        "     ???**/~~/**???     ",
        "      ???**//**???      ",
        "       ???****???       ",
        "        ???**???        ",
        "         ??????         ",
        "          ????          ",
        "                        ",
        "                        ",
        "                        ",
        "                        "
      ],
      "terrain": {
        "~": [ [ "t_swater_dp", 4 ], "t_water_dp" ],
        "/": [ [ "t_swater_dp", 4 ], [ "t_swater_sh", 4 ], "t_water_dp", "t_water_sh" ],
        "*": [ [ "t_swater_sh", 4 ], "t_water_sh" ],
        "?": [ [ "t_swater_sh", 4 ], "t_water_sh", [ "t_region_groundcover_barren", 5 ] ]
      },
      "furniture": {
        "~": [ [ "f_null", 15 ], [ "f_rubble_rock", 2 ], "f_boulder_small", "f_boulder_medium", "f_boulder_large" ],
        "*": [ [ "f_null", 35 ], [ "f_rubble_rock", 3 ], "f_boulder_small", "f_boulder_medium" ]
      },
      "set": [ { "point": "furniture", "id": "f_hot_spring", "x": [ 10, 13 ], "y": [ 10, 13 ], "chance": 3, "repeat": [ 1, 3 ] } ],
      "//": "Always one sulfur chunk, sometimes more but more often salt.",
      "place_loot": [
        { "item": "chunk_sulfur", "x": [ 10, 13 ], "y": [ 10, 13 ] },
        { "group": "spring_minerals", "x": [ 8, 15 ], "y": [ 8, 15 ], "repeat": [ 1, 3 ] }
      ]
    }
  }
]
