[
  {
    "type": "mapgen",
    "method": "json",
    "om_terrain": [ [ "lumbermill_0_0_ocu", "lumbermill_1_0_ocu" ], [ "lumbermill_0_1_ocu", "lumbermill_1_1_ocu" ] ],
    "object": {
      "fill_ter": "t_thconc_floor",
      "rows": [
        "vvvvvvvvvvvvvvvvvv#;;;;;;;;;;#vvvvvvvvvvvvvvvvvv",
        "v  *         *      *______ *6     2      *    v",
        "v      *       2     ______   7               2v",
        "v                    ______         *   2      v",
        "v*2      7 *    *    ______     *            * v",
        "v ^###ww####ww### * ________  *   ##ww#ww##^   v",
        "v *#xxxx..x.xxxx#   __________    w.c...c.w   *v",
        "v  #xx,,,,,,..xx#  _______________#ddX.Xdd#*   v",
        "v* wx,=======@.xw  _______________+......i#  * v",
        "v  w.,=,,,T,...xw* _______________#......&#    v",
        "v  #x,=,,......x#   _________ 2 * #ddX.Xdd#7   v",
        "v 2#x,=M,.C....x# * _________     w.c....cw   *v",
        "v *#.,=,,.Cr..xx#   __________*   #########^   v",
        "v  #.,=P,.Rr..xx# 2 __________  *     *     *  V",
        "v  #x,=,,.Cr..x6#6 *__________  2#############^v",
        "v *#x,=J,.C.....;________________#&.bb.bb.C.f# v",
        "v  #.,=,,.......;________________+..nn.nn.C.f#*v",
        "v* wx,=,,,B,....;________________#..bb.bb.C.D# v",
        "v  wx,=======O..;_____________   #..........F#7v",
        "v  #xx,,,,,,....;_____________  *#....nc###### v",
        "v^7#xx.....x..xx#  __________ *  wbnb.nc#S.+t#*v",
        "#######+#########7 __________   2wbnb...+..### v",
        "#$.$#ll.ll#b.w    *___________   #......#S.+t#*v",
        "#$.$#.....#b.#__________________*###ww########^v",
        "#$..+.bbb.+..+___________________________   *  v",
        "#$.$#.....#b.#______________________________  *v",
        "#$.$#lllll#b.w   _____________________________ v",
        "##############   _____________________________ v",
        "v^2              ______________________________v",
        "v    1111 11111  ______________________________v",
        "v   *          * ______________________________v",
        "v  1111 11111    ______________________________v",
        "v               _______________________________v",
        "v 111111 11111  ______________________________6#",
        "v *             _______________________________;",
        "v  111111 111  ________________________________;",
        "v        2    _________________________________;",
        "v vvvvv    *___________________________1 1  ___;",
        "v vooov______________________   ____ 121   1  _#",
        "v voGoV_____________ #.......#  ____ 1 1*1 1 1 v",
        "v vooov_________     #L.....L#* ____*  1 1 1 2 v",
        "v vvvvv   ______  * *wL.....Lw   ____1 1 1 1  *v",
        "v         1____ 2    #L.....L# * ____1 1*  1   v",
        "v 1111111 1____    7 wx.....xw   ____       *  v",
        "v1         ____*     #xx.x.xx#   ____ *111111  v",
        "v1 1111111____    2  #########*   ____   2   7 v",
        "v1   2    ____6     *^   2   ^    ____6   *   *v",
        "vvvvvvvvv#;;;;#vvvvvvvvvvvvvvvvvv#;;;;#vvvvvvvvv"
      ],
      "palettes": [ "lumberyard" ],
      "faction_owner": [
        { "id": "wasteland_scavengers", "x": [ 1, 23 ], "y": [ 1, 23 ] },
        { "id": "wasteland_scavengers", "x": [ 1, 23 ], "y": [ 24, 47 ] },
        { "id": "wasteland_scavengers", "x": [ 24, 47 ], "y": [ 1, 23 ] },
        { "id": "wasteland_scavengers", "x": [ 24, 47 ], "y": [ 24, 47 ] }
      ],
      "terrain": { "o": "t_concrete" },
      "gaspumps": { "G": { "fuel": "gasoline", "amount": [ 50000, 268750 ] } },
      "place_vehicles": [
        { "vehicle": "flatbed_truck", "x": [ 43, 45 ], "y": 33, "chance": 30, "fuel": 25, "status": 0, "rotation": 90 },
        {
          "vehicle": "pickup",
          "x": [ 35, 37 ],
          "y": [ 28, 31 ],
          "chance": 30,
          "fuel": 25,
          "status": 0,
          "rotation": 90
        },
        { "vehicle": "car", "x": [ 29, 31 ], "y": [ 27, 30 ], "chance": 30, "fuel": 15, "status": 0, "rotation": 90 }
      ],
      "place_npcs": [
        { "class": "NPC_lumbermill_logger", "x": 18, "y": 1 },
        { "class": "NPC_lumbermill_logger", "x": 30, "y": 1 },
        { "class": "NPC_lumbermill_logger", "x": 40, "y": 9 },
        { "class": "NPC_lumbermill_logger", "x": 17, "y": 10 },
        { "class": "NPC_lumbermill_logger", "x": 14, "y": 11 },
        { "class": "NPC_lumbermill_logger", "x": 35, "y": 19 },
        { "class": "NPC_lumbermill_logger", "x": 10, "y": 20 },
        { "class": "NPC_lumbermill_logger", "x": 32, "y": 22 },
        { "class": "NPC_lumbermill_logger", "x": 12, "y": 23 },
        { "class": "NPC_lumbermill_logger", "x": 14, "y": 27 },
        { "class": "NPC_lumbermill_logger", "x": 46, "y": 38 },
        { "class": "NPC_lumbermill_logger", "x": 20, "y": 39 },
        { "class": "NPC_lumbermill_logger", "x": 30, "y": 39 },
        { "class": "NPC_lumbermill_merchant", "x": 25, "y": 43 },
        { "class": "NPC_lumbermill_logger", "x": 9, "y": 46 },
        { "class": "NPC_lumbermill_logger", "x": 33, "y": 46 }
      ]
    }
  },
  {
    "type": "mapgen",
    "method": "json",
    "nested_mapgen_id": "occupied_lum_wall_0_0",
    "object": {
      "mapgensize": [ 24, 24 ],
      "rows": [
        "vvvvvvvvvvvvvvvvvv      ",
        "v                       ",
        "v                       ",
        "v                       ",
        "v                       ",
        "v                       ",
        "v                       ",
        "v                       ",
        "v                       ",
        "v                       ",
        "v                       ",
        "v                       ",
        "v                       ",
        "v                       ",
        "v                       ",
        "v                       ",
        "v                       ",
        "v                       ",
        "v                       ",
        "v                       ",
        "v                       ",
        "v                       ",
        "v                       ",
        "v                       "
      ],
      "terrain": { "v": "t_wall_wood", "!": "t_rdoor_c" }
    }
  },
  {
    "type": "mapgen",
    "method": "json",
    "nested_mapgen_id": "occupied_lum_wall_0_1",
    "object": {
      "mapgensize": [ 24, 24 ],
      "rows": [
        "v                       ",
        "v                       ",
        "v                       ",
        "v                       ",
        "v                       ",
        "v                       ",
        "v                       ",
        "v                       ",
        "v                       ",
        "v                       ",
        "v                       ",
        "v                       ",
        "v                       ",
        "v                       ",
        "v                       ",
        "v                       ",
        "v                       ",
        "v                       ",
        "v                       ",
        "v                       ",
        "v                       ",
        "v                       ",
        "v                       ",
        "vvvvvvvvv      vvvvvvvvv"
      ],
      "terrain": { "v": "t_wall_wood", "!": "t_rdoor_c" }
    }
  },
  {
    "type": "mapgen",
    "method": "json",
    "nested_mapgen_id": "occupied_lum_wall_1_0",
    "object": {
      "mapgensize": [ 24, 24 ],
      "rows": [
        "      vvvvv!vvvvvvvvvvvv",
        "                       v",
        "                       v",
        "                       v",
        "                       v",
        "                       v",
        "                       v",
        "                       v",
        "                       v",
        "                       v",
        "                       v",
        "                       v",
        "                       v",
        "                       v",
        "                       v",
        "                       v",
        "                       v",
        "                       v",
        "                       v",
        "                       v",
        "                       v",
        "                       v",
        "                       v",
        "                       v"
      ],
      "terrain": { "v": "t_wall_wood", "!": "t_rdoor_c" }
    }
  },
  {
    "type": "mapgen",
    "method": "json",
    "nested_mapgen_id": "occupied_lum_wall_1_1",
    "object": {
      "mapgensize": [ 24, 24 ],
      "rows": [
        "                       v",
        "                       v",
        "                       v",
        "                       v",
        "                       v",
        "                       v",
        "                       v",
        "                       v",
        "                       v",
        "                        ",
        "                        ",
        "                        ",
        "                        ",
        "                        ",
        "                        ",
        "                       v",
        "                       v",
        "                       v",
        "                       v",
        "                       v",
        "                       v",
        "                       v",
        "                       v",
        "vvvvvvvvv      vvvvvvvvv"
      ],
      "terrain": { "v": "t_wall_wood", "!": "t_rdoor_c" }
    }
  },
  {
    "type": "mapgen",
    "method": "json",
    "nested_mapgen_id": "occupied_lum_hotel_1_1",
    "object": {
      "mapgensize": [ 24, 24 ],
      "rows": [
        "                        ",
        "                        ",
        "                        ",
        "                        ",
        "                        ",
        "                        ",
        "                        ",
        "                        ",
        "                        ",
        "                        ",
        "                        ",
        "                        ",
        "                        ",
        "                        ",
        "                        ",
        "             vvvv!0vvv  ",
        "             vb!...!bv  ",
        "             vvv...vvv  ",
        "             vb!...!bv  ",
        "             vvv...vvv  ",
        "             vb!...!bv  ",
        "             vvvv0vvvv  ",
        "                        ",
        "                        "
      ],
      "terrain": { "v": "t_wall_wood", "!": "t_door_c", ".": "t_floor", "b": "t_floor", "0": "t_window" },
      "furniture": { "b": "f_makeshift_bed" }
    }
  },
  {
    "type": "mapgen",
    "method": "json",
    "nested_mapgen_id": "occupied_lum_hotel_roof_1_1",
    "object": {
      "mapgensize": [ 24, 24 ],
      "rows": [
        "                        ",
        "                        ",
        "                        ",
        "                        ",
        "                        ",
        "                        ",
        "                        ",
        "                        ",
        "                        ",
        "                        ",
        "                        ",
        "                        ",
        "                        ",
        "                        ",
        "                        ",
        "             .........  ",
        "             .........  ",
        "             .........  ",
        "             .........  ",
        "             .........  ",
        "             .........  ",
        "             .........  ",
        "                        ",
        "                        "
      ],
      "terrain": { ".": "t_flat_roof" }
    }
  }
]
