[
  {
    "type": "mapgen",
    "method": "json",
    "om_terrain": [ "outpost" ],
    "weight": 100,
    "object": {
      "fill_ter": "t_floor",
      "rows": [
        "|----------++----------|",
        "|                      |",
        "|   //////    /////    |",
        "|   /b.lb//;///&/&/    |",
        "|   /l......lb/*/*/    |",
        "|   /l........*.../    |",
        "|   /b.lblb.lb/T.S/    |",
        "|   ///////=///////    |",
        "|      /S....BB.ct/    |",
        "|      /X.......ct/    |",
        "|      /X.......ct/    |",
        "+      ;..........;    +",
        "+      /rrrrr...rr/    +",
        "|  ///////////;////    |",
        "|  /p../111/.....L/    |",
        "|  /...;...;.....L/    |",
        "|  /!!!/////.....L/    |",
        "|  /////22./.....L/    |",
        "|      /...x....../    |",
        "|      /22./6CCCCC/    |",
        "|      ////////////    |",
        "|                      |",
        "|                      |",
        "|----------++----------|"
      ],
      "terrain": {
        " ": "t_region_groundcover",
        "~": "t_gutter_downspout",
        ".": "t_floor",
        "-": "t_chainfence",
        "|": "t_chainfence",
        "/": "t_concrete_wall",
        "+": "t_chaingate_l",
        "*": "t_door_c",
        "=": "t_door_locked",
        ";": "t_door_metal_interior_locked",
        "6": "t_console",
        "p": "t_plut_generator",
        "x": "t_door_metal_locked"
      },
      "furniture": {
        "t": "f_table",
        "r": "f_rack",
        "c": "f_chair",
        "C": "f_counter",
        "X": "f_counter",
        "S": "f_sink",
        "1": "f_locker",
        "2": "f_utility_shelf",
        "!": "f_locker",
        "l": "f_locker",
        "L": "f_locker",
        "B": "f_bookcase",
        "b": "f_bunkbed",
        "T": "f_trashcan"
      },
      "items": {
        "B": { "item": "book_military", "chance": 50, "repeat": 3 },
        "b": { "item": "army_bed", "chance": 50, "repeat": 2 },
        "r": { "item": "mil_food", "chance": 50, "repeat": 2 },
        "t": { "item": "dining", "chance": 50 },
        "1": { "item": "cleaning", "chance": 75 },
        "2": [
          { "item": "energy_weapon_armory", "chance": 50, "repeat": 2 },
          { "item": "mil_armor_electronics", "chance": 75, "repeat": 2 },
          { "item": "pwr_armor", "chance": 50 },
          { "item": "pwr_armor_acc", "chance": 50, "repeat": 2 },
          { "item": "inactive_bots_milspec", "chance": 50 }
        ],
        "!": { "item": "hardware_plumbing", "chance": 75 },
        "L": [
          { "item": "guns_rifle_milspec", "chance": 75, "repeat": 2 },
          { "item": "grenades", "chance": 75, "repeat": 3 },
          { "item": "guns_launcher_milspec", "chance": 75 },
          { "item": "ammo_milspec", "chance": 75, "repeat": 10 },
          { "item": "mags_milspec", "chance": 75, "repeat": 2 }
        ],
        "X": { "item": "oven", "chance": 75, "repeat": 2 },
        "C": [
          { "item": "clothing_military_distribution", "chance": 75, "repeat": 2 },
          { "item": "military_ballistic_armor", "chance": 50, "repeat": 2 },
          { "item": "clothing_tactical_torso", "chance": 50 },
          { "item": "clothing_tactical_leg", "chance": 50 }
        ],
        "T": { "item": "trash_cart", "chance": 50 },
        "l": { "item": "bunker_basement_clothing", "chance": 50, "repeat": 2 }
      },
      "mapping": { " ": { "item": [ { "item": "corpse", "chance": 2 } ] } },
      "place_fields": [ { "field": "fd_blood", "x": [ 2, 21 ], "y": [ 2, 21 ], "repeat": [ 1, 12 ] } ],
      "toilets": { "&": {  } },
      "computers": {
        "6": {
          "name": "Experimental Weapons Storage",
          "access_denied": "ERROR!  Access denied!  Unauthorized access will be met with lethal force!",
          "security": 5,
          "failures": [ { "action": "alarm" }, { "action": "damage" }, { "action": "secubots" } ],
          "options": [ { "name": "Unlock Storage", "action": "unlock" } ]
        }
      },
      "place_monster": [
        { "group": "GROUP_MAYBE_MIL", "x": [ 6, 11 ], "y": [ 4, 5 ], "repeat": [ 1, 2 ] },
        { "group": "GROUP_MAYBE_MIL", "x": [ 9, 16 ], "y": [ 9, 11 ], "repeat": [ 2, 3 ] },
        { "group": "GROUP_MAYBE_MIL", "x": [ 12, 16 ], "y": [ 14, 19 ], "repeat": [ 2, 3 ] },
        { "group": "GROUP_ROBOTS_MIL", "x": [ 5, 6 ], "y": [ 14, 15 ] },
        { "group": "GROUP_ROBOTS_MIL", "x": [ 8, 10 ], "y": 15 },
        { "group": "GROUP_ROBOTS_MIL", "x": [ 8, 10 ], "y": 18 },
        { "group": "GROUP_ROBOTS_MIL", "x": [ 2, 6 ], "y": [ 8, 12 ] },
        { "group": "GROUP_ROBOTS_MIL", "x": [ 2, 6 ], "y": [ 18, 22 ] },
        { "monster": "mon_turret_medium", "x": 10, "y": 1 },
        { "monster": "mon_turret_longrange", "x": 13, "y": 1 },
        { "monster": "mon_turret_medium", "x": 1, "y": 10 },
        { "monster": "mon_turret_longrange", "x": 1, "y": 13 },
        { "monster": "mon_turret_medium", "x": 22, "y": 10 },
        { "monster": "mon_turret_longrange", "x": 22, "y": 13 },
        { "monster": "mon_turret_medium", "x": 10, "y": 22 },
        { "monster": "mon_turret_longrange", "x": 13, "y": 22 },
        { "monster": "mon_turret_searchlight", "x": 1, "y": 1 },
        { "monster": "mon_turret_searchlight", "x": 22, "y": 22 },
        { "monster": "mon_turret_searchlight", "x": 1, "y": 22 },
        { "monster": "mon_turret_searchlight", "x": 22, "y": 1 }
      ]
    }
  },
  {
    "type": "mapgen",
    "method": "json",
    "om_terrain": "outpost_roof",
    "object": {
      "fill_ter": "t_metal_floor_no_roof",
      "rows": [
        "                        ",
        "                        ",
        "    ......    .....     ",
        "    ...............     ",
        "    ..A.........=..     ",
        "    ...............     ",
        "    ............P..     ",
        "    ...............     ",
        "       ............     ",
        "       ............     ",
        "       ............     ",
        "       ............     ",
        "       ............     ",
        "   ................     ",
        "   ................     ",
        "   ................     ",
        "   ......R.R....X..     ",
        "   ................     ",
        "       ..R.R....X..     ",
        "       ............     ",
        "       ............     ",
        "                        ",
        "                        ",
        "                        "
      ],
      "palettes": [ "roof_palette" ],
      "terrain": {
        ".": "t_metal_floor_no_roof",
        "=": "t_metal_floor_no_roof",
        "A": "t_metal_floor_no_roof",
        "R": "t_radio_tower",
        "X": "t_metal_floor_no_roof"
      },
      "furniture": { "P": "f_water_purifier" }
    }
  },
  {
    "type": "mapgen",
    "method": "json",
    "om_terrain": [ "outpost_1" ],
    "weight": 100,
    "object": {
      "fill_ter": "t_floor",
      "rows": [
        "|----------++----------|",
        "|                      |",
        "|                      |",
        "|     /////;//////     |",
        "|     /b.....bllb/     |",
        "|     /l.dc....../     |",
        "|     /l.....bllb/     |",
        "|     /b........./     |",
        "|  //////*/../*/*////  |",
        "|  /XXXf../TS/&/&/11/  |",
        "|  /...../////////../  |",
        "+  ;...../...!/rrr..;  +",
        "+  /...../p..!/r..../  +",
        "|  /ccc..///;//r...r/  |",
        "|  /tttT...=.....rrr/  |",
        "|  ///////////;//////  |",
        "|     /22/6.....L/     |",
        "|     /..x......L/     |",
        "|     /..x......L/     |",
        "|     /22/CCCCC.L/     |",
        "|     ////////////     |",
        "|                      |",
        "|                      |",
        "|----------++----------|"
      ],
      "terrain": {
        " ": "t_region_groundcover",
        "~": "t_gutter_downspout",
        ".": "t_floor",
        "-": "t_chainfence",
        "|": "t_chainfence",
        "/": "t_concrete_wall",
        "+": "t_chaingate_l",
        "*": "t_door_c",
        "=": "t_door_locked",
        ";": "t_door_metal_interior_locked",
        "6": "t_console",
        "p": "t_plut_generator",
        "x": "t_door_metal_locked"
      },
      "furniture": {
        "t": "f_table",
        "r": "f_rack",
        "c": "f_chair",
        "C": "f_counter",
        "X": "f_counter",
        "S": "f_sink",
        "1": "f_locker",
        "2": "f_utility_shelf",
        "!": "f_locker",
        "l": "f_locker",
        "L": "f_locker",
        "b": "f_bunkbed",
        "d": "f_desk",
        "f": "f_fridge",
        "T": "f_trashcan"
      },
      "items": {
        "b": { "item": "army_bed", "chance": 60 },
        "d": { "item": "office", "chance": 50, "repeat": 2 },
        "f": { "item": "fridge", "chance": 50, "repeat": 5 },
        "r": { "item": "mil_food", "chance": 50, "repeat": 2 },
        "t": { "item": "dining", "chance": 50 },
        "1": { "item": "cleaning", "chance": 75 },
        "2": [
          { "item": "energy_weapon_armory", "chance": 50, "repeat": 2 },
          { "item": "mil_armor_electronics", "chance": 75, "repeat": 2 },
          { "item": "pwr_armor", "chance": 50 },
          { "item": "pwr_armor_acc", "chance": 50, "repeat": 2 },
          { "item": "inactive_bots_milspec", "chance": 50 }
        ],
        "!": { "item": "hardware_plumbing", "chance": 75 },
        "L": [
          { "item": "guns_rifle_milspec", "chance": 75, "repeat": 2 },
          { "item": "grenades", "chance": 75, "repeat": 3 },
          { "item": "guns_launcher_milspec", "chance": 75 },
          { "item": "ammo_milspec", "chance": 75, "repeat": 10 },
          { "item": "mags_milspec", "chance": 75, "repeat": 2 }
        ],
        "X": { "item": "oven", "chance": 75, "repeat": 2 },
        "C": [
          { "item": "clothing_military_distribution", "chance": 75, "repeat": 2 },
          { "item": "military_ballistic_armor", "chance": 50, "repeat": 2 },
          { "item": "clothing_tactical_torso", "chance": 50 },
          { "item": "clothing_tactical_leg", "chance": 50 }
        ],
        "T": { "item": "trash_cart", "chance": 50 },
        "l": { "item": "bunker_basement_clothing", "chance": 50, "repeat": 2 }
      },
      "mapping": { " ": { "item": [ { "item": "corpse", "chance": 2 } ] } },
      "place_fields": [ { "field": "fd_blood", "x": [ 2, 21 ], "y": [ 2, 21 ], "repeat": [ 1, 12 ] } ],
      "toilets": { "&": {  } },
      "computers": {
        "6": {
          "name": "Experimental Weapons Storage",
          "access_denied": "ERROR!  Access denied!  Unauthorized access will be met with lethal force!",
          "security": 5,
          "failures": [ { "action": "alarm" }, { "action": "damage" }, { "action": "secubots" } ],
          "options": [ { "name": "Unlock Storage", "action": "unlock" } ]
        }
      },
      "place_monster": [
        { "group": "GROUP_MAYBE_MIL", "x": [ 8, 13 ], "y": [ 4, 7 ], "repeat": [ 1, 2 ] },
        { "group": "GROUP_MAYBE_MIL", "x": [ 4, 8 ], "y": [ 10, 13 ], "repeat": [ 2, 3 ] },
        { "group": "GROUP_MAYBE_MIL", "x": [ 16, 18 ], "y": [ 12, 13 ], "repeat": [ 1, 2 ] },
        { "group": "GROUP_MAYBE_MIL", "x": [ 10, 15 ], "y": [ 16, 18 ], "repeat": [ 2, 3 ] },
        { "group": "GROUP_ROBOTS_MIL", "x": [ 11, 12 ], "y": [ 11, 12 ] },
        { "group": "GROUP_ROBOTS_MIL", "x": [ 7, 8 ], "y": [ 17, 18 ] },
        { "group": "GROUP_ROBOTS_MIL", "x": [ 3, 5 ], "y": [ 3, 7 ] },
        { "group": "GROUP_ROBOTS_MIL", "x": [ 18, 20 ], "y": [ 16, 20 ] },
        { "monster": "mon_turret_medium", "x": 10, "y": 1 },
        { "monster": "mon_turret_longrange", "x": 13, "y": 1 },
        { "monster": "mon_turret_medium", "x": 1, "y": 10 },
        { "monster": "mon_turret_longrange", "x": 1, "y": 13 },
        { "monster": "mon_turret_medium", "x": 22, "y": 10 },
        { "monster": "mon_turret_longrange", "x": 22, "y": 13 },
        { "monster": "mon_turret_medium", "x": 10, "y": 22 },
        { "monster": "mon_turret_longrange", "x": 13, "y": 22 },
        { "monster": "mon_turret_searchlight", "x": 1, "y": 1 },
        { "monster": "mon_turret_searchlight", "x": 22, "y": 22 },
        { "monster": "mon_turret_searchlight", "x": 1, "y": 22 },
        { "monster": "mon_turret_searchlight", "x": 22, "y": 1 }
      ]
    }
  },
  {
    "type": "mapgen",
    "method": "json",
    "om_terrain": "outpost_1_roof",
    "object": {
      "fill_ter": "t_metal_floor_no_roof",
      "rows": [
        "                        ",
        "                        ",
        "                        ",
        "      ............      ",
        "      ............      ",
        "      .........A..      ",
        "      ............      ",
        "      ......P..=..      ",
        "   ..................   ",
        "   ..................   ",
        "   ..................   ",
        "   ..................   ",
        "   ..................   ",
        "   ..................   ",
        "   ..................   ",
        "   ..................   ",
        "      ..R.R....X..      ",
        "      ............      ",
        "      ..R.R....X..      ",
        "      ............      ",
        "      ............      ",
        "                        ",
        "                        ",
        "                        "
      ],
      "palettes": [ "roof_palette" ],
      "terrain": {
        ".": "t_metal_floor_no_roof",
        "=": "t_metal_floor_no_roof",
        "A": "t_metal_floor_no_roof",
        "R": "t_radio_tower",
        "X": "t_metal_floor_no_roof"
      },
      "furniture": { "P": "f_water_purifier" }
    }
  }
]
