[
	{
		"type": "mapgen",
		"method": "json",
		"om_terrain": [ [ "vending_park_1", "vending_park_2" ] ],
		"weight": 100,
		"object": {
		  "fill_ter": "t_sidewalk",
		  "rows": [
			"'''''''''''''''''KKKKKKKKKKKKKK'''''''''''''''''",
			"'''''''''''''''''KKKKKKKKKKKKKK'''''''''''''''''",
			"'''''''''''''''''KKKEKKKKKKEKKK'''''''''''''''''",
			"'''[[[[[[[[[[[[[[[[[[DD[[DD[[[[[[[[[[[[[[[[[['''",
			"'''[KKKKKBBBKKKBBBKKXKKKKKKXKKBBBKKKKKKKKKKK['''",
			"'''[KKKKKKKKKKKKKKKKKKKKKKKKKKKKKKKKKjjKyKKK['''",
			"'''[KK1QKKKKKKKKKKKKKQzKKzQKKKKKKKKQQQQQQHKK['''",
			"'''[KKbF-/nk(e<v}r=n3FzKKzQn67rs!@^QnkJJGKKKD'''",
			"'''[KKbQQQQFQQQQQQFQQQcKKbQQQQQQFQQQqqqqGKKKD'''",
			"'''[KKbQ678s!@^-s=}(eQzKKbF(s<v8k3rQ{{qvGKKKD'''",
			"'''[KKzQKKKKKKKKKKKKKQyKKbQKKKKKKKKQQQQFQcKK['''",
			"'''[KKKKKKKKKKKKKKKKKKKKKKKKKKKKKKKKKKKKKKKK['''",
			"'''[KKKKKKKKKKKKKKKKKKKKKKKKKKKKKKKKKKKKKKKK['''",
			"'''[KKzQFQQQFKKKKKKKKQbKKyQKKKKKKKKKKKKKQzKK['''",
			"'''[KKzQqqqXQ<vk7r^36QbKKzQ763nk^rv<s(}=QbKK['''",
			"'''[KKK+qqq5QQQFQQQQQFbKKzQQQQQQQQQQQQQQFbKK['''",
			"'''[KKzQqxqqQn8s!@r-sQzKK1Qv<)(}=e-k@!98QbKK['''",
			"'''[KKzQQQFQQKKKKKKKKQzKKzQKKKKKKKKKKKKKQzKK['''",
			"'''[KKKyK{{KKKKKKKKKKKKKKKKKKKKKKKKKKKKKKKKK['''",
			"'''[KKKKKKKKKKKBBBKKXKKKKKKXKKBBBKKKBBBKKKKK['''",
			"'''[[[[[[[[[[[[[[[[[[[[[[[[[[[[[[[[[[[[[[[[[['''",
			"''''''''''''''''''''''''''''''''''''''''''''''''",
			"''''''''''''''''''''''''''''''''''''''''''''''''",
			"''''''''''''''''''''''''''''''''''''''''''''''''"
		  ],
		  "signs": { "E": { "signage": "Please be respectful of the machines! Automated security in use." } },
		  "graffiti": { "F": { "snippet": "general_graffiti_snippets" } },
		  "vendingmachines": {
			"}": { "item_group": "vending_adult" },
			"=": { "item_group": "vending_alcohol" },
			"/": { "reinforced": true, "item_group": "vending_ammo" },
			"6": { "item_group": "vending_bling" },
			"v": { "item_group": "vending_cars" },
			"N": { "item_group": "vending_clothes" },
			"<": { "item_group": "vending_drink" },
			")": { "reinforced": true, "item_group": "vending_bionics" },
			"(": { "item_group": "vending_electronics" },
			"-": { "item_group": "vending_grocery" },
			"^": { "item_group": "vending_useful" },
			"@": { "item_group": "vending_pet" },
			"!": { "item_group": "vending_fishing" },
			"9": { "reinforced": true, "item_group": "vending_medicine" },
			"8": { "item_group": "vending_maps" },
			"7": { "item_group": "vending_toys" },
			"3": { "item_group": "vending_smoking" },
			"e": { "item_group": "vending_sports" }
		  },
		  "items": {
			"%": { "item": "trash", "chance": 70, "repeat": [ 2, 7 ] },
			"&": { "item": "trash", "chance": 70, "repeat": [ 2, 7 ] },
			"T": [ { "item": "dining", "chance": 10, "repeat": [ 1, 2 ] }, { "item": "trash", "chance": 2 } ],
			"L": [ { "item": "dining", "chance": 10, "repeat": [ 1, 2 ] }, { "item": "trash", "chance": 2 } ],
			"X": { "item": "trash", "chance": 70, "repeat": [ 2, 7 ] },
			"J": { "item": "home_hw", "chance": 100 },
			"b": { "item": "trash", "chance": 2 },
			"{": { "item": "trash", "chance": 100, "repeat": [ 5, 25 ] }
		  },
		  "furniture": {
			"d": "f_region_weed",
			"5": "f_sink",
			"%": "f_trashcan",
			"f": "f_region_flower_decorative",
			"&": "f_trashcan",
			"'": [ [ "f_null", 40 ], "f_region_flower" ],
			"A": "f_statue",
			"B": "f_bench",
			"L": "f_table",
			"T": "f_table",
			"X": "f_trashcan",
			"Y": "f_brazier",
			"b": "f_bench",
			"0": [ [ "f_boulder_medium", 3 ], "f_boulder_large" ],
			"8": "f_vending_c",
			"x": "f_toilet",
			"{": "f_dumpster",
			"k": "f_arcade_machine",
			"n": "f_pinball_machine",
			"J": "f_utility_shelf",
			"6": "f_vending_c",
			"v": "f_vending_c",
			"<": "f_vending_c",
			")": "f_vending_reinforced",
			"(": "f_vending_c",
			"=": "f_vending_c",
			"}": "f_vending_c",
			"/": "f_vending_reinforced",
			"-": "f_vending_c",
			"^": "f_vending_c",
			"@": "f_vending_c",
			"!": "f_vending_c",
			"9": "f_vending_reinforced",
			"7": "f_vending_c",
			"3": "f_vending_c"
		  },
		  "terrain": {
			"+": "t_door_c",
			"#": "t_rock",
			"c": "t_region_tree",
			",": "t_region_groundcover_urban",
			"%": "t_sidewalk",
			".": "t_pavement",
			"&": "t_region_groundcover_urban",
			"'": "t_region_groundcover_urban",
			"1": [ [ "t_tree_young", 3 ], "t_region_shrub_decorative" ],
			"q": "t_concrete",
			"4": "t_region_tree_evergreen",
			"t": "t_region_tree_shade",
			"5": "t_thconc_floor",
			"u": "t_region_shrub",
			":": "t_thconc_floor",
			"z": "t_region_shrub_decorative",
			"A": "t_sidewalk",
			"B": "t_sidewalk",
			"C": "t_covered_well",
			"L": "t_thconc_floor",
			"P": "t_pavement_y",
			"Q": "t_concrete_wall",
			"T": "t_region_groundcover_urban",
			"W": "t_water_sh",
			"Y": "t_concrete",
			"Z": "t_region_shrub_fruit",
			"[": "t_chainfence",
			"]": "t_brick_wall",
			"_": "t_region_groundcover_urban",
			"`": "t_floor",
			"a": "t_region_tree_fruit",
			"b": "t_region_groundcover_urban",
			"p": "t_pavement",
			"s": "t_sidewalk",
			"|": "t_fence",
			"~": "t_water_pool_shallow",
			"j": "t_atm",
			"r": "t_slot_machine",
			"y": "t_gutter_downspout",
			"D": "t_chaingate_c",
			"F": "t_concrete_wall",
			"G": "t_door_metal_locked",
			"H": "t_gates_mech_control",
			"K": "t_sidewalk",
			"M": "t_sidewalk",
			"N": "t_sidewalk"
		  }
		}
	  },
	  {
		"type": "mapgen",
		"method": "json",
		"om_terrain": [ [ "vending_park_roof_1", "vending_park_roof_2" ] ],
		"weight": 100,
		"object": {
		  "fill_ter": "t_open_air",
		  "rows": [
			"                                                ",
			"                                                ",
			"                                                ",
			"                                                ",
			"                                                ",
			"                                                ",
			"       222222222222223    222222222222225       ",
			"       |.............3    |.............3       ",
			"       |...........:.3    |...........&.3       ",
			"       |.............3    |.............3       ",
			"       --------------5    --------------3       ",
			"                                                ",
			"                                                ",
			"       222222222222223    522222222222223       ",
			"       |.............3    |.............3       ",
			"       |.=...........3    |.............3       ",
			"       |.............3    |.............3       ",
			"       5-------------3    --------------3       ",
			"                                                ",
			"                                                ",
			"                                                ",
			"                                                ",
			"                                                ",
			"                                                "
		  ],
		  "toilets": { "T": {  } },
		  "furniture": {
			"s": "f_sofa",
			"c": "f_counter",
			"&": "f_roof_turbine_vent",
			":": "f_cellphone_booster",
			"r": "f_rack",
			"t": "f_table",
			"=": "f_vent_pipe",
			"A": "f_air_conditioner",
			"C": [ "f_crate_c", "f_cardboard_box" ],
			"L": "f_locker",
			"X": "f_small_satelitte_dish",
			"Y": "f_stool",
			"b": "f_bench",
			"y": [ "f_indoor_plant_y", "f_indoor_plant" ],
			"N": "f_TV_antenna",
			"F": "f_fridge",
			"S": "f_sink",
			"e": "f_oven",
			"~": "f_chimney"
		  },
		  "terrain": {
			" ": "t_open_air",
			"3": "t_gutter_east",
			"&": "t_flat_roof",
			":": "t_flat_roof",
			"=": "t_flat_roof",
			"#": "t_grate",
			".": "t_flat_roof",
			"5": "t_gutter_drop",
			"-": "t_gutter_south",
			"2": "t_gutter_north",
			"4": "t_gutter_downspout",
			"_": "t_floor",
			"o": "t_glass_roof",
			"|": "t_gutter_west"
		  }
		}
	  }
]
