[
  {
    "type": "mapgen",
    "method": "json",
    "om_terrain": [ [ "vending_park_1", "vending_park_2" ] ],
    "object": {
      "fill_ter": "t_sidewalk",
      "rows": [
        "                 ..............                 ",
        "                 ..............                 ",
        "                 ...E......E...                 ",
        "   [[[[[[[[[[[[[[[[[[DD[[DD[[[[[[[[[[[[[[[[[[   ",
        "   [.....BBB...BBB..x......x..BBB...........[   ",
        "   [.................................jj.^...[   ",
        "   [..1|.............|z..z|........||||||H..[   ",
        "   [..bFλγnkκσθεαrβnςFz..z|nδρrηξνμ|NKJJG...D   ",
        "   [..b||||F||||||F|||c..b||||||F|||''''G...D   ",
        "   [..b|δρπηξνμληβακσ|z..bFκηθεπkςr|}}'ζG...D   ",
        "   [..z|.............|^..b|........||||F|c..[   ",
        "   [........................................[   ",
        "   [........................................[   ",
        "   [..z|F|||F........|b..^|.............|z..[   ",
        "   [...|'''y|θεkρrμςδ|b..z|ρδςnkμrεθηκαβ|b..[   ",
        "   [...+'''S|||F|||||Fb..z||||||||||||||Fb..[   ",
        "   [...|'t''|nπηξνrλη|z..1|εθικαβσλkνξοπ|b..[   ",
        "   [..z|||F||........|z..z|.............|z..[   ",
        "   [...^.{{.................................[   ",
        "   [...........BBB..x......x..BBB...BBB.....[   ",
        "   [[[[[[[[[[[[[[[[[[[[[[[[[[[[[[[[[[[[[[[[[[   ",
        "                                                ",
        "                                                ",
        "                                                "
      ],
      "terrain": {
        " ": "t_region_groundcover_urban",
        "b": "t_region_groundcover_urban",
        "1": [ [ "t_tree_young", 3 ], "t_region_shrub_decorative" ],
        "z": "t_region_shrub_decorative",
        "c": "t_region_tree",
        ".": "t_sidewalk",
        "|": "t_concrete_wall",
        "F": "t_concrete_wall",
        "+": "t_door_c",
        "^": "t_gutter_downspout",
        "S": "t_thconc_floor",
        "'": "t_thconc_floor",
        "t": "t_thconc_floor",
        "J": "t_thconc_floor",
        "K": "t_thconc_floor",
        "N": "t_thconc_floor",
        "y": "t_thconc_floor",
        "}": "t_thconc_floor",
        "ζ": "t_thconc_floor",
        "[": "t_chainfence",
        "j": "t_atm",
        "r": "t_slot_machine",
        "D": "t_chaingate_c",
        "G": "t_door_metal_locked",
        "H": "t_gates_mech_control"
      },
      "furniture": {
        " ": [ [ "f_null", 40 ], "f_region_flower" ],
        "{": "f_dumpster",
        "}": "f_dumpster",
        "S": "f_sink",
        "B": "f_bench",
        "b": "f_bench",
        "x": "f_trashcan",
        "y": "f_trashcan",
        "J": "f_utility_shelf",
        "K": "f_arcade_machine",
        "k": "f_arcade_machine",
        "N": "f_pinball_machine",
        "n": "f_pinball_machine"
      },
      "toilets": { "t": {  } },
      "signs": { "E": { "signage": "Please be respectful of the machines! Automated security in use." } },
      "graffiti": { "F": { "snippet": "general_graffiti_snippets" } },
      "vendingmachines": {
        "α": { "item_group": "vending_adult" },
        "β": { "item_group": "vending_alcohol" },
        "γ": { "reinforced": true, "item_group": "vending_ammo" },
        "δ": { "item_group": "vending_bling" },
        "ε": { "item_group": "vending_cars" },
        "ζ": { "item_group": "vending_cars" },
        "η": { "item_group": "vending_clothes" },
        "θ": { "item_group": "vending_drink" },
        "ι": { "reinforced": true, "item_group": "vending_bionics" },
        "κ": { "item_group": "vending_electronics" },
        "λ": { "item_group": "vending_grocery" },
        "μ": { "item_group": "vending_useful" },
        "ν": { "item_group": "vending_pet" },
        "ξ": { "item_group": "vending_fishing" },
        "ο": { "reinforced": true, "item_group": "vending_medicine" },
        "π": { "item_group": "vending_maps" },
        "ρ": { "item_group": "vending_toys" },
        "ς": { "item_group": "vending_smoking" },
        "σ": { "item_group": "vending_sports" }
      },
      "items": {
        "x": { "item": "trash", "chance": 70, "repeat": [ 2, 7 ] },
        "y": { "item": "trash", "chance": 70, "repeat": [ 2, 7 ] },
        "J": { "item": "home_hw", "chance": 100 },
        "b": { "item": "trash", "chance": 2 },
        "{": { "item": "trash_dumpster", "chance": 80 },
        "}": { "item": "trash_dumpster", "chance": 80 }
      }
    }
  },
  {
    "type": "mapgen",
    "method": "json",
    "om_terrain": [ [ "vending_park_roof_1", "vending_park_roof_2" ] ],
    "object": {
      "fill_ter": "t_flat_roof",
      "rows": [
        "                                                ",
        "                                                ",
        "                                                ",
        "                                                ",
        "                                                ",
        "                                                ",
        "       ---------------    --------------5       ",
        "       -.............-    -.............-       ",
        "       -...........:.-    -...........&.-       ",
        "       -.............-    -.............-       ",
        "       --------------5    ---------------       ",
        "                                                ",
        "                                                ",
        "       ---------------    5--------------       ",
        "       -.............-    -.............-       ",
        "       -.=...........-    -.............-       ",
        "       -.............-    -.............-       ",
        "       5--------------    ---------------       ",
        "                                                ",
        "                                                ",
        "                                                ",
        "                                                ",
        "                                                ",
        "                                                "
      ],
      "palettes": [ "roof_palette" ]
    }
  }
]
