[
  {
	"type": "mapgen",
	"method": "json",
	"om_terrain": [ "s_vending_park" ],
	"weight": 100,
	"object": {
	  "fill_ter": "t_sidewalk",
	  "rows": [
		"GGGGGGG..........GGGGGGG",
		"G......................G",
		"G.---------++---------.G",
		"G.|.......P..T.......|.G",
		"G.|.sssss......sssss.|.G",
		"G.|..5s1........8s#..|.G",
		"G.|..4s2........9s$..|.G",
		"G.|..9s3........(s1..|.G",
		"G.|..6s5........!s*..|.G",
		"G.|..7sS........2s@..|.G",
		"G.|.sssssd....dsssss.|.G",
		"G.|..................|.G",
		"G.|..................|.G",
		"G.|.sssss......sssss.|.G",
		"G.|..Ss5........%s9..|.G",
		"G.|..1s6........*s4..|.G",
		"G.|..(s2........2s!..|.G",
		"G.|..3s7........@sS..|.G",
		"G.|..^s8........#s1..|.G",
		"G.|.sssssd....dsssss.|.G",
		"G.|.......&..&.......|.G",
		"G.--------------------.G",
		"G......................G",
		"GGGGGGGGGGGGGGGGGGGGGGGG"
	  ],
	  "terrain": {
		"&": "t_atm",
		"+": "t_chaingate_l",
		"-": "t_chainfence_h",
		"G": "t_grass",
		".": "t_sidewalk",
		"'": "t_pavement",
		"s": "t_little_column",
		"|": "t_chainfence_v",
		"S": "t_slot_machine",
		"d": "t_gutter_downspout"
	  },
	  "place_items": [
		{ "item": "trash", "x": [ 1, 23 ], "y": [ 1, 23 ], "chance": 100, "repeat": [ 5, 10 ] }
	  ],
	  "furniture": { "'": "f_street_light", "T": "f_trashcan" },
	  "signs": { "P": { "signage": "Please be respectful of the machines! Automated security in use." } },
	  "vendingmachines": {
		"1": { "item_group": "vending_drink" },
		"2": { "item_group": "vending_food" },
		"3": { "item_group": "vending_bling" },
		"4": { "item_group": "vending_clothes" },
		"5": { "item_group": "vending_useful" },
		"6": { "item_group": "vending_maps" },
		"7": { "item_group": "vending_toys" },
		"8": { "item_group": "vending_smoking" },
		"9": { "item_group": "vending_grocery" },
		"!": { "item_group": "vending_toys" },
		"@": { "item_group": "vending_adult" },
		"#": { "item_group": "vending_alcohol" },
		"*": { "item_group": "vending_electronics" },
		"(": { "item_group": "vending_cars" },
		"$": { "item_group": "vending_bionics", "reinforced": true },
		"%": { "item_group": "vending_medicine", "reinforced": true },
		"^": { "item_group": "vending_ammo", "reinforced": true }
	  }
	}
	},
	{
		"type": "mapgen",
		"method": "json",
		"om_terrain": [ "s_vending_park_roof" ],
		"object": {
		  "fill_ter": "t_open_air",
		  "rows": [
			"                        ",
			"                        ",
			"                        ",
			"                        ",
			"    ggggg      ggggg    ",
			"    g...g      g...g    ",
			"    g...g      g...g    ",
			"    g...g      g...g    ",
			"    g...g      g...g    ",
			"    g...g      g...g    ",
			"    ggggd      dgggg    ",
			"                        ",
			"                        ",
			"    ggggg      ggggg    ",
			"    g...g      g...g    ",
			"    g...g      g...g    ",
			"    g...g      g...g    ",
			"    g...g      g...g    ",
			"    g...g      g...g    ",
			"    ggggd      dgggg    ",
			"                        ",
			"                        ",
			"                        ",
			"                        "
		  ],
		  "terrain": { ".": "t_flat_roof", "g": "t_gutter", "d": "t_gutter_drop" }
		}
	  }
]
