[
  {
    "type": "mapgen",
    "method": "json",
    "om_terrain": [ "s_petstore" ],
    "weight": 500,
    "object": {
      "fill_ter": "t_floor",
      "rows": [
        "...........2rrrrrrrrrrr'",
        ".|--6666--|2yrrryrrryrrr",
        ".| 4      |2yrrryrrryrrr",
        ".|--  CC I72yrrryrrryrrr",
        ".| 4  CC I72yrrryrrryrrr",
        ".|--  CC I72yrrryrrryrrr",
        ".| 4      |2yyyyyyyyyyyy",
        ".|--    --|2222222222222",
        ".|      4 |....322223...",
        ".--+-11----------gg-|...",
        ".|          CCC7 oo |...",
        ".|     A  A    7 oo |...",
        ".|  A  A  A  A -6gg6|...",
        ".1  A  A  A  A   oo |...",
        ".|  A  A         oo 1...",
        ".|        dddd  dddd1...",
        ".1 K K L  d Fd  dF d|...",
        ".| K K L            ---.",
        ".|          CC  CC  AA|.",
        ".|+--+--              |.",
        ".| B| G|  KAAAAAAAAAAA|.",
        ".|------+-------------|.",
        ".....RrrrrrUUrrUrrrr....",
        ".....rrrrrrrUrrrrrrr...."
      ],
      "terrain": {
        " ": "t_floor",
        "+": "t_door_c",
        "-": "t_wall_w",
        ".": "t_grass",
        "1": "t_window",
        "2": "t_sidewalk",
        "3": "t_tree_young",
        "4": "t_chaingate_c",
        "5": "t_wall_wood",
        "6": "t_wall_glass_h",
        "7": "t_wall_glass_v",
        "'": "t_pavement",
        "g": "t_door_glass_c",
        "o": "t_carpet_green",
        "r": "t_pavement",
        "U": "t_pavement",
        "y": "t_pavement_y",
        "|": "t_wall_w",
        "R": "t_gutter_downspout"
      },
      "furniture": {
        "'": "f_street_light",
        "A": "f_rack",
        "C": "f_counter",
        "F": "f_chair",
        "G": "f_locker",
        "H": "f_table",
        "I": "f_sofa",
        "d": "f_desk",
        "K": "f_counter",
        "L": "f_counter",
        "U": [ "f_dumpster", "f_recycle_bin" ]
      },
      "toilets": { "B": {  } },
      "items": {
        "A": { "item": "petstore_shelves", "chance": 70, "repeat": [ 2, 8 ] },
        "L": { "item": "petstore_shelves", "chance": 70, "repeat": [ 2, 8 ] },
        "G": { "item": "cleaning", "chance": 70, "repeat": [ 1, 4 ] },
        "C": { "item": "petstore_misc", "chance": 70, "repeat": [ 2, 8 ] },
        "K": { "item": "petstore_misc", "chance": 70, "repeat": [ 2, 8 ] },
        "d": { "item": "office", "chance": 50, "repeat": [ 2, 4 ] },
        "U": { "item": "trash_dumpster", "chance": 80 }
      }
    }
  },
  {
    "type": "mapgen",
    "method": "json",
    "om_terrain": "s_petstore_roof",
    "object": {
      "fill_ter": "t_flat_roof",
      "rows": [
        "                        ",
        " ----------             ",
        " -........-             ",
        " -..U.....-             ",
        " -........-             ",
        " -........-             ",
        " -.....R..-             ",
        " -........-             ",
        " -........-             ",
        " -........-----------   ",
        " -..................-   ",
        " -..................-   ",
        " -..................-   ",
        " -..................-   ",
        " -..................-   ",
        " -..................-   ",
        " -..................-   ",
        " -..................--- ",
        " -....................- ",
        " -....................- ",
        " -....................- ",
        " ----5----------------- ",
        "                        ",
        "                        "
      ],
      "palettes": [ "roof_palette" ],
      "nested": { "U": { "chunks": [ "roof_2x2_infrastructure" ] }, "R": { "chunks": [ "roof_2x2_infrastructure_1" ] } },
      "place_nested": [
        {
          "chunks": [
            [ "null", 20 ],
            [ "roof_2x2_utilities_b", 15 ],
            [ "roof_2x2_utilities_c", 5 ],
            [ "roof_2x2_utilities_d", 40 ],
            [ "roof_2x2_utilities", 50 ]
          ],
          "x": [ 5, 15 ],
          "y": 18
        },
        {
          "chunks": [ [ "null", 20 ], [ "roof_4x4_utility", 40 ], [ "roof_6x6_utility", 20 ] ],
          "x": [ 5, 12 ],
          "y": 11
        }
      ]
    }
  },
  {
    "type": "mapgen",
    "method": "json",
    "om_terrain": "s_petstore_1",
    "object": {
      "fill_ter": "t_floor",
      "rows": [
        "sssssssssssssssssssssss'",
        "ssssssssssssssssssssssss",
        " ||||www||ss||wwww||||| ",
        " |CCW...^|ss|^.....-ff| ",
        " |CC+....|++|......#..| ",
        " |---..............#A.| ",
        " |CCW..............#..| ",
        " |CC+...{.{........-D-| ",
        " |---...{.{...........| ",
        " |CCW...{.{...}.}.}.}.| ",
        " |CCW...{.{...}.}.}.}.| ",
        " |CC+...{.{...........| ",
        " |---...{.{...{{{{{{{{| ",
        " |CCW...{.{...--------| ",
        " |CCW.................| ",
        " |CC+.................| ",
        " |||||||||||||b||-...-| ",
        "   cddddddd4|T.&|l....| ",
        "   cdddddddd|||||l...&| ",
        "   cdddddddddcdd|.....| ",
        "   cdddddddddaddb....&| ",
        "   cdddddddddcdd|.....| ",
        "   ccccccccccccc||||||| ",
        "                        "
      ],
      "terrain": {
        "+": "t_door_glass_c",
        "-": "t_wall_w",
        ".": "t_floor",
        "C": "t_thconc_floor",
        "D": "t_door_c",
        "W": "t_wall_glass",
        " ": "t_region_groundcover_urban",
        "'": "t_sidewalk",
        "a": "t_chaingate_c",
        "b": "t_door_locked",
        "c": "t_chainfence",
        "d": "t_region_soil",
        "s": "t_sidewalk",
        "w": "t_wall_glass_alarm",
        "|": "t_brick_wall",
        "4": "t_gutter_downspout"
      },
      "furniture": {
        "'": "f_street_light",
        "#": "f_counter",
        "&": "f_sink",
        "^": "f_indoor_plant",
        "{": "f_rack",
        "f": "f_filing_cabinet",
        "A": "f_stool",
        "l": "f_locker",
        "}": "f_counter"
      },
      "toilets": { "T": {  } },
      "place_item": [
        { "item": "pet_carrier", "x": 8, "y": 14 },
        { "item": "pet_carrier", "x": 10, "y": 14 },
        { "item": "bathroom_scale", "x": 21, "y": 19 }
      ],
      "place_items": [
        { "chance": 15, "item": "vet_softdrug", "x": 21, "y": 6 },
        { "chance": 30, "item": "vet_utility", "x": [ 20, 21 ], "y": 3 }
      ],
      "items": {
        "{": { "item": "petstore_shelves", "chance": 70, "repeat": [ 2, 8 ] },
        "}": { "item": "petstore_misc", "chance": 70, "repeat": [ 2, 8 ] },
        "l": { "item": "SUS_janitors_closet", "chance": 100 },
        "T": { "item": "softdrugs", "chance": 30 }
      },
      "place_monster": [
        { "monster": "mon_cat", "x": 2, "y": 3 },
        { "monster": "mon_rabbit", "x": 2, "y": 7 },
        { "monster": "mon_rabbit", "x": 3, "y": 7 },
        { "monster": "mon_dog_zombie_rot", "x": 2, "y": 9 },
        { "monster": "mon_dog", "x": 2, "y": 13 },
        { "monster": "mon_dog", "x": 2, "y": 15 },
        { "monster": "mon_dog_zombie_rot", "x": 10, "y": 19 }
      ]
    }
  },
  {
    "type": "mapgen",
    "method": "json",
    "om_terrain": "s_petstore_roof_1",
    "object": {
      "fill_ter": "t_flat_roof",
      "rows": [
        "                        ",
        "                        ",
        " ---------  ----------- ",
        " -.......-  -.........- ",
        " -.......----.........- ",
        " -....................- ",
        " -....................- ",
        " -....................- ",
        " -....................- ",
        " -....................- ",
        " -....................- ",
        " -....................- ",
        " -....................- ",
        " -....................- ",
        " -....................- ",
        " -....................- ",
        " -----------5....R....- ",
        "            -.........- ",
        "            -----.....- ",
        "                -.....- ",
        "                -..U..- ",
        "                -.....- ",
        "                ------- ",
        "                        "
      ],
      "palettes": [ "roof_palette" ],
      "nested": { "U": { "chunks": [ "roof_2x2_infrastructure" ] }, "R": { "chunks": [ "roof_2x2_infrastructure_1" ] } },
      "place_nested": [
        {
          "chunks": [
            [ "null", 20 ],
            [ "roof_2x2_utilities_b", 15 ],
            [ "roof_2x2_utilities_c", 5 ],
            [ "roof_2x2_utilities_d", 40 ],
            [ "roof_2x2_utilities", 50 ],
            [ "roof_4x4_utility", 40 ],
            [ "roof_6x6_utility", 20 ]
          ],
          "x": [ 5, 15 ],
          "y": [ 6, 8 ]
        }
      ]
    }
  },
  {
    "type": "mapgen",
    "method": "json",
    "om_terrain": "s_petstore_2",
    "object": {
      "fill_ter": "t_floor",
      "rows": [
        "           pppssppp    '",
        "  9    9   p9psspKppppp ",
        "     9     pppssp|||--||",
        "    uuuuuuuu  ss |HH..^|",
        " ||----------|++||.....|",
        " |....^|^...&-..-....^&|",
        " |.....|.....-..-...||||",
        " |.....#.....|++|...-..|",
        " |l.|.a#............+..|",
        " |l.|..#............||||",
        " |l.|..#............-..|",
        " |l.|..#...{..{..b..+..|",
        " ||||..|...{..{..b..||||",
        " |.....|...{..{.....-..|",
        " |....&|...{..{..b..+..|",
        " ||D||||...{..{..b..||||",
        " |....................S|",
        " |....................#|",
        " ||D||e|||||||||||||||||",
        " |t.|...a&HH|ddddddddddc",
        "4|..|.......Dddddddddddc",
        " |#S|YYG....|ddddddddddc",
        " ||||||||w|||ccccccccccc",
        "                        "
      ],
      "terrain": {
        "+": "t_door_glass_c",
        " ": "t_region_groundcover_urban",
        "'": "t_region_groundcover_urban",
        "p": "t_region_groundcover_urban",
        "K": "t_region_groundcover_urban",
        "-": "t_wall_glass",
        ".": "t_floor",
        "D": "t_door_c",
        "c": "t_chainfence",
        "d": "t_region_soil",
        "e": "t_door_c_peep",
        "s": "t_sidewalk",
        "u": "t_region_shrub_decorative",
        "w": "t_window",
        "|": "t_brick_wall",
        "4": "t_gutter_downspout",
        "9": "t_region_tree"
      },
      "furniture": {
        "'": "f_street_light",
        "#": "f_counter",
        "&": "f_trashcan",
        "H": "f_sofa",
        "S": "f_sink",
        "^": "f_indoor_plant",
        "a": "f_chair",
        "b": "f_bench",
        "l": "f_locker",
        "Y": "f_locker",
        "G": "f_locker",
        "p": "f_region_flower",
        "{": "f_rack",
        "K": "f_birdbath"
      },
      "toilets": { "t": {  } },
      "place_items": [
        { "chance": 55, "item": "clothing_outdoor_torso", "x": [ 5, 6 ], "y": 21 },
        { "chance": 70, "repeat": [ 1, 2 ], "item": "vet_softdrug", "x": 2, "y": [ 8, 10 ] },
        { "chance": 55, "item": "trash", "x": 6, "y": 14 },
        { "chance": 55, "item": "trash", "x": 12, "y": 5 },
        { "chance": 20, "item": "vet_hardrug", "x": 2, "y": 11 },
        { "chance": 85, "repeat": [ 1, 4 ], "item": "vet_utility", "x": 14, "y": 14 },
        { "chance": 85, "repeat": [ 1, 4 ], "item": "vet_utility", "x": 14, "y": 12 },
        { "chance": 85, "repeat": [ 1, 4 ], "item": "vet_utility", "x": 11, "y": [ 11, 12 ] },
        { "chance": 70, "repeat": [ 1, 6 ], "item": "magazines", "x": 7, "y": 11 }
      ],
      "items": {
        "{": { "item": "petstore_shelves", "chance": 70, "repeat": [ 1, 4 ] },
        "G": { "item": "cleaning", "chance": 70, "repeat": [ 1, 4 ] },
        "l": { "item": "petstore_misc", "chance": 70, "repeat": [ 1, 4 ] },
        "#": { "item": "office", "chance": 80, "repeat": [ 2, 4 ] },
        "Y": [ { "item": "jackets", "chance": 10 }, { "item": "bags", "chance": 10 } ]
      },
      "place_monster": [
        { "monster": "mon_dog_zombie_rot", "x": 21, "y": 7 },
        { "monster": "mon_dog_skeleton", "x": 22, "y": 7 },
        { "monster": "mon_dog", "x": 22, "y": 10 },
        { "monster": "mon_dog", "x": 22, "y": 11 },
        { "monster": "mon_cat", "x": 21, "y": 13 },
        { "monster": "mon_cat", "x": 22, "y": 13 },
        { "monster": "mon_dog_zombie_rot", "x": 14, "y": 19 },
        { "monster": "mon_dog_zombie_rot", "x": 20, "y": 21 }
      ]
    }
  },
  {
    "type": "mapgen",
    "method": "json",
    "om_terrain": "s_petstore_roof_2",
    "object": {
      "fill_ter": "t_flat_roof",
      "rows": [
        "                        ",
        "                        ",
        "                 -------",
        "                 -.....-",
        " -----------------..U..-",
        " -.....................-",
        " -.....................-",
        " -.....................-",
        " -.....................-",
        " -.....................-",
        " -.....................-",
        " -.....................-",
        " -.....................-",
        " -.....................-",
        " -.....................-",
        " -.....................-",
        " -.....................-",
        " -.....................-",
        " -..........------------",
        " -..........-           ",
        " 5....R.....-           ",
        " -..........-           ",
        " ------------           ",
        "                        "
      ],
      "palettes": [ "roof_palette" ],
      "nested": { "U": { "chunks": [ "roof_2x2_infrastructure" ] }, "R": { "chunks": [ "roof_2x2_infrastructure_1" ] } },
      "place_nested": [
        {
          "chunks": [
            [ "null", 20 ],
            [ "roof_2x2_utilities_b", 15 ],
            [ "roof_2x2_utilities_c", 5 ],
            [ "roof_2x2_utilities_d", 40 ],
            [ "roof_2x2_utilities", 50 ],
            [ "roof_4x4_utility", 40 ],
            [ "roof_6x6_utility", 20 ]
          ],
          "x": [ 5, 15 ],
          "y": [ 6, 9 ]
        }
      ]
    }
  }
]
