[
  {
    "type": "mapgen",
    "method": "json",
    "om_terrain": [ [ "power_plant_small_1", "power_plant_small_2" ] ],
    "weight": 250,
    "object": {
      "fill_ter": "t_floor",
      "rows": [
        "|||_,,,,,,,pp,,,,,,,_|||||||||||||||||||||||||||",
        "|  _,,,,,,,,,,,,,,,,_                          |",
        "|  _,ppppp,pp,,,,,,,_    ####WWW#######WWW#### |",
        "| ?_,,,,,,,,,,,,,,,,_?   #vV.ccc..f#.d..h..d.#9|",
        "|___,,,,,,,,,,,,,,,,____ W........s#h6.666.6hW |",
        "|,,,,,,,,,,,,,,,,,,,,,,_ W..ee....t#.........W |",
        "|,,,,,,,,,,,,,,,,,,,,,,_ #.heeh....#....t*FFF# |",
        "|,,,,,,,,,,,,,,,,,,,,,,_ #######++###++####### |",
        "|,,,,,,,,,,,,,,,,,,,,,,_ #T.sE#.........bbbbb# |",
        "|,,,,,,,,,,,,,,,,,,,,,,_ #....+..............# |",
        "|ppppppp,,,,,,,,ppppppp_ #t...#..............# |",
        "|,,,,,,,,,,,,,,,,,,,,,,_ #######++###++###++## |",
        "|,,,,,,,,,,,,,,,,,,,,,,_ #..d......#....#;;;;# |",
        "|,,,,,,,,,,,,,,,,,,,,,,_ W.hd......#l..l#;;;8# |",
        "|,,,,,,,,,,,,,,,,,,,,,,_ W.dd......#l..l#;;;a# |",
        "|,,,,,,,,,,,,,,,,,,,,,,_ #.........#l..l#;;;;# |",
        "|ppppppp,,,,,,,,ppppppp_ ##WWWW#++#######;;;r# |",
        "|,,,,,,,,,,,,,,,,,,,,,,___________ | #w;;;;;r# |",
        "|,,,,,,,,,,,,,,,,,,,,,,___________ | #2;;;;;r# |",
        "|,,,,,,,,,,,,,,,,,,,,,,_           | #4;;;;;r# |",
        "|,,,,,,,,,,,,,,,,,,,,,,_          A| #7;;;;;r# |",
        "|,,,,,,,,,,,,,,,,,,,,,,_          A| #;;;;;;;# |",
        "|___,,,,,,,pp,,,,,,,____          A| ##WW#++## |",
        "| ?_,,,,,,,,,,,,,,,,_?             |      __   |"
      ],
      "palettes": [ "power_plant_palette" ],
      "terrain": { "V": "t_floor" },
      "mapping": {
        "l": { "items": { "item": "clothing_work_set", "chance": 50, "repeat": 2 } },
        "r": { "items": { "item": "hardware", "chance": 25, "repeat": 3 } }
      },
      "toilets": { "T": {  } },
      "vendingmachines": { "v": { "item_group": "vending_drink" }, "V": { "item_group": "vending_food" } },
      "place_signs": [ { "signage": "<city> power station", "x": 24, "y": 19 } ],
      "place_vehicles": [
        { "vehicle": "parkinglotbasic", "x": 3, "y": 8, "chance": 25, "rotation": 180 },
        { "vehicle": "parkinglotbasic", "x": 3, "y": 14, "chance": 25, "rotation": 180 },
        { "vehicle": "parkinglotbasic", "x": 3, "y": 20, "chance": 25, "rotation": 180 },
        { "vehicle": "parkinglotbasic", "x": 20, "y": 6, "chance": 25 },
        { "vehicle": "parkinglotbasic", "x": 20, "y": 12, "chance": 25 },
        { "vehicle": "parkinglotbasic", "x": 20, "y": 18, "chance": 25 }
      ],
      "place_monster": [
        { "group": "GROUP_INDUSTRIAL_CENTER", "x": [ 1, 23 ], "y": [ 1, 23 ], "repeat": [ 10, 15 ] },
        { "group": "GROUP_INDUSTRIAL_CENTER", "x": [ 26, 44 ], "y": [ 3, 21 ], "repeat": [ 10, 15 ] }
      ]
    }
  },
  {
    "type": "mapgen",
    "method": "json",
    "om_terrain": [ "power_plant_small_3" ],
    "weight": 250,
    "//": "Coal variant.",
    "object": {
      "fill_ter": "t_floor",
      "rows": [
        "||||GGGGGGGGGGGGGGGG||||",
        "|   ,,,,,,,,,,,,,,,,__  ",
        "|   p,,,,,,p,,,,,,,,__  ",
        "|   p,,,,,,p,,,,,,,,__  ",
        "|   p,,,,,,p,,,,,,,,____",
        "| ::::::::::::      ____",
        "| :::--!!--:::##WWW#++##",
        "| :::-!!!!-:::#;;;;;;;;;",
        "| :::-!!!!-:::#;;;;;;;;;",
        "| :::-!!!!-:::#;;;;;&---",
        "| :::-!!!!-:::#;;311&-!-",
        "| :::-=--=-:::#;;;;;&---",
        "| ::::1::1::::#6;;;;;;T;",
        "| ::::1::1::::#6h;;;;;;;",
        "| ::::1::1::::#6h;;;;;;;",
        "| ::::2222111X#6;;;;;;T;",
        "| ::::3223::::#;;;;;&---",
        "| ::::3223::::#;;311&-!-",
        "| ::::2222111X#;;;;;&---",
        "| ::::::::::::#;;;;;;;;;",
        "| ::::::::::::#rrr;;;;;;",
        "| ::::::::::::##########",
        "|                       ",
        "||||||||||||||||||||||||"
      ],
      "palettes": [ "power_plant_palette" ],
      "terrain": { "X": "t_grate", "T": "t_thconc_floor", "h": "t_thconc_floor" },
      "furniture": { "T": "f_standing_tank" },
      "mapping": { "r": { "items": { "item": "fireman_gear", "chance": 25, "repeat": 3 } } },
      "liquids": { "T": { "liquid": "water", "amount": [ 0, 100 ] } },
      "place_loot": [ { "item": "coal_lump", "x": [ 6, 9 ], "y": [ 7, 10 ], "chance": 50, "repeat": 5 } ],
      "place_monster": [ { "group": "GROUP_INDUSTRIAL_CENTER", "x": [ 1, 19 ], "y": [ 1, 22 ], "repeat": [ 10, 15 ] } ]
    }
  },
  {
    "type": "mapgen",
    "method": "json",
    "om_terrain": [ "power_plant_small_3" ],
    "weight": 250,
    "//": "Natural gas variant, with a chance of a gas explosion and fire.",
    "object": {
      "fill_ter": "t_floor",
      "rows": [
        "||||GGGGGGGGGGGGGGGG||||",
        "|   ,,,,,,,,,,,,,,,,__  ",
        "|   p,,,,,,p,,,,,,,,__  ",
        "|   p,,,,,,p,,,,,,,,__  ",
        "|   p,,,,,,p,,,,,,,,____",
        "| ::::::::::::      ____",
        "| :::HNMM:::::##WWW#++##",
        "| :--------:::#;;;;;;;;;",
        "| :-IIIIHI-:::#;;;;;;;;;",
        "| :-I!I!!I--=-#;;;;;&---",
        "| :-I!I!!I!!!!#;;HII&-!-",
        "| :-I!I!!I!!!!#;;;;;&---",
        "| :-I!I!!IIII!#6;;;;;;T;",
        "| :-I!I!!I!!!!#6h;;;;;;;",
        "| :-!!I!!IIII!#6h;;;;;;;",
        "| :-!II!!I!!!!#6;;;;;;T;",
        "| :-!!!!!IIII!#;;;;;&---",
        "| :=!!!!!I!!!!#;;HII&-!-",
        "| :=!!!!!IIII!#;;;;;&---",
        "| :-!!!!!!!!!!#;;;;;;;;;",
        "| :-----------#rrr;;;;;;",
        "| ::::::::::::##########",
        "|                       ",
        "||||||||||||||||||||||||"
      ],
      "palettes": [ "power_plant_palette" ],
      "terrain": { "H": "t_sewage_pump", "T": "t_thconc_floor", "h": "t_thconc_floor" },
      "furniture": { "T": "f_standing_tank" },
      "mapping": { "r": { "items": { "item": "fireman_gear", "chance": 25, "repeat": 3 } } },
      "liquids": { "T": { "liquid": "water", "amount": [ 0, 100 ] } },
      "place_nested": [ { "chunks": [ "null", "power_plant_7x7_incident_fire" ], "x": [ 1, 9 ], "y": [ 5, 15 ] } ],
      "place_monster": [ { "group": "GROUP_INDUSTRIAL_CENTER", "x": [ 1, 19 ], "y": [ 1, 22 ], "repeat": [ 10, 15 ] } ]
    }
  },
  {
    "type": "mapgen",
    "method": "json",
    "om_terrain": [ "power_plant_small_3" ],
    "weight": 125,
    "//": "Petroleum variant.",
    "object": {
      "fill_ter": "t_floor",
      "rows": [
        "||||GGGGGGGGGGGGGGGG||||",
        "|   ,,,,,,,,,,,,,,,,__  ",
        "|   p,,,,,,p,,,,,,,,__  ",
        "|   p,,,,,,p,,,,,,,,__  ",
        "|   p,,,,,,p,,,,,,,,____",
        "| ::::::::::::      ____",
        "| ::::::::33::##WWW#++##",
        "| ::::::::33::#;;;;;;;;;",
        "| :::---::I:::#;;;;;;;;;",
        "| ::--'--:I:::#;;;;;&---",
        "| ::-'''-II:::#;;HII&-!-",
        "| ::--'--:I:::#;;;;;&---",
        "| :::---::I:::#6;;;;;;T;",
        "| ::::::::I:::#6h;;;;;;;",
        "| :::-----I:::#6h;;;;;;;",
        "| ::--'''--:::#6;;;;;;T;",
        "| ::-'''''-:::#;;;;;&---",
        "| ::-'''''-:::#;;HII&-!-",
        "| ::-'''''-:::#;;;;;&---",
        "| ::--'''--:::#;;;;;;;;;",
        "| :::-----::::#rrr;;;;;;",
        "| ::::::::::::##########",
        "|                       ",
        "||||||||||||||||||||||||"
      ],
      "palettes": [ "power_plant_palette" ],
      "terrain": { "'": "t_metal_floor", "3": "t_gas_tank", "H": "t_sewage_pump", "T": "t_thconc_floor", "h": "t_thconc_floor" },
      "furniture": { "T": "f_standing_tank" },
      "mapping": { "r": { "items": { "item": "fireman_gear", "chance": 25, "repeat": 3 } } },
      "liquids": { "T": { "liquid": "water", "amount": [ 0, 100 ] } },
      "place_loot": [ { "group": "fuel_barrel", "x": [ 2, 9 ], "y": [ 5, 7 ], "chance": 50, "repeat": 5 } ],
      "place_monster": [ { "group": "GROUP_INDUSTRIAL_CENTER", "x": [ 11, 19 ], "y": [ 1, 22 ], "repeat": [ 10, 15 ] } ]
    }
  },
  {
    "type": "mapgen",
    "method": "json",
    "om_terrain": [ "power_plant_small_3" ],
    "weight": 125,
    "//": "Geothermal with a chance of seismic-activity-induced Fun.",
    "//2": "Speculative, as of this comment (2023) geothermal power generation isn't utilized in New England, Enhanced Geothermal Systems using injection drilling are being considered though.",
    "object": {
      "fill_ter": "t_floor",
      "rows": [
        "||||GGGGGGGGGGGGGGGG||||",
        "|   ,,,,,,,,,,,,,,,,__  ",
        "|   p,,,,,,p,,,,,,,,__  ",
        "|   p,,,,,,p,,,,,,,,__  ",
        "|   p,,,,,,p,,,,,,,,____",
        "| ::::::::::::      ____",
        "| ::::::::::::##WWW#++##",
        "| :::--==--:::#;;;;;;;;;",
        "| :::-!!!!-:::#;;;;;;;;;",
        "| :::-H!!!-:::#;;;;;I---",
        "| :::-I!!!-:::#;;HIII-!-",
        "| :::-I22!-:::#;;;;;I---",
        "| :::-II2!-:::#6;;;;;:T;",
        "| :::------:::#6;;;;;;;;",
        "| ::::::::::::#6;;;;;;;;",
        "| ::::::::%%::#6;;;;;;T;",
        "| ::~I:HI:%%::#;;;;;I---",
        "| ::~I::::::::#;;HIII-!-",
        "| :~~I~~~~~~~:#;;;;;I---",
        "| :~~I~~~~~~~:#;;;;;;;;;",
        "| :~~~~~~~~~~:#rrr;;;;;;",
        "| ::::::::::::##########",
        "|                       ",
        "||||||||||||||||||||||||"
      ],
      "palettes": [ "power_plant_palette" ],
      "terrain": { "~": "t_water_dp", "%": "t_water_pump", "H": "t_sewage_pump", "T": "t_thconc_floor", "h": "t_thconc_floor" },
      "furniture": { "T": "f_standing_tank" },
      "mapping": { "r": { "items": { "item": "fireman_gear", "chance": 25, "repeat": 3 } } },
      "liquids": { "T": { "liquid": "water", "amount": [ 0, 100 ] } },
      "place_nested": [ { "chunks": [ "null", "power_plant_7x7_incident_lava" ], "x": [ 1, 9 ], "y": [ 5, 10 ] } ],
      "place_monster": [ { "group": "GROUP_INDUSTRIAL_CENTER", "x": [ 1, 19 ], "y": [ 1, 22 ], "repeat": [ 10, 15 ] } ]
    }
  },
  {
    "type": "mapgen",
    "method": "json",
    "om_terrain": [ "power_plant_small_4" ],
    "weight": 250,
    "object": {
      "fill_ter": "t_floor",
      "rows": [
        "||||||||||||      __   |",
        "                  __   |",
        "                  __   |",
        "                  __   |",
        "___________       __   |",
        "____________________   |",
        "#########___________   |",
        ";;;;;47;##WWWWWWW#++## |",
        ";;;;;;;;#..bbbbb.....# |",
        ";00;;;;;+............# |",
        "5003Z;;;+............# |",
        ";00;;;;;W............# |",
        ";;;;;;;;W....ddd66..6# |",
        ";;;;;;;;W....dh.h...6# |",
        ";;;;;;;;##++##.....h6# |",
        ";;;;;;;;# __ #FF*t..6#9|",
        ";00;;;XX# __ ##WWWWW## |",
        "5003Z;XX#::::::::::::  |",
        ";00;;;XX#:V::::::::::  |",
        ";;;;;;;Z#ZXC:Z::BVZ::P |",
        "rrrMM;;;#::N:::::::::  |",
        "#########        P     |",
        "                       |",
        "||||||||||||||||||||||||"
      ],
      "palettes": [ "power_plant_palette" ],
      "mapping": { "r": { "items": { "item": "supplies_electronics", "chance": 50, "repeat": 3 } } },
      "place_monster": [ { "group": "GROUP_INDUSTRIAL_CENTER", "x": [ 0, 22 ], "y": [ 0, 22 ], "repeat": [ 10, 15 ] } ]
    }
  },
  {
    "type": "mapgen",
    "method": "json",
    "om_terrain": "power_plant_small_2_roof",
    "weight": 250,
    "object": {
      "fill_ter": "t_flat_roof",
      "rows": [
        "                        ",
        "                        ",
        " |22222222222222222223  ",
        " |...................5  ",
        " |................XX.3  ",
        " |................XX.3  ",
        " |...................3  ",
        " |...................3  ",
        " |...................3  ",
        " |...................3  ",
        " |...................3  ",
        " |...................3  ",
        " |...................3  ",
        " |...................3  ",
        " |...................3  ",
        " |...................3  ",
        " |-----------|.......3  ",
        "             |.......3  ",
        "             |.......3  ",
        "             |.......3  ",
        "             |.......3  ",
        "             |.......3  ",
        "             |-------3  ",
        "                        "
      ],
      "palettes": [ "roof_palette" ],
      "terrain": { "X": "t_radio_tower" },
      "place_nested": [
        {
          "chunks": [
            [ "null", 20 ],
            [ "roof_2x2_utilities_b", 10 ],
            [ "roof_2x2_utilities_c", 10 ],
            [ "roof_2x2_utilities_d", 10 ],
            [ "roof_2x2_utilities", 10 ],
            [ "roof_4x4_utility", 20 ],
            [ "roof_4x4_utility_1", 20 ]
          ],
          "x": [ 14, 17 ],
          "y": [ 16, 18 ]
        }
      ]
    }
  },
  {
    "type": "mapgen",
    "method": "json",
    "om_terrain": [ [ "power_plant_small_3_roof", "power_plant_small_4_roof" ] ],
    "weight": 250,
    "object": {
      "fill_ter": "t_flat_roof",
      "rows": [
        "                                                ",
        "                                                ",
        "                                                ",
        "                                                ",
        "                                                ",
        "                                                ",
        "              |222222222222222223               ",
        "              |.................32222222222223  ",
        "              |..............................3  ",
        "              |......###.....................3  ",
        "              |......# #.....................3  ",
        "              |......###.....................3  ",
        "              |..............................3  ",
        "              |..............................3  ",
        "              |.................32222|.......3  ",
        "              |.................3    |.......5  ",
        "              |......###........3    |-------3  ",
        "              |......# #........3               ",
        "              |......###........3               ",
        "              |.................3               ",
        "              |.................3               ",
        "              |-----------------3               ",
        "                                                ",
        "                                                "
      ],
      "palettes": [ "roof_palette" ],
      "terrain": { "#": "t_wall_metal" },
      "place_nested": [
        {
          "chunks": [
            [ "null", 20 ],
            [ "roof_2x2_utilities_b", 10 ],
            [ "roof_2x2_utilities_c", 10 ],
            [ "roof_2x2_utilities_d", 10 ],
            [ "roof_2x2_utilities", 10 ],
            [ "roof_4x4_utility", 20 ],
            [ "roof_4x4_utility_1", 20 ]
          ],
          "x": [ 33, 41 ],
          "y": [ 8, 10 ]
        }
      ]
    }
  },
  {
    "type": "mapgen",
    "method": "json",
    "nested_mapgen_id": "power_plant_7x7_incident_fire",
    "object": {
      "mapgensize": [ 7, 7 ],
      "rotation": [ 0, 3 ],
      "rows": [
        " %%%%% ",
        "%%...%%",
        "%.....%",
        "%..^..%",
        "%.....%",
        "%%...%%",
        " %%%%% "
      ],
      "terrain": { ".": "t_pit_shallow", "%": "t_dirtmound", "^": "t_pit" },
      "furniture": { "%": "f_ash" },
      "fields": { "^": { "field": "fd_fire_vent", "intensity": 1, "age": 10 } }
    }
  },
  {
    "type": "mapgen",
    "method": "json",
    "nested_mapgen_id": "power_plant_7x7_incident_lava",
    "object": {
      "mapgensize": [ 7, 7 ],
      "rotation": [ 0, 3 ],
      "rows": [
        " ....^ ",
        "....^^^",
        "..##^^.",
        ".^###^.",
        ".^^##..",
        "^^^....",
        " ^.... "
      ],
      "terrain": { ".": "t_rock_floor_no_roof", "#": "t_rock", "^": "t_lava" },
      "furniture": { ".": [ [ "f_null", 2 ], "f_rubble_rock" ] },
      "mapping": { ".": { "item": { "item": "chunk_sulfur", "chance": 25 } } }
    }
  }
]
