[
  {
    "type": "mapgen",
    "method": "json",
    "om_terrain": [ "pwr_sub_s" ],
    "object": {
      "fill_ter": "t_floor",
      "rotation": 2,
      "rows": [
        "........................",
        "------------------------",
        "-   T                  -",
        "-                      -",
        "-   }                  -",
        "- T hST                -",
        "-              ||||d||||",
        "- T {BT        Wc*****I|",
        "-              Wc****aI|",
        "- T hsT{BT     |C*****kW",
        "-              |Ca***|||",
        "-        8S    |C****|$|",
        "- T      T     Wc****D*|",
        "-    888       Wc****|&|",
        "-    888       ||||d||||",
        "- T  888 T          4  -",
        "-        8S            -",
        "-                      -",
        "- T hST{BT             -",
        "-   {              -++--",
        "-   B              -  ..",
        "- T hST            -  ..",
        "-   }              -  ..",
        "--------------------...."
      ],
      "terrain": {
        " ": "t_concrete",
        "*": "t_floor",
        "+": "t_chaingate_c",
        "-": "t_chainfence",
        ".": "t_region_groundcover",
        "8": "t_potential_trans",
        "B": "t_oil_circ_brkr_l",
        "C": "t_console_broken",
        "S": "t_switchgear_l",
        "T": "t_support_l",
        "W": "t_window",
        "d": "t_door_locked",
        "D": "t_door_c",
        "h": "t_station_disc",
        "s": "t_switchgear_s",
        "x": "t_chainfence_posts",
        "{": "t_current_trans",
        "|": "t_wall_b",
        "}": "t_lgtn_arrest",
        "4": "t_gutter_downspout"
      },
      "toilets": { "&": {  } },
      "furniture": { "c": "f_counter", "a": "f_stool", "I": "f_desk", "k": "f_filing_cabinet", "$": "f_sink" },
      "items": {
        "I": { "item": "office", "chance": 30, "repeat": [ 1, 2 ] },
        "k": { "item": "office_paper", "chance": 30, "repeat": [ 1, 2 ] }
      },
      "place_loot": [
        { "group": "supplies_electronics", "x": 16, "y": [ 7, 8 ], "chance": 40, "repeat": [ 1, 3 ] },
        { "group": "tools_lighting_industrial", "x": 16, "y": [ 7, 8 ], "chance": 30, "repeat": [ 1, 2 ] },
        { "group": "tools_common", "x": 16, "y": [ 7, 8 ], "chance": 40, "repeat": [ 1, 2 ] },
        { "group": "clothing_work_set", "x": 16, "y": [ 7, 8 ], "chance": 25 },
        { "group": "supplies_electronics", "x": 16, "y": [ 12, 13 ], "chance": 40, "repeat": [ 1, 3 ] },
        { "group": "tools_lighting_industrial", "x": 16, "y": [ 12, 13 ], "chance": 30, "repeat": [ 1, 2 ] },
        { "group": "tools_common", "x": 16, "y": [ 12, 13 ], "chance": 40, "repeat": [ 1, 2 ] },
        { "group": "clothing_work_set", "x": 16, "y": [ 12, 13 ], "chance": 25 },
        { "item": "stepladder", "x": 20, "y": 17, "chance": 100 }
      ],
      "place_monster": [
        {
          "monster": [ "mon_leech_blossom", "mon_leech_blossom", "mon_leech_pod_cluster" ],
          "x": [ 3, 8 ],
          "y": [ 10, 12 ],
          "chance": 15,
          "repeat": [ 1, 2 ]
        }
      ]
    }
  },
  {
    "type": "mapgen",
    "method": "json",
    "om_terrain": "pwr_sub_s_roof",
    "object": {
      "fill_ter": "t_tar_flat_roof",
      "rotation": 2,
      "rows": [
        "                        ",
        "                        ",
        "                        ",
        "                        ",
        "                        ",
        "                        ",
        "               ---------",
        "               -.......-",
        "               -.......-",
        "               -.......-",
        "               -.......-",
        "               -.......-",
        "               -.......-",
        "               -.......-",
        "               -----5---",
        "                        ",
        "                        ",
        "                        ",
        "                        ",
        "                        ",
        "                        ",
        "                        ",
        "                        ",
        "                        "
      ],
      "palettes": [ "roof_palette" ],
      "terrain": { ".": "t_tar_flat_roof" }
    }
  }
]
