[
  {
    "type": "mapgen",
    "method": "json",
    "om_terrain": [ [ "power_plant_small_1", "power_plant_small_2" ] ],
    "weight": 250,
    "object": {
      "fill_ter": "t_floor",
      "rows": [
        "|||_,,,,,,,pp,,,,,,,_|||||||||||||||||||||||||||",
        "|  _,,,,,,,,,,,,,,,,_                          |",
        "|  _,ppppp,pp,,,,,,,_    ####WWW#######WWW#### |",
        "| ?_,,,,,,,,,,,,,,,,_?   #vv.ccc..f#.d..h..d.#9|",
        "|___,,,,,,,,,,,,,,,,____ W........s#h6.666.6hW |",
        "|,,,,,,,,,,,,,,,,,,,,,,_ W..ee....t#.........W |",
        "|,,,,,,,,,,,,,,,,,,,,,,_ #.heeh....#....t*FFF# |",
        "|,,,,,,,,,,,,,,,,,,,,,,_ #######++###++####### |",
        "|,,,,,,,,,,,,,,,,,,,,,,_ #T.sE#.........bbbbb# |",
        "|,,,,,,,,,,,,,,,,,,,,,,_ #....+..............# |",
        "|ppppppp,,,,,,,,ppppppp_ #t...#..............# |",
        "|,,,,,,,,,,,,,,,,,,,,,,_ #######++###++###++## |",
        "|,,,,,,,,,,,,,,,,,,,,,,_ #..d......#....#;;;;# |",
        "|,,,,,,,,,,,,,,,,,,,,,,_ W.hd......#l..l#;;;8# |",
        "|,,,,,,,,,,,,,,,,,,,,,,_ W.dd......#l..l#;;;a# |",
        "|,,,,,,,,,,,,,,,,,,,,,,_ #.........#l..l#;;;;# |",
        "|ppppppp,,,,,,,,ppppppp_ ##WWWW#++#######;;;r# |",
        "|,,,,,,,,,,,,,,,,,,,,,,___________ | #w;;;;;r# |",
        "|,,,,,,,,,,,,,,,,,,,,,,___________ | #2;;;;;r# |",
        "|,,,,,,,,,,,,,,,,,,,,,,_           | #4;;;;;r# |",
        "|,,,,,,,,,,,,,,,,,,,,,,_          A| #7;;;;;r# |",
        "|,,,,,,,,,,,,,,,,,,,,,,_          A| #;;;;;;;# |",
        "|___,,,,,,,pp,,,,,,,____          A| ##WW#++## |",
        "| ?_,,,,,,,,,,,,,,,,_?             |      __   |"
      ],
      "palettes": [ "power_plant_palette" ],
      "place_signs": [ { "signage": "<city> power station", "x": 24, "y": 19 } ],
      "toilets": { "T": {  } },
      "place_monster": [
        { "group": "GROUP_INDUSTRIAL_CENTER", "x": [ 1, 23 ], "y": [ 1, 23 ], "repeat": [ 10, 15 ] },
        { "group": "GROUP_INDUSTRIAL_CENTER", "x": [ 26, 44 ], "y": [ 3, 21 ], "repeat": [ 10, 15 ] }
      ]
    }
  },
  {
    "type": "mapgen",
    "method": "json",
    "om_terrain": [ "power_plant_small_3" ],
    "weight": 250,
    "//": "Coal variant.",
    "object": {
      "fill_ter": "t_floor",
      "rows": [
        "||||GGGGGGGGGGGGGGGG||||",
        "| ,,,,,,,,,,,,,,,,,,    ",
        "| p,,,,,,,,,,,,,,,,,    ",
        "| p,,,,,,,,,,,,,,,,,    ",
        "| p,,,,,,,,,,,,,,,,,    ",
        "| ::::::::::____________",
        "| ::::::::::____________",
        "| ::::::::::__##########",
        "| ::::::::::__#;;;;;;;;;",
        "| ::::::::::__+;;;;;;;;;",
        "| :-::::-:::__+;;;;;----",
        "| :-!!!!-:::::#;;h;;&-!-",
        "| :-!!!!-:::::#;666;&---",
        "| :-!!!!-:1111=11113&---",
        "| :-!!!!-:1:::#;;;;;----",
        "| :--==--:1:11=11113&---",
        "| :::11:::1:1:#;;;;;&---",
        "| :::11:::222:#;;;;;&-!-",
        "| :::11111222:#;;;;;----",
        "| :::11111222:#;;;;;;;;;",
        "| ::::::::222:#rrr;;;;;;",
        "| ::::::::::::##########",
        "|                       ",
        "||||||||||||||||||||||||"
      ],
      "palettes": [ "power_plant_palette" ],
      "place_monster": [ { "group": "GROUP_INDUSTRIAL_CENTER", "x": [ 1, 23 ], "y": [ 1, 22 ], "repeat": [ 10, 15 ] } ]
    }
  },
  {
    "type": "mapgen",
    "method": "json",
    "om_terrain": [ "power_plant_small_3" ],
    "weight": 250,
    "//": "Natural gas variant.",
    "object": {
      "fill_ter": "t_floor",
      "rows": [
        "||||GGGGGGGGGGGGGGGG||||",
        "|   ,,,,,,,,,,,,,,,,    ",
        "|   p,,,,,,p,,,,,,,,    ",
        "|   p,,,,,,p,,,,,,,,    ",
        "|   p,,,,,,p,,,,,,,,    ",
        "| ::::::::::____________",
        "| ::::::::::____________",
        "| ::::::::::__##########",
        "| ::::::::::__#;;;;;;;;;",
        "| :--------:__+;;;;;;;;;",
        "| :-IIIIHI-:__+;;;;;----",
        "| :-I!I!!I-:::#;;h;;&-!-",
        "| :_I!I!!I----#;666;&---",
        "| :-I!I!!I!!!!#;IIII&---",
        "| :-!!I!!IIII!#;H;;;----",
        "| :-!II!!I!!!!#;IIII&---",
        "| :-!!!!!IIII!#;;;;;&---",
        "| :=!!!!!I!!!!#;;;;;&-!-",
        "| :=!!!!!IIII!#;;;;;----",
        "| :-!!!!!!!!!!#;;;;;;;;;",
        "| :-----------#rrr;;;;;;",
        "| ::::::::::::##########",
        "|                       ",
        "||||||||||||||||||||||||"
      ],
      "palettes": [ "power_plant_palette" ],
      "terrain": { "H": "t_sewage_pump" },
      "place_monster": [ { "group": "GROUP_INDUSTRIAL_CENTER", "x": [ 1, 23 ], "y": [ 1, 22 ], "repeat": [ 10, 15 ] } ]
    }
  },
  {
    "type": "mapgen",
    "method": "json",
    "om_terrain": [ "power_plant_small_3" ],
    "weight": 125,
    "//": "Petroleum variant.",
    "object": {
      "fill_ter": "t_floor",
      "rows": [
        "||||GGGGGGGGGGGGGGGG||||",
        "|   ,,,,,,,,,,,,,,,,    ",
        "|   p,,,,,,p,,,,,,,,    ",
        "|   p,,,,,,p,,,,,,,,    ",
        "|   p,,,,,,p,,,,,,,,    ",
        "| ::::::::::____________",
        "| ::::::HH::____________",
        "| ::::::HH::__##########",
        "| ::---::I::__#;;;;;;;;;",
        "| :--!--:I::__+;;;;;;;;;",
        "| :-!!!-II::__+;;;;;----",
        "| :--!--:I::::#;;h;;&-'-",
        "| ::---::I::::#;666;&---",
        "| :::::::I::::#;IIII&---",
        "| ::-----I::::#;;;;;----",
        "| :--!!!--::::#;IIII&---",
        "| :-!!!!!-::::#;;;;;&---",
        "| :-!!!!!-::::#;;;;;&-'-",
        "| :-!!!!!-::::#;;;;;----",
        "| :--!!!--::::#;;;;;;;;;",
        "| ::-----:::::#rrr;;;;;;",
        "| ::::::::::::##########",
        "|                       ",
        "||||||||||||||||||||||||"
      ],
      "palettes": [ "power_plant_palette" ],
      "terrain": { "'": "t_metal_floor_no_roof", "!": "t_metal_floor", "H": "t_gas_tank" },
      "place_monster": [ { "group": "GROUP_INDUSTRIAL_CENTER", "x": [ 1, 23 ], "y": [ 1, 22 ], "repeat": [ 10, 15 ] } ]
    }
  },
  {
    "type": "mapgen",
    "method": "json",
    "om_terrain": [ "power_plant_small_4" ],
    "weight": 250,
    "object": {
      "fill_ter": "t_floor",
      "rows": [
        "||||||||||||      __   |",
        "                  __   |",
        "                  __   |",
        "                  __   |",
        "                  __   |",
        "____________________   |",
        "____________________   |",
        "##########WWWWWWW#++## |",
        ";;;;;47;#..bbbbb.....# |",
        ";;;;;;;;+............# |",
        ";00;;;;;+............# |",
        "5003Z;;;W............# |",
        ";00;;;;;W....ddd66..6# |",
        ";;;;;;;;W....dh.h...6# |",
        ";;;;Z;;;##++##.....h6# |",
        ";;;;;;;;# __ #FF*t..6#9|",
        ";00;;;XX# __ ##WWWWW## |",
        "5003Z;XX#::::::::::::: |",
        ";00;;;XX#:V::::::::::: |",
        ";;;;;;;Z#ZXC:Z::BVZ:::P|",
        "rrrMM;;;#::N:::::::::: |",
        "#########::::::::::::: |",
        "                 P     |",
        "||||||||||||||||||||||||"
      ],
      "palettes": [ "power_plant_palette" ],
      "place_monster": [ { "group": "GROUP_INDUSTRIAL_CENTER", "x": [ 0, 23 ], "y": [ 0, 23 ], "repeat": [ 10, 15 ] } ]
    }
  }
]
