[
  {
    "type": "palette",
    "id": "rest_area",
    "terrain": {
      ".": "t_region_groundcover",
      "W": "t_region_groundcover",
      "T": "t_region_groundcover",
      "e": "t_region_groundcover",
      "%": "t_region_shrub_decorative",
      "_": "t_pavement",
      "^": "t_pavement",
      "v": "t_pavement",
      "-": "t_pavement_y",
      "s": "t_sidewalk",
      "M": "t_sidewalk",
      "d": "t_sidewalk",
      "f": "t_sidewalk",
      "E": "t_sidewalk",
      "!": "t_sidewalk",
      " ": "t_floor",
      "+": "t_door_c",
      ":": "t_wall_glass",
      "g": "t_door_glass_c",
      "|": "t_wall_w",
      "4": "t_gutter_downspout",
      "$": "t_atm"
    },
    "furniture": {
      "!": "f_street_light",
      "α": "f_rack",
      "β": "f_rack",
      "γ": "f_rack",
      "δ": "f_rack",
      "C": "f_counter",
      "S": "f_sink",
      "a": "f_stool",
      "H": "f_table",
      "T": "f_table",
      "W": "f_bench",
      "K": "f_bench",
      "M": "f_bench",
      "e": "f_trashcan",
      "E": "f_trashcan",
      "Y": "f_trashcan"
    },
    "toilets": { "t": {  } },
    "vendingmachines": {
      "D": { "item_group": "vending_drink" },
      "F": { "item_group": "vending_food" },
      "d": { "item_group": "vending_drink" },
      "f": { "item_group": "vending_food" }
    },
    "items": {
      "e": { "item": "trash", "chance": 45, "repeat": [ 1, 4 ] },
      "E": { "item": "trash", "chance": 45, "repeat": [ 1, 4 ] },
      "Y": { "item": "trash", "chance": 45, "repeat": [ 1, 4 ] },
      "α": { "item": "magazines", "chance": 40, "repeat": [ 1, 6 ] },
      "β": { "item": "snacks", "chance": 40, "repeat": [ 1, 6 ] },
      "γ": { "item": "groce_softdrink", "chance": 40, "repeat": [ 1, 6 ] },
      "δ": { "item": "softdrugs", "chance": 40, "repeat": [ 1, 4 ] },
      "T": [ { "item": "snacks", "chance": 10 }, { "item": "groce_softdrink", "chance": 10 } ]
    },
    "vehicles": {
      "^": { "vehicle": "parking_garage", "chance": 25, "rotation": 270 },
      "v": { "vehicle": "parking_garage", "chance": 25, "rotation": 90 }
    }
  },
  {
    "type": "mapgen",
    "method": "json",
    "om_terrain": "s_restparking_1",
    "object": {
      "rows": [
        "....________............",
        "....________............",
        "....________ssssssssssss",
        ".s!s________s%%%%%%%%%%%",
        ".s%s________ssssssssssss",
        ".s%s________s-----------",
        ".s%s________s-____-____-",
        ".s%s________s-____-____-",
        ".s%s________s-_^__-_^__-",
        ".s%s________s-____-____-",
        ".s%s________s-____-____-",
        "ssss________s-____-____-",
        "s_______________________",
        "s_______________________",
        "s_______________________",
        "s_______________________",
        "s_______________________",
        "s_______________________",
        "s_______________________",
        "s_______________________",
        "s_______________________",
        "s_______________________",
        "s_______________________",
        "s_______________________"
      ],
      "palettes": [ "rest_area" ],
      "place_monsters": [ { "monster": "GROUP_ZOMBIE", "x": [ 2, 21 ], "y": [ 2, 21 ], "repeat": [ 1, 3 ] } ]
    }
  },
  {
    "type": "mapgen",
    "method": "json",
    "om_terrain": "s_restparking_2",
    "object": {
      "rows": [
        "............________....",
        "............________....",
        "ssssssssssss________....",
        "%%%%%s.....s________s!s.",
        "ssssss.WTW.s________s%s.",
        "-----s.WTW.s________s%s.",
        "____-s..e..s________s%s.",
        "____-s.....s________s%s.",
        "_^__-s.WTW.s________s%s.",
        "____-s.WTW.s________s%s.",
        "____-s..e..s________s%s.",
        "____-sssssss________ssss",
        "_______________________s",
        "_______________________s",
        "_______________________s",
        "_______________________s",
        "_______________________s",
        "_______________________s",
        "_______________________s",
        "_______________________s",
        "_______________________s",
        "_______________________s",
        "_______________________s",
        "_______________________s"
      ],
      "palettes": [ "rest_area" ],
      "place_monsters": [ { "monster": "GROUP_ZOMBIE", "x": [ 2, 21 ], "y": [ 2, 21 ], "repeat": [ 1, 3 ] } ]
    }
  },
  {
    "type": "mapgen",
    "method": "json",
    "om_terrain": "s_reststop_1",
    "object": {
      "fill_ter": "t_floor",
      "rows": [
        "s-____-____-____-____-ss",
        "s-____-____-____-____-ss",
        "s-____-____-____-____-ss",
        "s-__v_-__v_-__v_-__v_-ss",
        "s-____-____-____-____-ss",
        "s-____-____-____-____-ss",
        "s---------------------ss",
        "!sssssssssssssssssssssss",
        "...sssssssssssssssssssss",
        "...||||::::::||||ssss|||",
        "...|γ        Ca :ssss:  ",
        "...|γ δββα   CC :ssss:  ",
        "...|γ           |ssss|DF",
        "...||:::|gg|::::|:gg:|||",
        "...|K                   ",
        "...|K      KKKK         ",
        "...|||||  ||||||||||||| ",
        "...|C     |t|t|t|t|t|t| ",
        "...|S     |+|+|+|+|+|+| ",
        "...|S           |       ",
        "...|S     |+|+|+|+|+|+| ",
        "...|C   YH|t|t|t|t|t|t|H",
        "...|||||||||||||||||||||",
        "...4...................."
      ],
      "palettes": [ "rest_area" ],
      "place_monsters": [ { "monster": "GROUP_ZOMBIE", "x": [ 2, 21 ], "y": [ 2, 21 ], "repeat": [ 1, 3 ] } ]
    }
  },
  {
    "type": "mapgen",
    "method": "json",
    "om_terrain": "s_reststop_2",
    "object": {
      "fill_ter": "t_floor",
      "rows": [
        "ss-____-____-____-____-s",
        "ss-____-____-____-____-s",
        "ss-____-____-____-____-s",
        "ss-__v_-__v_-__v_-__v_-s",
        "ss-____-____-____-____-s",
        "ss-____-____-____-____-s",
        "ss---------------------s",
        "sssssssssssssssssssssss!",
        "sssssssssssssssse.......",
        "|::::::::|||||ss........",
        "         KKKK:ss..WTTW..",
        "             :ss..WTTW..",
        "         KKKK:ss..WTTW..",
        "        Y|||||ss........",
        "             gss........",
        "     $       gss..WTTW..",
        " ||||||:::::||ss..WTTW..",
        "    C|Esssssfdss..WTTW..",
        "    S|Msssssssss........",
        "    S|Msssssssss........",
        "    S|Msssssssss..WTTW..",
        "Y   C|Msssssssss..WTTW..",
        "||||||ssssssssss..WTTW..",
        ".....4.................."
      ],
      "palettes": [ "rest_area" ],
      "place_monsters": [ { "monster": "GROUP_ZOMBIE", "x": [ 2, 21 ], "y": [ 2, 21 ], "repeat": [ 1, 3 ] } ]
    }
  },
  {
    "type": "mapgen",
    "method": "json",
    "om_terrain": "s_reststop_1_roof",
    "object": {
      "fill_ter": "t_tar_flat_roof",
      "rows": [
        "                        ",
        "                        ",
        "                        ",
        "                        ",
        "                        ",
        "                        ",
        "                        ",
        "                        ",
        "                        ",
        "   --------------    ---",
        "   -............-    -..",
        "   -............-    -..",
        "   -.....X......-    -..",
        "   -............------..",
        "   -....................",
        "   -....................",
        "   -....................",
        "   -...........AA.......",
        "   -....................",
        "   -........=.......=...",
        "   -....................",
        "   -....................",
        "   5--------------------",
        "                        "
      ],
      "palettes": [ "roof_palette" ],
      "terrain": { ".": "t_tar_flat_roof" }
    }
  },
  {
    "type": "mapgen",
    "method": "json",
    "om_terrain": "s_reststop_2_roof",
    "object": {
      "fill_ter": "t_tar_flat_roof",
      "rows": [
        "                        ",
        "                        ",
        "                        ",
        "                        ",
        "                        ",
        "                        ",
        "                        ",
        "                        ",
        "                        ",
        "--------------          ",
        ".............-          ",
        ".............-          ",
        ".............-          ",
        ".............-          ",
        ".............-          ",
        "&............-          ",
        ".....---------          ",
        ".....-                  ",
        ".....-                  ",
        ".....-                  ",
        ".....-                  ",
        ".....-                  ",
        "-----5                  ",
        "                        "
      ],
      "palettes": [ "roof_palette" ],
      "terrain": { ".": "t_tar_flat_roof" }
    }
  }
]
