[
  {
    "type": "mapgen",
    "om_terrain": [ [ "robofachq_roof_a0", "robofachq_roof_a1", "robofachq_roof_a2", "robofachq_roof_a3" ] ],
    "method": "json",
    "object": {
      "fill_ter": "t_concrete",
      "rows": [
        ",,,,,,,,,,,,,,,,,,,,,,,,,,,,,,,,,,,,,,,,,,,,,,,,,,,,,,,,,,,,,,,,,,,,,,,,,,,,,,,,,,,,,,,,,,,,,,,,",
        ",,,,,,,,,,,,,,,,,,,,,,,,       ,,,,,,,,,,,,,,,,,,,,,,,,,,,,,,,,,,,,,,,,,,,,,,,,,,,,,,,,,,,,,,,,,",
        ",,,,,,,,,,,,,,,,,,,,,,,,       ,,,,,,,,,,,,,,,,,,,,,,,,,,,,,,,,,,,,,,,,,,,,,,,,,,,,,,,,,,,,,,,,,",
        ",,,,,,,,,,,,,,,,,,,,,,,,       ,,,,,,,,,,,,,,,,,,,,,,,,,,,,,,,,,,,,,,,,,,,,,,,,,,,,,,,,,,,,,,,,,",
        ",,,,,,,,,,,,,,,,,,,,,,,,       ,,,,,,,,,,,,,,,,,,,,,,,,,,,,,,,,,,,,,,,,,,,,,,,,,,,,,,,,,,,,,,,,,",
        ",,,,,,,,,,,,,,,,,,,,,,,,,,,,,,,,,,,,,,,,,,,,,,,,,,,,,,,,,,,,,,,,,,,,,,,,,,,,,,,,,,,,,,,,,,,,,,,,",
        ",,,,,,,,,,,,,,,,,,,,,,,,,,,,,,,,,,,,,,,,,,,,,,,,,,,,,,,,,,,,,,,,,,,,,,,,,,,,,,,,,,,,,,,,,,,,,,,,",
        ",,,,,,,,,,,,,,,,,,,,,,,,,,,,,,,,,,,,,,,,,,,,,,,,,,,,,,,,,,,,,,,,,,,,,,,,,,,,,,,,,,,,,,,,,,,,,,,,",
        ",,,,,,,,,,,,,,,,,,,,,,,,,,,                                            ,,,,,,,,,,,,,,,,,,,,,,,,,",
        ",,,,,,,,,,,,,,,,,,,,,,,,,,,                                            ,,,,,,,,,,,,,,,,,,,,,,,,,",
        ",,,,,,,,,,,,,,,,,,,,,,,,,,,                                            ,,,,,,,,,,,,,,,,,,,,,,,,,",
        ",,,,,,,,,,,,,,,,,,,,,,,,,,,                                            ,,,,,,,,,,,,,,,,,,,,,,,,,",
        ",,,,,,,,,,,,,,,,,,,,,,,,,,,                                            ,,,,,,,,,,,,,,,,,,,,,,,,,",
        ",,,,,,,,,,,,,,,,,,,,,,,,,,,                                            ,,,,,,,,,,,,,,,,,,,,,,,,,",
        ",,,,,,,,,,,,,,,,,,,,,,,,,,,                                            ,,,,,,,,,,,,,,,,,,,,,,,,,",
        ",,,,,,,,,,,,,,,,,,,,,,,,,,,                                            ,,,,,,,,,,,,,,,,,,,,,,,,,",
        ",,,,,,,,,,,,,,,,,,,,,,,,,,,                                            ,,,,,,,,,,,,,,,,,,,,,,,,,",
        ",,,,,,,,,,,,,,,,,,,,,,,,,,,                                            ,,,,,,,,,,,,,,,,,,,,,,,,,",
        ",,,,,,,,,,,,,,,,,,,,,,,,,,,                                            ,,,,,,,,,,,,,,,,,,,,,,,,,",
        ",,,,,,,,,,,,,,,,,,,,,,,,,,,                                            ,,,,,,,,,,,,,,,,,,,,,,,,,",
        ",,,,,,,,,,,,,,,,,,,,,,,,,,,                                            ,,,,,,,,,,,,,,,,,,,,,,,,,",
        ",,,,,,,,,,,,,,,,,,,,,,,,,,,                                            ,,,,,,,,,,,,,,,,,,,,,,,,,",
        ",,,,,,,,,,,,,,,,,,,,,,,,,,,                                            ,,,,,,,,,,,,,,,,,,,,,,,,,",
        ",,,,,,,,,,,,,,,,,,,,,,,,,,,                                            ,,,,,,,,,,,,,,,,,,,,,,,,,"
      ],
      "terrain": { ",": "t_open_air" }
    }
  },
  {
    "type": "mapgen",
    "om_terrain": [
      [ "robofachq_surface_parking", "robofachq_surface_entrance", "robofachq_surface_car_entrance", "robofachq_surface_a3" ],
      [ "robofachq_surface_b0", "robofachq_surface_b1", "robofachq_surface_b2", "robofachq_surface_b3" ]
    ],
    "method": "json",
    "object": {
      "fill_ter": "t_thconc_floor",
      "rows": [
        ",,,,yyyyyyyyyyyyyyyysssssssssss,,,,,,,,,,,,,,,,,,,,,,______yyyyyyyyy,,,,,,,,,,,,,,,,,,,,,,,,,,,,",
        ",,,,________________ssss|ss|((|,,,,,,,,,,,,,,,,,,,,,,_______________,,,,,,,,,,,,,,,,,,,,,,,,,,,,",
        ",,||___________555555555|ss(dh|||||||||||||||||||||||||||___________||||||||||||||||||||||||||,,",
        ",,|,_________555555555__|s,(d 2s,,,,,,,,,,,_____________5555555555555U,,,,,,,,,,,,,,,,,,,,,,,|,,",
        ",,|,____________________|22||||s,,,,,,,,,,,,,,,,,,,,,,,,,___________,U,,,,,,,,,,,,,,,,,,,,,,,|,,",
        ",,|,____________________sssssssssssssssssssssssssssssssss___________,U,,,,,,,,,,,,,,,,,,,,,,,|,,",
        ",,|,____________________sssssssssssssssssssssssssssssssss___________,U,,,,,,,,,,,,,,,,,,,,,,,|,,",
        ",,|,____________________ss,,,,,,,,ss,,,,,,,,,,,,,,,,,,,,,___________,U,,,,,,,,,,,,,,,,,,,,,,,|,,",
        ",,|,____________________ss,|((((||22||||||||||||(((((||||___________|||,,,,,,,,,,,,,,,,,,,,,,|,,",
        ",,|,____________________ss,|        |d  h   |;i|    B||||55555555555|||,,,,,,,,,,,,,,,,,,,,,,|,,",
        ",,|,____________________ss,|?       (dh     |  | dh B||||eeeeeeeeeee|||,,,,,,,,,,,,,,,,,,,,,,|,,",
        ",,|,____________________ss,|? t     (dd66d  ||2|hd   |   eeeeeeeeeee  |,,,,,,,,,,,,,,,,,,,,,,|,,",
        ",,|,__________yyyyyyyyyyss,|? t     ||((((22|  |(((([|   eeeeeeeeeee  |,,,,,,,,,,,,,,,,,,,,,,|,,",
        ",,|,____________________ss,|?        2  YY           5   eeeeeeeeeee  |,,,,,,,,,,,,,,,,,,,,,,|,,",
        ",,|,____________________ss,|^a a     2               5   eeeeeeeeeee  |,,,,,,,,,,,,,,,,,,,,,,|,,",
        ",,|,____________________ss,|||||||||||||55GI||||55||||   eeeeeeeeeee  |,,,,,,,,,,,,,,,,,,,,,,|,,",
        ",,|,____________________ss,|hhhhhhhhh|      |  |  |; |   eeeeeeeeeee. |,,,,,,,,,,,,,,,,,,,,,,|,,",
        ",,|,__________yyyyyyyyyyss,|         2      |  |  2 i|   eeeeeeeeeee  |,,,,,,,,,,,,,,,,,,,,,,|,,",
        ",,|,____________________ss,| lllllll |      ||||55||||   eeeeeeeeeee  |,,,,,,,,,,,,,,,,,,,,,,|,,",
        ",,|,____________________ss,|2|||||||2|Eeeeee(d      d(   eeeeeeeeeee  |,,,,,,,,,,,,,,,,,,,,,,|,,",
        ",,|,____________________ss,|  2~|~2  |eeeeee(6h 66 h6(   eeeeeeeeeee  |,,,,,,,,,,,,,,,,,,,,,,|,,",
        ",,|,____________________ss,|i ||||| i|eeeeee(d  66  d(   eeeeeeeeeee  |,,,,,,,,,,,,,,,,,,,,,,|,,",
        ",,|,__________yyyyyyyyyyss,|i 2~|~2 i|Eeeeee|        |   eeeeeeeeeee  |,,,,,,,,,,,,,,,,,,,,,,|,,",
        ",,|,__________ssssssssssss,||||||||||||||||||||||||||||||||||||||||||||,,,,,,,,,,,,,,,,,,,,,,|,,",
        ",,|,,,,,,,,,,,,,,,,,,,,,,,,,,,,,,,,,,,,,,,,,,,,,,,,,,,,,,,,,,,,,,,,,,,,,,,,,,,,,,,,,,,,,,,,,,|,,",
        ",,|,,,,,,,,,,,,,,,,,,,,,,,,,,,,,,,,,,,,,,,,,,,,,,,,,,,,,,,,,,,,,,,,,,,,,,,,,,,,,,,,,,,,,,,,,,|,,",
        ",,|,,,,,,,,,,,,,,,,,,,,,,,,,,,,,,,,,,,,,,,,,,,,,,,,,,,,,,,,,,,,,,,,,,,,,,,,,,,,,,,,,,,,,,,,,,|,,",
        ",,|,,,,,,,,,,,,,,,,,,,,,,,,,,,,,,,,,,,,,,,,,,,,,,,,,,,,,,,,,,,,,,,,,,,,,,,,,,,,,,,,,,,,,,,,,,|,,",
        ",,|,,,,,,,,,,,,,,,,,,,,,,,,,,,,,,,,,,,,,,,,,,,,,,,,,,,,,,,,,,,,,,,,,,,,,,,,,,,,,,,,,,,,,,,,,,|,,",
        ",,|,,,,,,,,,,,,,,,,,,,,,,,,,,,,,,,,,,,,,,,,,,,,,,,,,,,,,,,,,,,,,,,,,,,,,,,,,,,,,,,,,,,,,,,,,,|,,",
        ",,|,,,,,,,,,,,,,,,,,,,,,,,,,,,,,,,,,,,,,,,,,,,,,,,,,,,,,,,,,,,,,,,,,,,,,,,,,,,,,,,,,,,,,,,,,,|,,",
        ",,|,,,,,,,,,,,,,,,,,,,,,,,,,,,,,,,,,,,,,,,,,,,,,,,,,,,,,,,,,,,,,,,,,,,,,,,,,,,,,,,,,,,,,,,,,,|,,",
        ",,|,,,,,,,,,,,,,,,,,,,,,,,,,,,,,,,,,,,,,,,,,,,,,,,,,,,,,,,,,,,,,,,,,,,,,,,,,,,,,,,,,,,,,,,,,,|,,",
        ",,|,,,,,,,,,,,,,,,,,,,,,,,,,,,,,,,,,,,,,,,,,,,,,,,,,,,,,,,,,,,,,,,,,,,,,,,,,,,,,,,,,,,,,,,,,,|,,",
        ",,|,,,,,,,,,,,,,,,,,,,,,,,,,,,,,,,,,,,,,,,,,,,,,,,,,,,,,,,,,,,,,,,,,,,,,,,,,,,,,,,,,,,,,,,,,,|,,",
        ",,|,,,,,,,,,,,,,,,,,,,,,,,,,,,,,,,,,,,,,,,,,,,,,,,,,,,,,,,,,,,,,,,,,,,,,,,,,,,,,,,,,,,,,,,,,,|,,",
        ",,|,,,,,,,,,,,,,,,,,,,,,,,,,,,,,,,,,,,,,,,,,,,,,,,,,,,,,,,,,,,,,,,,,,,,,,,,,,,,,,,,,,,,,,,,,,|,,",
        ",,|,,,,,,,,,,,,,,,,,,,,,,,,,,,,,,,,,,,,,,,,,,,,,,,,,,,,,,,,,,,,,,,,,,,,,,,,,,,,,,,,,,,,,,,,,,|,,",
        ",,|,,,,,,,,,,,,,,,,,,,,,,,,,,,,,,,,,,,,,,,,,,,,,,,,,,,,,,,,,,,,,,,,,,,,,,,,,,,,,,,,,,,,,,,,,,|,,",
        ",,|,,,,,,,,,,,,,,,,,,,,,,,,,,,,,,,,,,,,,,,,,,,,,,,,,,,,,,,,,,,,,,,,,,,,,,,,,,,,,,,,,,,,,,,,,,|,,",
        ",,|,,,,,,,,,,,,,,,,,,,,,,,,,,,,,,,,,,,,,,,,,,,,,,,,,,,,,,,,,,,,,,,,,,,,,,,,,,,,,,,,,,,,,,,,,,|,,",
        ",,|,,,,,,,,,,,,,,,,,,,,,,,,,,,,,,,,,,,,,,,,,,,,,,,,,,,,,,,,,,,,,,,,,,,,,,,,,,,,,,,,,,,,,,,,,,|,,",
        ",,|,,,,,,,,,,,,,,,,,,,,,,,,,,,,,,,,,,,,,,,,,,,,,,,,,,,,,,,,,,,,,,,,,,,,,,,,,,,,,,,,,,,,,,,,,,|,,",
        ",,|,,,,,,,,,,,,,,,,,,,,,,,,,,,,,,,,,,,,,,,,,,,,,,,,,,,,,,,,,,,,,,,,,,,,,,,,,,,,,,,,,,,,,,,,,,|,,",
        ",,|,,,,,,,,,,,,,,,,,,,,,,,,,,,,,,,,,,,,,,,,,,,,,,,,,,,,,,,,,,,,,,,,,,,,,,,,,,,,,,,,,,,,,,,,,,|,,",
        ",,|,,,,,,,,,,,,,,,,,,,,,,,,,,,,,,,,,,,,,,,,,,,,,,,,,,,,,,,,,,,,,,,,,,,,,,,,,,,,,,,,,,,,,,,,,,|,,",
        ",,||||||||||||||||||||||||||||||||||||||||||||||||||||||||||||||||||||||||||||||||||||||||||||,,",
        ",,,,,,,,,,,,,,,,,,,,,,,,,,,,,,,,,,,,,,,,,,,,,,,,,,,,,,,,,,,,,,,,,,,,,,,,,,,,,,,,,,,,,,,,,,,,,,,,"
      ],
      "palettes": [ "robofachq" ],
      "terrain": {
        "-": "t_wall_metal",
        "G": "t_card_robofac",
        "e": "t_elevator",
        "E": "t_elevator_control_off",
        "Y": "t_utility_light",
        "I": "t_intercom"
      },
      "items": {
        "l": [ { "item": "NC_ROBOFAC_FIELD_RESEARCHER_worn", "chance": 50 }, { "item": "NC_ROBOFAC_SCIENTIST_worn", "chance": 50 } ],
        "i": { "item": "cleaning", "chance": 50 },
        "B": [ { "item": "textbooks", "chance": 50 }, { "item": "manuals", "chance": 50 } ]
      },
      "place_npcs": [ { "class": "robofac_intercom", "x": 46, "y": 17 } ]
    }
  }
]
