[
  {
    "type": "mapgen",
    "method": "json",
    "om_terrain": [ [ "rv_park_1", "rv_park_2" ], [ "rv_park_3", "rv_park_4" ] ],
    "object": {
      "fill_ter": "t_sidewalk",
      "rows": [
        "................................................",
        "................................................",
        "..                                            ..",
        "..                                            ..",
        "..                                            ..",
        "..                                            ..",
        "..                                            ..",
        "..                                            ..",
        "...........sjs                    sjs...........",
        "...........sts                    sts...........",
        "..                                            ..",
        "..                                            ..",
        "..                                            ..",
        "..                                            ..",
        "..                                            ..",
        "..                                            ..",
        "...........sjs                    sjs...........",
        "...........sts                    sts...........",
        "..                                            ..",
        "..                                            ..",
        "..                                            ..",
        "..                                            ..",
        "..                                            ..",
        "..                                            ..",

        "...........sjs                    sjs...........",
        "...........sts                    sts...........",
        "..                                            ..",
        "..                                            ..",
        "..                                            ..",
        "..                                            ..",
        "..                                            ..",
        "..                                            ..",
        "...........sjs                    sjs...........",
        "...ssss....sts                    sts...........",
        "...svcs.......                            ......",
        "..ssssss......                             .....",
        "..sbeebs......                              ....",
        "..sbeebs......                              ....",
        "..sbeebs......                              ....",
        "..ssssssssssss                              ....",
        "..||||||||||+|.                             ....",
        "..|____SSSSS_|..                            ....",
        "..||+|_______|.........s|ww|                ....",
        "..|__|+|+|+|+|.........s|d6|                ....",
        "..|T_|T|T|T|T|.........s+_h|                ....",
        "..||||||||||||.........s||||                ....",
        "............g............g..                ....",
        "............................                ...."
      ],
      "terrain": {
        " ": "t_region_groundcover_barren",
        ".": [ [ "t_region_groundcover", 7 ], [ "t_region_shrub", 2 ], [ "t_region_tree", 1 ] ],
        "|": "t_wall_g",
        "+": "t_door_c",
        "_": "t_thconc_floor",
        "6": "t_console_broken",
        "d": "t_thconc_floor",
        "g": "t_gutter_downspout",
        "h": "t_thconc_floor",
        "S": "t_thconc_floor",
        "s": "t_sidewalk",
        "T": "t_thconc_floor",
        "w": "t_wall_glass"
      },
      "furniture": {
        "b": "f_bench",
        "c": "f_tourist_table",
        "d": "f_desk",
        "e": "f_table",
        "h": "f_table",
        "j": "f_cable_connector",
        "T": "f_toilet",
        "t": "f_trashcan",
        "S": "f_sink",
        "v": "f_brazier"
      },
      "toilets": { "T": {  } },
      "items": {
        " ": { "item": "trash_forest", "chance": 1 },
        "d": { "item": "SUS_office_desk", "chance": 90 },
        "t": { "item": "trash_cart", "chance": 50 }
      },
      "place_vehicles": [
        { "chance": 25, "fuel": 25, "vehicle": "speedway_rv", "x": 4, "y": 6, "rotation": 180 },
        { "chance": 25, "fuel": 25, "vehicle": "speedway_rv", "x": 4, "y": 14, "rotation": 180 },
        { "chance": 25, "fuel": 25, "vehicle": "speedway_rv", "x": 4, "y": 22, "rotation": 180 },
        { "chance": 25, "fuel": 25, "vehicle": "speedway_rv", "x": 4, "y": 30, "rotation": 180 },
        { "chance": 25, "fuel": 25, "vehicle": "speedway_rv", "x": 43, "y": 3, "rotation": 0 },
        { "chance": 25, "fuel": 25, "vehicle": "speedway_rv", "x": 43, "y": 11, "rotation": 0 },
        { "chance": 25, "fuel": 25, "vehicle": "speedway_rv", "x": 43, "y": 19, "rotation": 0 },
        { "chance": 25, "fuel": 25, "vehicle": "speedway_rv", "x": 43, "y": 27, "rotation": 0 }
      ],
      "place_monster": [
 { "group": "GROUP_PARK_SCENIC", "x": [ 1, 22 ], "y": [ 1, 22 ], "repeat": [ 1, 3 ] },
 { "group": "GROUP_PARK_SCENIC", "x": [ 25, 46 ], "y": [ 1, 22 ], "repeat": [ 1, 3 ] },
 { "group": "GROUP_PARK_SCENIC", "x": [ 1, 22 ], "y": [ 25, 46 ], "repeat": [ 1, 3 ] },
 { "group": "GROUP_PARK_SCENIC", "x": [ 25, 46 ], "y": [ 25, 46 ], "repeat": [ 1, 3 ] }
 ]
    }
  },
  {
    "type": "mapgen",
    "method": "json",
    "om_terrain": [ [ "rv_park_roof_1", "rv_park_roof_2" ] ],
    "weight": 500,
    "object": {
      "fill_ter": "t_open_air",
      "rows": [
        "                                                ",
        "                                                ",
        "                                                ",
        "                                                ",
        "                                                ",
        "                                                ",
        "                                                ",
        "                                                ",
        "                                                ",
        "                                                ",
        "                                                ",
        "                                                ",
        "                                                ",
        "                                                ",
        "                                                ",
        "                                                ",
        "  ||||||||||||                                  ",
        "  |..........|                                  ",
        "  |..........|          ||||                    ",
        "  |..........|          |..|                    ",
        "  |..........|          |..|                    ",
        "  ||||||||||o|          |o||                    ",
        "                                                ",
        "                                                "
      ],
      "terrain": { "|": "t_gutter", "o": "t_gutter_drop", ".": "t_flat_roof" }
    }
  }
]
