[
  {
    "type": "mapgen",
    "method": "json",
    "om_terrain": [ "s_gun" ],
    "weight": 300,
    "object": {
      "fill_ter": "t_floor",
      "rows": [
        "  ____________________  ",
        "  *___*___*______*___*  ",
        "  *___*___*______*___*  ",
        "  *___*___*______*___*  ",
        "  *___*___*______*___*  ",
        "  *___*___*______*___*  ",
        "  ---:::--------:::---  ",
        "  |{....#...........{|  ",
        "  |{..S.?...........{|  ",
        "  |{....#...{{..{...{|  ",
        "  |{....#...{{..{...{|  ",
        "  |---..#...{{..{...{|  ",
        "  |&N|..............{|  ",
        "  |..D..........{{{{{|  ",
        "  |---:::::::::------|  ",
        " 4|l~~~~~~~~~~~~~~D~<|  ",
        "  |--H--H--H--H--H-+-|  ",
        "  |~~~~~~~~~~~~~~~~~~|  ",
        "  |~~~~~~~~~~~~~~~~~~|  ",
        "  |~~~~~~~~~~~~~~~~~~|  ",
        "  |~~~~~~~~~~~~~~~~~~|  ",
        "  |~~~~~~~~~~~~~~~~~~|  ",
        "  |ssssssssssssssssss|  ",
        "  ====================  "
      ],
      "place_terrain": [
        { "ter": "t_door_metal_pickable", "x": [ 11, 14 ], "y": 6 },
        { "ter": "t_door_metal_pickable", "x": [ 7, 14 ], "y": 14 }
      ],
      "terrain": {
        " ": [ "t_grass", "t_grass", "t_grass", "t_dirt" ],
        "*": "t_pavement_y",
        "+": "t_door_metal_pickable",
        "-": "t_wall_w",
        ".": "t_floor",
        ":": "t_window_bars_alarm",
        "=": "t_strconc_wall",
        "_": "t_pavement",
        "~": "t_thconc_floor",
        "H": "t_thconc_floor",
        "s": "t_thconc_floor",
        "l": "t_thconc_floor",
        "|": "t_wall_w",
        "D": "t_door_c",
        "?": "t_console_broken",
        "<": "t_ladder_up",
        "4": "t_gutter_downspout"
      },
      "toilets": { "&": {  } },
      "furniture": {
        "#": "f_counter",
        "H": "f_counter",
        "S": "f_stool",
        "l": "f_locker",
        "s": "f_sandbag_wall",
        "{": "f_rack",
        "N": "f_sink"
      },
      "place_loot": [
        { "group": "guns_pistol_common_display", "x": 12, "y": 9, "chance": 95, "repeat": [ 1, 3 ], "magazine": 100 },
        { "group": "guns_pistol_common_display", "x": 13, "y": 9, "chance": 95, "repeat": [ 1, 3 ], "magazine": 100 },
        {
          "group": "guns_pistol_common_display",
          "x": [ 12, 13 ],
          "y": 10,
          "chance": 95,
          "repeat": [ 1, 3 ],
          "magazine": 100
        },
        { "group": "guns_pistol_rare_display", "x": 12, "y": 11, "chance": 15, "magazine": 100 },
        { "group": "guns_pistol_rare_display", "x": 13, "y": 11, "chance": 15, "magazine": 100 },
        { "group": "guns_shotgun_common_display", "x": 16, "y": 9, "chance": 50, "magazine": 100 },
        { "group": "guns_shotgun_common_display", "x": 16, "y": 10, "chance": 100, "magazine": 100 },
        { "group": "guns_shotgun_rare_static_display", "x": 16, "y": 11, "chance": 25, "magazine": 100 },
        { "group": "guns_rifle_common_display", "x": 20, "y": 7, "chance": 25, "magazine": 100 },
        { "group": "guns_rifle_rare_display", "x": 20, "y": 8, "chance": 25, "magazine": 100 },
        { "group": "guns_rifle_common_display", "x": 20, "y": 9, "chance": 90, "repeat": [ 1, 3 ], "magazine": 100 },
        { "group": "guns_rifle_common_display", "x": 20, "y": 10, "chance": 90, "repeat": [ 1, 3 ], "magazine": 100 },
        { "group": "guns_rifle_common_display", "x": 20, "y": 11, "chance": 90, "repeat": [ 1, 3 ], "magazine": 100 },
        { "group": "guns_rifle_common_display", "x": 20, "y": 12, "chance": 90, "repeat": [ 1, 3 ], "magazine": 100 },
        { "group": "guns_smg_common_display", "x": 17, "y": 13, "chance": 85, "repeat": [ 1, 3 ], "magazine": 100 },
        { "group": "guns_smg_rare_display", "x": 18, "y": 13, "chance": 15, "magazine": 100 },
        { "group": "ammo_common", "x": 3, "y": [ 7, 10 ], "chance": 100, "repeat": [ 1, 8 ] },
        { "group": "ammo_pistol_common", "x": 3, "y": 7, "chance": 100, "repeat": [ 1, 8 ] },
        { "group": "ammo_shotgun_common", "x": 3, "y": 8, "chance": 95, "repeat": [ 1, 8 ] },
        { "group": "ammo_rifle_common", "x": 3, "y": 9, "chance": 95, "repeat": [ 1, 6 ] },
        { "group": "mags_common", "x": 3, "y": 10, "chance": 100, "repeat": [ 1, 4 ] },
        { "group": "mags_pistol_common", "x": 3, "y": 9, "chance": 100, "repeat": [ 1, 4 ] },
        { "group": "mags_rifle_common", "x": 3, "y": 8, "chance": 75, "repeat": [ 1, 4 ] },
        { "group": "mags_shotgun_common", "x": 3, "y": 7, "chance": 50, "repeat": [ 1, 4 ] },
        { "group": "mags_pistol_rare", "x": 3, "y": [ 7, 10 ], "chance": 50 },
        { "group": "mags_rifle_rare", "x": 3, "y": [ 7, 10 ], "chance": 25 },
        { "group": "mags_shotgun_rare", "x": 3, "y": [ 7, 10 ], "chance": 10 },
        { "group": "book_gunmags", "x": 8, "y": [ 8, 9 ], "chance": 100, "repeat": [ 1, 8 ] },
        { "group": "book_gunmags", "x": 8, "y": [ 11, 12 ], "chance": 50, "repeat": [ 1, 8 ] },
        {
          "group": "guns_pistol_common",
          "x": 5,
          "y": 16,
          "chance": 50,
          "repeat": [ 1, 3 ],
          "ammo": 25,
          "magazine": 100
        },
        { "group": "guns_pistol_rare", "x": 8, "y": 16, "chance": 20, "ammo": 75, "magazine": 100 },
        { "group": "guns_pistol_obscure", "x": 11, "y": 16, "chance": 20, "ammo": 100, "magazine": 100 },
        { "group": "guns_pistol_rare", "x": 14, "y": 16, "chance": 20, "ammo": 75, "magazine": 100 },
        {
          "group": "guns_pistol_common",
          "x": 17,
          "y": 16,
          "chance": 50,
          "repeat": [ 1, 3 ],
          "ammo": 25,
          "magazine": 100
        },
        { "item": "ear_plugs", "x": 2, "y": 14, "chance": 50, "repeat": 2 },
        { "item": "powered_earmuffs", "x": 2, "y": 14, "chance": 30 }
      ],
      "place_monsters": [ { "monster": "GROUP_ZOMBIE", "x": [ 0, 0 ], "y": [ 23, 23 ], "chance": 2, "repeat": [ 2, 3 ] } ]
    }
  },
  {
    "type": "mapgen",
    "method": "json",
    "om_terrain": "s_gun_roof",
    "object": {
      "fill_ter": "t_flat_roof",
      "rows": [
        "                        ",
        "                        ",
        "                        ",
        "                        ",
        "                        ",
        "                        ",
        "  |2222222222222222223  ",
        "  |..................3  ",
        "  |..................3  ",
        "  |..................3  ",
        "  |..................3  ",
        "  |..X...............3  ",
        "  |..................3  ",
        "  |..................3  ",
        "  |..................3  ",
        "  5.................>3  ",
        "  |..................3  ",
        "  |..................3  ",
        "  |..................3  ",
        "  |..................3  ",
        "  |..................3  ",
        "  |..................3  ",
        "  |..................3  ",
        "  |------------------3  "
      ],
      "palettes": [ "roof_palette" ],
      "terrain": { ">": "t_ladder_down" },
      "place_nested": [
        {
          "chunks": [
            [ "null", 20 ],
            [ "roof_2x2_utilities_b", 15 ],
            [ "roof_2x2_utilities_c", 5 ],
            [ "roof_2x2_utilities_d", 30 ],
            [ "roof_2x2_utilities", 30 ],
            [ "roof_2x2_golf", 10 ],
            [ "roof_3x3_wine", 10 ]
          ],
          "x": [ 4, 15 ],
          "y": [ 8, 9 ]
        },
        {
          "chunks": [
            [ "null", 20 ],
            [ "roof_4x4_party", 5 ],
            [ "roof_4x4_holdout", 15 ],
            [ "roof_4x4_utility", 40 ],
            [ "roof_4x4_utility_1", 10 ],
            [ "roof_6x6_survivor", 20 ],
            [ "roof_6x6_utility", 20 ]
          ],
          "x": [ 4, 13 ],
          "y": [ 11, 16 ]
        }
      ]
    }
  },
  {
    "type": "mapgen",
    "method": "json",
    "om_terrain": [ "s_gun_1" ],
    "//": "Home defense gun store",
    "weight": 300,
    "object": {
      "fill_ter": "t_floor",
      "rows": [
        "_ssssssssssssssssssssss_",
        "_s@@@@@@@_ssss_@@@@@@@s_",
        "_s||555||_ssss_||555||s_",
        "_s|#####5_ssss_5#####|s_",
        "_s|..a..5_ssss_5..a..|s_",
        "_s|.#?#.5_ssss_5.#?#.|s_",
        "_s|.....|55++55|.....|s_",
        "_s|..................|s_",
        "_s|..................|s_",
        "_s|....rrr....rrr....|s_",
        "_s|u...rrr....rrr...u|s_",
        "_s|^................^|s_",
        "_||u...rrr....rrr...u|s_",
        "_A|....rrr....rrr....|s_",
        "_||..................|s_",
        "_s|..................|s_",
        "_s||D|*|&&&&&&&&||+|||s_",
        "_s|;.|.|..####..|..cE|s_",
        "_s|..|.|........*...E|s_",
        "_s|S.|<|lll##lll|l...|4_",
        "_s|||||||||||||||||+||s_",
        "_ssssssssssssssssssssss_",
        "________________________",
        "________________________"
      ],
      "terrain": {
        "&": "t_bars",
        "*": "t_door_locked_alarm",
        "+": "t_door_metal_pickable",
        ".": "t_floor",
        "5": "t_window_bars_alarm",
        ";": "t_floor",
        "@": "t_shrub",
        "A": "t_atm",
        "D": "t_door_c",
        "L": "t_door_metal_locked",
        "_": "t_pavement",
        "s": "t_sidewalk",
        "|": "t_wall_w",
        "?": "t_console_broken",
        "<": "t_ladder_up",
        "4": "t_gutter_downspout"
      },
      "furniture": {
        "#": "f_counter",
        "a": "f_stool",
        "E": "f_desk",
        "S": "f_sink",
        "^": "f_indoor_plant",
        "c": "f_chair",
        "l": "f_locker",
        "r": "f_rack",
        "u": "f_vending_reinforced"
      },
      "vendingmachines": { "u": { "item_group": "vending_ammo", "reinforced": true } },
      "toilets": { ";": {  } },
      "place_loot": [
        { "group": "guns_pistol_rare_display", "x": [ 8, 10 ], "y": 19, "chance": 100, "repeat": [ 1, 2 ], "magazine": 100 },
        { "group": "guns_shotgun_rare_static_display", "x": [ 8, 10 ], "y": 19, "chance": 80, "magazine": 100 },
        { "group": "guns_rifle_rare_display", "x": [ 13, 16 ], "y": 19, "chance": 100, "magazine": 100 },
        { "group": "guns_smg_rare_display", "x": [ 13, 16 ], "y": 19, "chance": 80, "magazine": 100 },
        { "group": "ammo_rare", "x": [ 10, 13 ], "y": 17, "chance": 100, "repeat": [ 1, 4 ] },
        { "group": "ammo_pistol_common", "x": [ 7, 9 ], "y": [ 9, 10 ], "chance": 100, "repeat": [ 3, 8 ] },
        { "group": "ammo_rifle_common", "x": [ 7, 9 ], "y": 12, "chance": 100, "repeat": [ 1, 8 ] },
        { "group": "ammo_shotgun_common", "x": [ 7, 9 ], "y": 13, "chance": 100, "repeat": [ 1, 6 ] },
        { "group": "guns_pistol_common_display", "x": 14, "y": [ 9, 10 ], "chance": 85, "repeat": [ 1, 3 ] },
        { "group": "guns_shotgun_common_display", "x": 15, "y": [ 9, 10 ], "chance": 85, "repeat": [ 1, 3 ] },
        { "group": "guns_rifle_common_display", "x": 16, "y": [ 9, 10 ], "chance": 85, "repeat": [ 1, 3 ] },
        { "group": "mags_common", "x": [ 14, 16 ], "y": 12, "chance": 100, "repeat": [ 1, 8 ] },
        { "group": "mags_rare", "x": [ 14, 16 ], "y": 13, "chance": 75, "repeat": [ 1, 3 ] }
      ]
    }
  },
  {
    "type": "mapgen",
    "method": "json",
    "om_terrain": "s_gun_roof_1",
    "object": {
      "fill_ter": "t_flat_roof",
      "rows": [
        "                        ",
        "                        ",
        "  |222223      |222223  ",
        "  |.....3      |.....3  ",
        "  |.....3      |.....3  ",
        "  |.....3      |.....3  ",
        "  |.....3222222|.....3  ",
        "  |..................3  ",
        "  |..................3  ",
        "  |..................3  ",
        "  |..................3  ",
        "  |..................3  ",
        "  |..................3  ",
        "  |..................3  ",
        "  |..................3  ",
        "  |..................3  ",
        "  |..................3  ",
        "  |..................3  ",
        "  |..................3  ",
        "  |...>..............5  ",
        "  |------------------3  ",
        "                        ",
        "                        ",
        "                        "
      ],
      "palettes": [ "roof_palette" ],
      "terrain": { ">": "t_ladder_down" },
      "place_nested": [
        {
          "chunks": [
            [ "null", 20 ],
            [ "roof_2x2_utilities_b", 15 ],
            [ "roof_2x2_utilities_c", 5 ],
            [ "roof_2x2_utilities_d", 30 ],
            [ "roof_2x2_utilities", 30 ]
          ],
          "x": [ 4, 15 ],
          "y": [ 7, 8 ]
        },
        {
          "chunks": [
            [ "null", 20 ],
            [ "roof_4x4_party", 5 ],
            [ "roof_4x4_holdout", 15 ],
            [ "roof_4x4_utility", 40 ],
            [ "roof_4x4_utility_1", 10 ],
            [ "roof_6x6_survivor", 20 ],
            [ "roof_6x6_utility", 20 ]
          ],
          "x": [ 4, 13 ],
          "y": 12
        }
      ]
    }
  },
  {
    "type": "mapgen",
    "method": "json",
    "om_terrain": [ "s_gun_2" ],
    "//": "Public holdout based on Home Defense Gunstore. Uses same roof as s_gunstore_1.",
    "weight": 100,
    "object": {
      "fill_ter": "t_floor",
      "rows": [
        "_ssssssssssssssssssssss_",
        "_s@@@@@@@_ssss_@@@@@@@s_",
        "_s||555||_ssss_||555||s_",
        "_s|#####5_ssss_5#####|s_",
        "_s|..a..5_ssss_5..a..|s_",
        "_s|.#?#.5_ssss_5.#?#.|s_",
        "_s|.....|55++55|.....|s_",
        "_s|..................|s_",
        "_s|..................|s_",
        "_s|....rrr....rrr....|s_",
        "_s|u...rrr....rrr...u|s_",
        "_s|^................^|s_",
        "_||u...rrr....rrr...u|s_",
        "_A|....rrr....rrr....|s_",
        "_||..................|s_",
        "_s|..................|s_",
        "_s||D|*|&&&&&&&&||+|||s_",
        "_s|;.|.|..####..|..cE|s_",
        "_s|..|.|........*...E|s_",
        "_s|S.|<|lll##lll|l...|4_",
        "_s|||||||||||||||||+||s_",
        "_ssssssssssssssssssssss_",
        "________________________",
        "________________________"
      ],
      "terrain": {
        "&": "t_bars",
        "*": "t_door_locked_alarm",
        "+": "t_door_metal_pickable",
        ".": "t_floor",
        "5": "t_window_bars_alarm",
        ";": "t_floor",
        "@": "t_shrub",
        "A": "t_atm",
        "D": "t_door_c",
        "L": "t_door_metal_locked",
        "_": "t_pavement",
        "s": "t_sidewalk",
        "|": "t_wall_w",
        "?": "t_console_broken",
        "<": "t_ladder_up",
        "4": "t_gutter_downspout"
      },
      "furniture": {
        "#": "f_counter",
        "a": "f_stool",
        "E": "f_desk",
        "S": "f_sink",
        "^": "f_indoor_plant",
        "c": "f_chair",
        "l": "f_locker",
        "r": "f_rack",
        "u": "f_vending_reinforced"
      },
      "vendingmachines": { "u": { "item_group": "vending_ammo", "reinforced": true } },
      "toilets": { ";": {  } },
      "place_loot": [
        { "group": "guns_pistol_rare_display", "x": [ 8, 10 ], "y": 19, "chance": 100, "repeat": [ 1, 2 ], "magazine": 100 },
        { "group": "guns_shotgun_rare_static_display", "x": [ 8, 10 ], "y": 19, "chance": 80, "magazine": 100 },
        { "group": "guns_rifle_rare_display", "x": [ 13, 16 ], "y": 19, "chance": 100, "magazine": 100 },
        { "group": "guns_smg_rare_display", "x": [ 13, 16 ], "y": 19, "chance": 80, "magazine": 100 },
        { "group": "ammo_rare", "x": [ 10, 13 ], "y": 17, "chance": 100, "repeat": [ 1, 4 ] },
        { "group": "ammo_pistol_common", "x": [ 7, 9 ], "y": [ 9, 10 ], "chance": 100, "repeat": [ 3, 8 ] },
        { "group": "ammo_rifle_common", "x": [ 7, 9 ], "y": 12, "chance": 100, "repeat": [ 1, 8 ] },
        { "group": "ammo_shotgun_common", "x": [ 7, 9 ], "y": 13, "chance": 100, "repeat": [ 1, 6 ] },
        { "group": "guns_pistol_common_display", "x": 14, "y": [ 9, 10 ], "chance": 85, "repeat": [ 1, 3 ] },
        { "group": "guns_shotgun_common_display", "x": 15, "y": [ 9, 10 ], "chance": 85, "repeat": [ 1, 3 ] },
        { "group": "guns_rifle_common_display", "x": 16, "y": [ 9, 10 ], "chance": 85, "repeat": [ 1, 3 ] },
        { "group": "mags_common", "x": [ 14, 16 ], "y": 12, "chance": 100, "repeat": [ 1, 8 ] },
        { "group": "mags_rare", "x": [ 14, 16 ], "y": 13, "chance": 75, "repeat": [ 1, 3 ] }
      ]
    }
  },
  {
    "method": "json",
    "om_terrain": "s_gun_3",
    "type": "mapgen",
    "weight": 200,
    "object": {
      "fill_ter": "t_floor",
      "rows": [
        "_ssssssssssssssssssssss_",
        "_s@@@@@@@_ssss_@@@@@@@s_",
        "_s||555||_ssss_||555||s_",
        "_s|#####5_ssss_5#####|s_",
        "_s|..a..5_ssss_5..a..|s_",
        "_s|.#?#.5_ssss_5.#?#.|s_",
        "_s|.....|55++55|.....|s_",
        "_s|..................|s_",
        "_s|..................|s_",
        "_s|....rrr....rrr....|s_",
        "_s|u...rrr....rrr...u|s_",
        "_s|^................^|s_",
        "_||u...rrr....rrr...u|s_",
        "_A|....rrr....rrr....|s_",
        "_||..................|s_",
        "_s|..................|s_",
        "_s||D|*|&&&&&&&&||+|||s_",
        "_s|;.|.|..####..|..cE|s_",
        "_s|..|.|........*...E|s_",
        "_s|S.|<|lll##lll|l...|4_",
        "_s|||||||||||||||||+||s_",
        "_ssssssssssssssssssssss_",
        "________________________",
        "________________________"
      ],
      "terrain": {
        "&": "t_bars",
        "*": "t_door_locked_alarm",
        "+": "t_door_metal_pickable",
        ".": "t_floor",
        "5": "t_window_bars_alarm",
        ";": "t_floor",
        "@": "t_shrub",
        "A": "t_atm",
        "D": "t_door_c",
        "L": "t_door_metal_locked",
        "_": "t_pavement",
        "s": "t_sidewalk",
        "|": "t_wall_w",
        "?": "t_console_broken",
        "<": "t_ladder_up",
        "4": "t_gutter_downspout"
      },
      "furniture": {
        "#": "f_counter",
        "a": "f_stool",
        "E": "f_desk",
        "S": "f_sink",
        "^": "f_indoor_plant",
        "c": "f_chair",
        "l": "f_locker",
        "r": "f_rack",
        "u": "f_vending_reinforced"
      },
      "vendingmachines": { "u": { "item_group": "vending_ammo", "reinforced": true } },
      "toilets": { ";": {  } },
      "place_loot": [
        { "group": "guns_pistol_rare_display", "x": [ 8, 10 ], "y": 19, "chance": 100, "repeat": [ 1, 2 ], "magazine": 100 },
        { "group": "guns_shotgun_rare_static_display", "x": [ 8, 10 ], "y": 19, "chance": 80, "magazine": 100 },
        { "group": "guns_rifle_rare_display", "x": [ 13, 16 ], "y": 19, "chance": 100, "magazine": 100 },
        { "group": "guns_smg_rare_display", "x": [ 13, 16 ], "y": 19, "chance": 80, "magazine": 100 },
        { "group": "ammo_rare", "x": [ 10, 13 ], "y": 17, "chance": 100, "repeat": [ 1, 4 ] },
        { "group": "ammo_pistol_common", "x": [ 7, 9 ], "y": [ 9, 10 ], "chance": 100, "repeat": [ 3, 8 ] },
        { "group": "ammo_rifle_common", "x": [ 7, 9 ], "y": 12, "chance": 100, "repeat": [ 1, 8 ] },
        { "group": "ammo_shotgun_common", "x": [ 7, 9 ], "y": 13, "chance": 100, "repeat": [ 1, 6 ] },
        { "group": "guns_pistol_common_display", "x": 14, "y": [ 9, 10 ], "chance": 85, "repeat": [ 1, 3 ] },
        { "group": "guns_shotgun_common_display", "x": 15, "y": [ 9, 10 ], "chance": 85, "repeat": [ 1, 3 ] },
        { "group": "guns_rifle_common_display", "x": 16, "y": [ 9, 10 ], "chance": 85, "repeat": [ 1, 3 ] },
        { "group": "mags_common", "x": [ 14, 16 ], "y": 12, "chance": 100, "repeat": [ 1, 8 ] },
        { "group": "mags_rare", "x": [ 14, 16 ], "y": 13, "chance": 75, "repeat": [ 1, 3 ] }
      ]
    }
  },
  {
    "type": "mapgen",
    "method": "json",
    "om_terrain": "s_gun_roof_3",
    "object": {
      "fill_ter": "t_flat_roof",
      "rows": [
        "                        ",
        "                        ",
        "  |222223      |222223  ",
        "  |.....3      |.....3  ",
        "  |.....3      |.....3  ",
        "  |.....3      |.....3  ",
        "  |.....3222222|.....3  ",
        "  |..................3  ",
        "  |..................3  ",
        "  |..................3  ",
        "  |..................3  ",
        "  |..................3  ",
        "  |..................3  ",
        "  |..................3  ",
        "  |..................3  ",
        "  |..................3  ",
        "  |..................3  ",
        "  |..................3  ",
        "  |..................3  ",
        "  |...>..............5  ",
        "  |------------------3  ",
        "                        ",
        "                        ",
        "                        "
      ],
      "palettes": [ "roof_palette" ],
      "terrain": { ">": "t_ladder_down" },
      "place_nested": [
        {
          "chunks": [
            [ "null", 20 ],
            [ "roof_2x2_utilities_b", 15 ],
            [ "roof_2x2_utilities_c", 5 ],
            [ "roof_2x2_utilities_d", 30 ],
            [ "roof_2x2_utilities", 30 ]
          ],
          "x": [ 4, 15 ],
          "y": [ 7, 8 ]
        },
        {
          "chunks": [
            [ "null", 20 ],
            [ "roof_4x4_party", 5 ],
            [ "roof_4x4_holdout", 15 ],
            [ "roof_4x4_utility", 40 ],
            [ "roof_4x4_utility_1", 10 ],
            [ "roof_6x6_survivor", 20 ],
            [ "roof_6x6_utility", 20 ]
          ],
          "x": [ 4, 13 ],
          "y": 12
        }
      ]
    }
  }
]
