[
  {
    "type": "mapgen",
    "method": "json",
    "om_terrain": [ "s_gun" ],
    "weight": 200,
    "object": {
      "fill_ter": "t_floor",
      "rows": [
        "  BBBBBBBBBBBBBBBBBBBB '",
        "  B|A|A|BBBBBBBBBBBBBB  ",
        "  |------  BB  --:::-|  ",
        "  |T...{:  BB  :....S|  ",
        "  |T...{:  BB  :....S|  ",
        "  |T...{|--++--|....S|  ",
        "  |T................S|  ",
        "  |T................S|  ",
        "  :T....{{..{{..{{..S|  ",
        "  :T....{{..{{..{{..S|  ",
        "  |T....{{..{{..{{..T|  ",
        "  |---..............T|  ",
        "  |&N|...TT#?#T.....T|  ",
        "  |..D......h.T.....T|  ",
        "  |--------------+-+-|  ",
        " 4|$CCCCCCCCCCCCCC|.<|  ",
        "  |--H--H--H--H--H-+-|  ",
        "  |~~~~~~~~~~~~~~~~~~|  ",
        "  |~~~~~~~~~~~~~~~~~~|  ",
        "  |~~~~~~~~~~~~~~~~~~|  ",
        "  |~~@~~@~~@~~@~~@~~~|  ",
        "  |ssssssssssssssssss|  ",
        "  ====================  ",
        "                  UUU   "
      ],
      "terrain": {
        " ": "t_region_groundcover_urban",
        "'": "t_region_groundcover_urban",
        "*": "t_pavement_y",
        "+": "t_door_metal_pickable",
        "-": "t_wall_w",
        ".": "t_floor",
        ":": "t_window_bars_alarm",
        "=": "t_strconc_wall",
        "_": "t_pavement",
        "~": "t_thconc_floor",
        "H": "t_thconc_floor",
        "C": "t_thconc_floor",
        "s": "t_thconc_floor",
        "l": "t_thconc_floor",
        "$": "t_thconc_floor",
        "@": "t_thconc_floor",
        "|": "t_wall_w",
        "D": "t_door_c",
        "?": "t_console_broken",
        "<": "t_ladder_up",
        "4": "t_gutter_downspout",
        "A": "t_atm",
        "B": "t_sidewalk",
        "U": "t_region_groundcover_urban"
      },
      "toilets": { "&": {  } },
      "furniture": {
        "'": "f_street_light",
        "#": "f_counter",
        "H": "f_counter",
        "h": "f_stool",
        "l": "f_locker",
        "s": "f_sandbag_wall",
        "{": "f_rack",
        "$": "f_vending_reinforced",
        "N": "f_sink",
        "S": "f_displaycase",
        "T": "f_displaycase",
        "U": "f_dumpster",
        "@": "f_target"
      },
      "vendingmachines": { "$": { "item_group": "vending_guns", "reinforced": true } },
      "items": {
        "{": {
          "item": {
            "subtype": "distribution",
            "entries": [
              { "group": "mags_pistol_common", "prob": 5 },
              { "group": "mags_pistol_rare", "prob": 2 },
              { "group": "mags_smg_common", "prob": 2 },
              { "group": "mags_smg_rare", "prob": 1 },
              { "group": "mags_rifle_common", "prob": 3 },
              { "group": "mags_rifle_rare", "prob": 1 },
              { "group": "mags_shotgun_common", "prob": 3 },
              { "group": "mags_shotgun_rare", "prob": 1 },
              { "group": "gunmod_common", "prob": 2 },
              { "group": "gunmod_rare", "prob": 1 }
            ]
          },
          "chance": 70,
          "repeat": [ 1, 3 ]
        },
        "S": {
          "item": {
            "subtype": "distribution",
            "entries": [ { "group": "ammo_common", "prob": 15 }, { "group": "ammo_rare", "prob": 5 }, { "group": "ammo_obscure", "prob": 1 } ]
          },
          "chance": 70,
          "repeat": [ 2, 5 ]
        },
        "T": { "item": "guns_common_display", "chance": 70 },
        "l": { "item": "SUS_janitors_closet", "chance": 60 },
        "H": { "item": "ear_protection", "chance": 80 },
        "U": { "item": "trash_dumpster", "chance": 80 },
        "C": { "item": "casings", "chance": 50, "repeat": [ 10, 100 ] }
      },
      "place_monsters": [ { "monster": "GROUP_ZOMBIE_GUNSTORE", "x": [ 2, 21 ], "y": 0, "chance": 2, "repeat": [ 2, 3 ] } ]
    }
  },
  {
    "type": "mapgen",
    "method": "json",
    "om_terrain": "s_gun_roof",
    "object": {
      "fill_ter": "t_flat_roof",
      "rows": [
        "                        ",
        "                        ",
        "  -------      -------  ",
        "  -.....-      -.....-  ",
        "  -..X..-      -.....-  ",
        "  -.....--------.....-  ",
        "  -..................-  ",
        "  -..................-  ",
        "  -..................-  ",
        "  -..................-  ",
        "  -..................-  ",
        "  -..................-  ",
        "  -..................-  ",
        "  -..................-  ",
        "  -..................-  ",
        "  5.................>-  ",
        "  -..................-  ",
        "  -..................-  ",
        "  -..................-  ",
        "  -..................-  ",
        "  -..................-  ",
        "  -..................-  ",
        "  --------------------  ",
        "                        "
      ],
      "palettes": [ "roof_palette" ],
      "terrain": { ">": "t_ladder_down" },
      "place_nested": [
        {
          "chunks": [
            [ "null", 20 ],
            [ "roof_2x2_utilities_b", 15 ],
            [ "roof_2x2_utilities_c", 5 ],
            [ "roof_2x2_utilities_d", 30 ],
            [ "roof_2x2_utilities", 30 ],
            [ "roof_2x2_golf", 10 ],
            [ "roof_3x3_wine", 10 ]
          ],
          "x": [ 4, 16 ],
          "y": [ 7, 8 ]
        },
        {
          "chunks": [
            [ "null", 20 ],
            [ "roof_4x4_party", 5 ],
            [ "roof_4x4_holdout", 15 ],
            [ "roof_4x4_utility", 40 ],
            [ "roof_4x4_utility_1", 10 ],
            [ "roof_6x6_survivor", 20 ],
            [ "roof_6x6_utility", 20 ]
          ],
          "x": [ 4, 13 ],
          "y": [ 11, 16 ]
        }
      ]
    }
  },
  {
    "type": "mapgen",
    "method": "json",
    "om_terrain": [ "s_gun_1" ],
    "//": "Home defense gun store",
    "weight": 300,
    "object": {
      "fill_ter": "t_floor",
      "rows": [
        "_ssssssssssssssssssssss'",
        "_s@@@@@@@_ssss_@@@@@@@s_",
        "_s|-:::-|_ssss_|-:::-|s_",
        "_s|TTTTT:_ssss_:TTTTT|s_",
        "_s|.....:_ssss_:.....|s_",
        "_s|.....:_ssss_:.....|s_",
        "_s|.....|::++::|.....|s_",
        "_s:S................S:s_",
        "_s:S................S:s_",
        "_s|S...{{{....{{{...S|s_",
        "_s|S...{{{....{{{...S|s_",
        "_s|S................S|s_",
        "_||S...{{{....{{{...S|s_",
        "_A|....{{{....{{{....|s_",
        "_||..................|s_",
        "_s|..................|s_",
        "_s||D|+|.#?##?#.||+|||s_",
        "_s|;.|.|..h..h..|..cE|s_",
        "_s|..|.|........|...E|s_",
        "_s|N.|<|TTTTTTTT|l...|4_",
        "_s|--|-|-----------+-|s_",
        "_ssUUssssssssssssssssss_",
        "________________________",
        "________________________"
      ],
      "terrain": {
        "&": "t_bars",
        "*": "t_door_locked_alarm",
        "+": "t_door_metal_pickable",
        ".": "t_floor",
        ":": "t_window_bars_alarm",
        ";": "t_floor",
        "@": "t_shrub",
        "A": "t_atm",
        "D": "t_door_c",
        "L": "t_door_metal_locked",
        "_": "t_pavement",
        "'": "t_pavement",
        "s": "t_sidewalk",
        "|": "t_wall_w",
        "-": "t_wall_w",
        "?": "t_console_broken",
        "<": "t_ladder_up",
        "4": "t_gutter_downspout"
      },
      "mapping": { "U": { "terrain": "t_sidewalk", "furniture": "f_dumpster" } },
      "furniture": {
        "'": "f_street_light",
        "#": "f_counter",
        "h": "f_stool",
        "E": "f_desk",
        "N": "f_sink",
        "^": "f_indoor_plant",
        "c": "f_chair",
        "l": "f_locker",
        "{": "f_rack",
        "$": "f_vending_reinforced",
        "S": "f_displaycase",
        "T": "f_displaycase"
      },
      "vendingmachines": { "$": { "item_group": "vending_guns", "reinforced": true } },
      "toilets": { ";": {  } },
      "items": {
        "{": {
          "item": {
            "subtype": "distribution",
            "entries": [
              { "group": "mags_pistol_common", "prob": 5 },
              { "group": "mags_pistol_rare", "prob": 2 },
              { "group": "mags_smg_common", "prob": 2 },
              { "group": "mags_smg_rare", "prob": 1 },
              { "group": "mags_rifle_common", "prob": 3 },
              { "group": "mags_rifle_rare", "prob": 1 },
              { "group": "mags_shotgun_common", "prob": 3 },
              { "group": "mags_shotgun_rare", "prob": 1 },
              { "group": "gunmod_common", "prob": 2 },
              { "group": "gunmod_rare", "prob": 1 }
            ]
          },
          "chance": 70,
          "repeat": [ 1, 2 ]
        },
        "S": {
          "item": {
            "subtype": "distribution",
            "entries": [ { "group": "ammo_common", "prob": 15 }, { "group": "ammo_rare", "prob": 5 }, { "group": "ammo_obscure", "prob": 1 } ]
          },
          "chance": 70,
          "repeat": [ 2, 5 ]
        },
        "T": { "item": "guns_common_display", "chance": 70 },
        "l": { "item": "SUS_janitors_closet", "chance": 60 },
        "U": { "item": "trash_dumpster", "chance": 80 }
      },
      "place_monsters": [ { "monster": "GROUP_ZOMBIE_GUNSTORE", "x": [ 2, 21 ], "y": 0, "chance": 2, "repeat": [ 2, 3 ] } ]
    }
  },
  {
    "type": "mapgen",
    "method": "json",
    "om_terrain": "s_gun_roof_1",
    "object": {
      "fill_ter": "t_flat_roof",
      "rows": [
        "                        ",
        "                        ",
        "  -------      -------  ",
        "  -.....-      -.....-  ",
        "  -.....-      -.....-  ",
        "  -.....-      -.....-  ",
        "  -.....--------.....-  ",
        "  -..................-  ",
        "  -..................-  ",
        "  -..................-  ",
        "  -..................-  ",
        "  -..................-  ",
        "  -..................-  ",
        "  -..................-  ",
        "  -..................-  ",
        "  -..................-  ",
        "  -..................-  ",
        "  -..................-  ",
        "  -..................-  ",
        "  -...>..............5  ",
        "  --------------------  ",
        "                        ",
        "                        ",
        "                        "
      ],
      "palettes": [ "roof_palette" ],
      "terrain": { ">": "t_ladder_down" },
      "place_nested": [
        {
          "chunks": [
            [ "null", 20 ],
            [ "roof_2x2_utilities_b", 15 ],
            [ "roof_2x2_utilities_c", 5 ],
            [ "roof_2x2_utilities_d", 30 ],
            [ "roof_2x2_utilities", 30 ]
          ],
          "x": [ 4, 15 ],
          "y": [ 7, 8 ]
        },
        {
          "chunks": [
            [ "null", 20 ],
            [ "roof_4x4_party", 5 ],
            [ "roof_4x4_holdout", 15 ],
            [ "roof_4x4_utility", 40 ],
            [ "roof_4x4_utility_1", 10 ],
            [ "roof_6x6_survivor", 20 ],
            [ "roof_6x6_utility", 20 ]
          ],
          "x": [ 4, 13 ],
          "y": 12
        }
      ]
    }
  },
  {
    "type": "mapgen",
    "method": "json",
    "om_terrain": [ "s_gun_2" ],
    "//": "Public holdout based on Home Defense Gunstore. Uses same roof as s_gunstore_1.",
    "weight": 50,
    "object": {
      "fill_ter": "t_floor",
      "rows": [
        "_ssssssssssssssssssssss'",
        "_s@@xx@@@_ssss_@@@@@@@s_",
        "_s||5l5||_ssss_||555||s_",
        "_s|#lll#5_ssss_5#####|s_",
        "_s|r##r#5_ssss_5l....|s_",
        "_s|.rr.#5_ssss_5#....|s_",
        "_s|.....|55++55|#....|s_",
        "_s|......##ll##......|s_",
        "_s|..................|s_",
        "_s|...........r......|s_",
        "_s|u...r............u|s_",
        "_s|^................^|s_",
        "_||u......rrrr......u|s_",
        "_A|......rr..rr....7.|s_",
        "_||.....rr...........|s_",
        "_s|....rr..B.B.rrr.r.|s_",
        "_s||D|D|&&&&&&&&||p|||s_",
        "_s|;.|.|B.......|..c.|s_",
        "_s|..|.|........C.#..|s_",
        "_s|S.|<|B...B...|.EE#|4_",
        "_s|||||||||||||||||L||s_",
        "_ssssssssssssssssssssss_",
        "________________________",
        "________________________"
      ],
      "terrain": {
        "&": "t_bars",
        "*": "t_door_locked_alarm",
        "+": "t_door_metal_pickable",
        ".": "t_floor",
        "5": "t_window_bars_alarm",
        "@": "t_shrub",
        "A": "t_atm",
        "C": "t_door_frame",
        "D": "t_door_o",
        "L": "t_door_metal_locked",
        "_": "t_pavement",
        "'": "t_pavement",
        "p": "t_door_metal_o",
        "s": "t_sidewalk",
        "|": "t_wall_w",
        "x": "t_dirt",
        "<": "t_ladder_up",
        "4": "t_gutter_downspout"
      },
      "furniture": {
        "'": "f_street_light",
        "#": "f_counter",
        "E": "f_desk",
        "S": "f_sink",
        "^": "f_indoor_plant",
        "c": "f_chair",
        "l": "f_locker",
        "r": "f_rack",
        "x": "f_locker",
        "u": "f_vending_o"
      },
      "toilets": { ";": {  } },
      "items": { "B": { "item": "bed", "chance": 65, "repeat": [ 1, 3 ] } },
      "monster": { "7": { "monster": "mon_zombie_cop" } },
      "place_monsters": [
        { "monster": "GROUP_ZOMBIE_GUNSTORE", "x": [ 11, 13 ], "y": [ 17, 19 ], "density": 0.08 },
        { "monster": "GROUP_ZOMBIE_GUNSTORE", "x": 18, "y": [ 14, 15 ], "density": 0.08 }
      ],
      "place_fields": [
        { "field": "fd_blood", "x": [ 10, 11 ], "y": [ 14, 15 ], "repeat": [ 2, 4 ] },
        { "field": "fd_gibs_flesh", "x": 10, "y": 15, "repeat": [ 1, 5 ] },
        { "field": "fd_blood", "x": 12, "y": [ 14, 15 ], "repeat": [ 2, 3 ] }
      ],
      "place_loot": [
        { "item": "corpse", "x": 10, "y": 14, "chance": 100 },
        { "item": "corpse", "x": 12, "y": 15, "chance": 100 },
        {
          "group": "guns_pistol_common_display",
          "x": 10,
          "y": 14,
          "chance": 100,
          "repeat": [ 1, 3 ],
          "magazine": 100
        },
        { "group": "guns_shotgun_common_display", "x": 12, "y": 15, "chance": 100, "repeat": [ 1, 3 ] },
        { "group": "ammo_common", "x": [ 8, 12 ], "y": [ 17, 19 ], "chance": 90, "repeat": [ 1, 8 ] },
        { "group": "guns_pistol_common_display", "x": 10, "y": 14, "chance": 10, "magazine": 100 },
        { "group": "guns_shotgun_common_display", "x": 12, "y": 15, "chance": 10, "magazine": 100 },
        { "group": "default_zombie_death_drops", "x": 10, "y": 14, "chance": 100 },
        { "group": "default_zombie_death_drops", "x": 12, "y": 15, "chance": 100 },
        { "item": "can_food_unsealed", "x": 8, "y": 18, "chance": 100, "repeat": [ 1, 3 ] },
        { "item": "can_food_unsealed", "x": 11, "y": 17, "chance": 100, "repeat": [ 1, 2 ] },
        { "group": "vending_food_items", "x": [ 11, 13 ], "y": [ 17, 19 ], "chance": 100, "repeat": [ 2, 8 ] },
        { "item": "bottle_plastic_small", "x": [ 11, 12 ], "y": [ 17, 19 ], "chance": 100, "repeat": [ 1, 3 ] },
        { "item": "pipe", "x": 18, "y": [ 14, 15 ], "chance": 100, "repeat": [ 6, 18 ] },
        { "item": "sheet_metal_small", "x": 18, "y": [ 14, 15 ], "chance": 100, "repeat": [ 1, 5 ] },
        { "item": "pipe", "x": [ 14, 15 ], "y": 14, "chance": 100, "repeat": [ 6, 18 ] },
        { "item": "sheet_metal_small", "x": [ 14, 15 ], "y": 14, "chance": 100, "repeat": [ 1, 5 ] }
      ]
    }
  },
  {
    "method": "json",
    "om_terrain": "s_gun_3",
    "type": "mapgen",
    "weight": 30,
    "object": {
      "fill_ter": "t_floor",
      "rows": [
        "....d...d....dss..dd.d.'",
        ".......d......ss........",
        "d.............ssd.d.....",
        "..d....d..d.dssss......d",
        "....dwWeaWwwWaffaWwwa...",
        "d....W{_Cc__^____DDDWu..",
        "d....ar__D_________Dw...",
        ".d...|r__D_________$|u.d",
        "...u4|__cc_________$|u..",
        "d.||||______DDD__||||...",
        ".u|{_|||||_______+_C|u.d",
        ".u|{_+______||+|||_t|...",
        "d.|{_|___|&_|;_N|i_H|...",
        "..|||||e|||g|||||||||...",
        ".u-___________tt_tt_-u..",
        "du-_________________-u..",
        "..-b#-bdSSSSbS.SS-Sb-...",
        "..-ddd..........dddd-..d",
        "du-ddddd.d.....ddddd-u..",
        "..-ddddddddddddddddd-..d",
        ".u-ddddddddddddddddd-..d",
        "d.-#dTdddddTdddddTd#-u..",
        "..-#################-...",
        ".d-------------------.d."
      ],
      "terrain": {
        "#": "t_dirt",
        "+": "t_door_metal_pickable",
        "-": "t_brick_wall",
        ".": "t_grass",
        "'": "t_dirt",
        "S": "t_grass",
        "T": "t_dirt",
        "W": "t_wall_w",
        "_": "t_floor",
        "a": "t_wall_r",
        "b": "t_dirt",
        "d": "t_dirt",
        "e": "t_window_boarded",
        "f": "t_door_boarded",
        "g": "t_door_c",
        "s": "t_sidewalk",
        "u": "t_underbrush",
        "w": "t_wall_b",
        "|": "t_wall_w",
        "4": "t_gutter_downspout"
      },
      "toilets": { ";": {  } },
      "place_item": [ { "item": "corpse", "repeat": 1, "x": 19, "y": 12 } ],
      "furniture": {
        "'": "f_street_light",
        "#": "f_sandbag_wall",
        "&": "f_trashcan",
        "C": "f_chair",
        "D": "f_displaycase",
        "H": "f_armchair",
        "S": "f_sandbag_half",
        "T": "f_table",
        "^": "f_indoor_plant_y",
        "b": "f_sandbag_half",
        "c": "f_counter",
        "i": "f_indoor_plant",
        "r": "f_rack",
        "t": "f_table",
        "N": "f_sink",
        "{": "f_locker",
        "$": "f_vending_reinforced"
      },
      "vendingmachines": { "$": { "item_group": "vending_guns", "reinforced": true } },
      "place_items": [
        { "chance": 99, "item": "corpse_male", "x": 19, "y": 12 },
        { "chance": 75, "item": "ammo_casings_bulk", "x": [ 14, 15 ], "y": 14 },
        { "chance": 65, "item": "guns_pistol_common_display", "x": 19, "y": 8 },
        { "chance": 75, "item": "guns_common_display", "x": 3, "y": 10 },
        { "chance": 40, "item": "gunmod_rare", "x": 3, "y": 12 },
        { "chance": 85, "item": "book_gunmags", "x": 9, "y": 8 },
        { "chance": 5, "item": "guns_pistol_common_display", "x": 3, "y": 11 },
        { "chance": 75, "item": "ammo_rifle_common", "x": 18, "y": 14 },
        { "chance": 75, "item": "ammo_rifle_common", "x": 6, "y": 7 },
        { "chance": 60, "item": "gunmod_common", "x": [ 12, 14 ], "y": 9 },
        { "chance": 95, "item": "ammo_common", "x": 6, "y": [ 5, 6 ] },
        { "chance": 85, "item": "guns_rifle_common_display", "x": [ 17, 18 ], "y": 5 },
        { "chance": 95, "item": "guns_common_display", "x": 9, "y": [ 6, 7 ] },
        { "chance": 95, "item": "guns_common_display", "x": 19, "y": [ 5, 7 ] },
        { "chance": 45, "item": "trash", "x": 13, "y": 12 },
        { "chance": 45, "item": "trash", "x": 10, "y": 12 }
      ],
      "place_monsters": [ { "monster": "GROUP_ZOMBIE_GUNSTORE", "x": [ 2, 21 ], "y": 2, "chance": 2, "repeat": [ 2, 3 ] } ]
    }
  },
  {
    "type": "mapgen",
    "method": "json",
    "om_terrain": "s_gun_roof_3",
    "object": {
      "fill_ter": "t_flat_roof",
      "rows": [
        "                        ",
        "                        ",
        "                        ",
        "                        ",
        "     ----------------   ",
        "     -..............-   ",
        "     -..............-   ",
        "     -..............-   ",
        "     -..............-   ",
        "  ---5..............-   ",
        "  -.................-   ",
        "  -.................-   ",
        "  -.................-   ",
        "  -------------------   ",
        "  NNNNNNNNNNNNNNNNNNN   ",
        "  NNNNNNNNNNNNNNNNNNN   ",
        "  N  N           N  N   ",
        "  N                 N   ",
        "  N                 N   ",
        "  N                 N   ",
        "  N                 N   ",
        "  N                 N   ",
        "  N                 N   ",
        "  NNNNNNNNNNNNNNNNNNN   "
      ],
      "palettes": [ "roof_palette" ],
      "terrain": { "N": "t_open_air_rooved" },
      "place_nested": [
        {
          "chunks": [
            [ "null", 20 ],
            [ "roof_2x2_utilities_b", 15 ],
            [ "roof_2x2_utilities_c", 5 ],
            [ "roof_2x2_utilities_d", 40 ],
            [ "roof_2x2_utilities", 50 ]
          ],
          "x": [ 7, 17 ],
          "y": [ 6, 10 ]
        }
      ]
    }
  }
]
