[
  {
    "type": "mapgen",
    "method": "json",
    "om_terrain": [ "s_liquor" ],
    "weight": 1000,
    "object": {
      "fill_ter": "t_floor",
      "rows": [
        "               _       '",
        "               _        ",
        "   ||:|||||||||+||:||   ",
        "   |#..#####....cs..|   ",
        "   |#..##.......c...|   ",
        "   |#..##..##...ccc.|   ",
        "   |#..##..##.......|   ",
        "   |#..##..........&|   ",
        "   |.......#####...&|   ",
        "   |||+|...#####...&|   ",
        "   |S..|...........&|   ",
        "   |U..|.........&&&|   ",
        "   |||||||||+||||||||   ",
        "   _4{{{|K=====<|..L|   ",
        "   __{{{|KK=====+..B|   ",
        "   _____|KKK====|..L|   ",
        "   _____|KKK====|||||   ",
        "   _____|KK====*|{{{_   ",
        "   _____|^^^^^^||____   ",
        "   ____________*_____   ",
        "   __________________   ",
        "   __________________   ",
        "   __________________   ",
        "   __________________   "
      ],
      "terrain": {
        " ": "t_region_groundcover_urban",
        "'": "t_region_groundcover_urban",
        ".": "t_floor",
        ":": "t_window",
        "_": "t_concrete",
        "{": "t_concrete",
        "|": "t_wall_g",
        "=": "t_thconc_floor",
        "K": "t_thconc_floor",
        "<": "t_ladder_up",
        "^": "t_door_metal_locked",
        "*": "t_gates_mech_control",
        "4": "t_gutter_downspout",
        "+": "t_door_c"
      },
      "furniture": {
        "'": "f_street_light",
        "#": "f_rack",
        "&": "f_glass_fridge",
        "c": "f_counter",
        "s": "f_stool",
        "B": "f_bench",
        "L": "f_locker",
        "S": "f_sink",
        "{": "f_dumpster"
      },
      "place_items": [
        { "item": "alcohol", "x": 4, "y": [ 3, 7 ], "chance": 96, "repeat": [ 1, 6 ] },
        { "item": "alcohol", "x": [ 7, 11 ], "y": 3, "chance": 96, "repeat": [ 1, 6 ] },
        { "item": "alcohol", "x": [ 7, 8 ], "y": [ 4, 7 ], "chance": 96, "repeat": [ 1, 6 ] },
        { "item": "alcohol", "x": [ 11, 15 ], "y": [ 8, 9 ], "chance": 96, "repeat": [ 1, 6 ] },
        { "item": "snacks", "x": [ 11, 12 ], "y": [ 5, 6 ], "chance": 85, "repeat": [ 1, 12 ] },
        { "item": "fridgesnacks", "x": 19, "y": [ 7, 10 ], "chance": 90, "repeat": [ 1, 12 ] },
        { "item": "fridgesnacks", "x": [ 17, 19 ], "y": 11, "chance": 90, "repeat": [ 1, 12 ] },
        { "item": "behindcounter", "x": [ 17, 19 ], "y": [ 3, 4 ], "chance": 80, "repeat": [ 1, 6 ] },
        { "item": "liqstore_brew", "x": 16, "y": [ 3, 5 ], "chance": 70, "repeat": [ 1, 12 ] },
        { "item": "liqstore_brew", "x": [ 17, 18 ], "y": 5, "chance": 70, "repeat": [ 1, 12 ] }
      ],
      "items": {
        "K": { "item": "keg_beer", "chance": 70 },
        "L": { "item": "jackets", "chance": 50 },
        "{": { "item": "trash_dumpster", "chance": 80 }
      },
      "toilets": { "U": {  } },
      "place_monsters": [ { "monster": "GROUP_ZOMBIE", "x": [ 2, 21 ], "y": [ 20, 22 ], "chance": 2, "repeat": [ 2, 3 ] } ],
      "vehicles": { ".": { "vehicle": "shopping_cart", "chance": 1, "status": 1 } }
    }
  },
  {
    "type": "mapgen",
    "method": "json",
    "om_terrain": "s_liquor_roof",
    "object": {
      "fill_ter": "t_flat_roof",
      "rows": [
        "                        ",
        "                        ",
        "   ------------------   ",
        "   -................-   ",
        "   -................-   ",
        "   -................-   ",
        "   -................-   ",
        "   -................-   ",
        "   -................-   ",
        "   -................-   ",
        "   -.&..............-   ",
        "   -.=..............-   ",
        "   -5----...........-   ",
        "        -......>....-   ",
        "        -...........-   ",
        "        -...........-   ",
        "        -.......-----   ",
        "        -.......-       ",
        "        ---------       ",
        "                        ",
        "                        ",
        "                        ",
        "                        ",
        "                        "
      ],
      "palettes": [ "roof_palette" ],
      "terrain": { ">": "t_ladder_down" },
      "place_nested": [
        {
          "chunks": [
            [ "null", 20 ],
            [ "roof_2x2_utilities_b", 15 ],
            [ "roof_2x2_utilities_c", 5 ],
            [ "roof_2x2_utilities_d", 40 ],
            [ "roof_2x2_golf", 20 ],
            [ "roof_3x3_wine", 10 ]
          ],
          "x": [ 10, 11 ],
          "y": 12
        },
        {
          "chunks": [
            [ "null", 50 ],
            [ "roof_4x4_party", 10 ],
            [ "roof_4x4_holdout", 5 ],
            [ "roof_4x4_utility", 40 ],
            [ "roof_4x4_survivor", 5 ]
          ],
          "x": [ 5, 15 ],
          "y": [ 4, 5 ]
        }
      ]
    }
  }
]
