[
  {
    "type": "mapgen",
    "method": "json",
    "om_terrain": [ [ "shootingrange_1a" ], [ "shootingrange_2a" ] ],
    "object": {
      "fill_ter": "t_floor",
      "rows": [
        "zzzzzzzzzzzzzzzzzzzzzzzz",
        "_z------z_______________",
        "_z-fff$-z_______________",
        "_zWCdff+zzzzzzz_________",
        "_z-fffX-zzszzsz_________",
        "_z------zzzzzzz_________",
        "_zzzzzzzzzzzzzzzzzzzzzz_",
        "_======%========%======_",
        "_|ww|ww|ww|ww|ww|ww|ww|_",
        "_|cc|cc|cc|cc|cc|cc|cc|_",
        "_######################_",
        "_......................_",
        "_......................_",
        "_......................_",
        "_P@...................P_",
        "_..@..................._",
        "_......................_",
        "_......................_",
        "_......................_",
        "_P....@...............P_",
        "_....@................._",
        "_......................_",
        "_......................_",
        "_......................_",
        "_P.....@..............P_",
        "_......................_",
        "_......................_",
        "_......................_",
        "_......................_",
        "_P........@...........P_",
        "_..........@..........._",
        "_......................_",
        "_......................_",
        "_......................_",
        "_P............@.......P_",
        "_......................_",
        "_................@....._",
        "_...............@......_",
        "_......................_",
        "_P....................P_",
        "_...................@.._",
        "_......................_",
        "_0000000000000000000000_",
        "_0000000000000000000000_",
        "______zzzzzzzzzzzz______",
        "________________________",
        "________________________",
        "________________________"
      ],
      "terrain": {
        "_": [ [ "t_region_groundcover_forest", 20 ], [ "t_region_shrub", 5 ], [ "t_region_tree", 5 ] ],
        ".": "t_region_groundcover_barren",
        "s": "t_region_groundcover",
        "z": "t_region_groundcover",
        "@": "t_region_soil",
        "P": "t_region_soil",
        "#": "t_thconc_floor",
        "0": "t_dirtmound",
        "+": "t_door_metal_pickable",
        "-": "t_wall_w",
        "W": "t_window_bars_alarm",
        "c": "t_thconc_floor",
        "f": "t_floor",
        "w": "t_thconc_floor",
        "%": "t_thconc_floor",
        "=": "t_thconc_floor",
        "|": "t_wall_wood"
      },
      "furniture": {
        "&": "f_trashcan",
        "@": "f_target",
        "C": "f_chair",
        "P": "f_sign",
        "X": "f_gunsafe_ml",
        "c": "f_counter",
        "d": "f_desk",
        "s": "f_sign",
        "%": "f_trashcan"
      },
      "vendingmachines": { "$": { "item_group": "vending_guns", "reinforced": true } },
      "place_items": [
        { "chance": 10, "item": "ammo_pistol_common", "x": 6, "y": 9 },
        { "chance": 5, "item": "ammo_pistol_common", "x": 3, "y": 9 },
        { "chance": 5, "item": "guns_rifle_common", "x": 21, "y": 9 },
        { "chance": 5, "item": "guns_rifle_common", "x": 17, "y": 9 },
        { "chance": 5, "item": "ammo_shotgun_common", "x": 15, "y": 9 },
        { "chance": 5, "item": "ammo_rifle_common", "x": 20, "y": 9 },
        { "chance": 5, "item": "ammo_rifle_common", "x": 18, "y": 9 },
        { "chance": 5, "item": "guns_shotgun_common", "x": 14, "y": 9 },
        { "chance": 5, "item": "ammo_smg_common", "x": 12, "y": 9 },
        { "chance": 5, "item": "ammo_smg_common", "x": 9, "y": 9 },
        { "chance": 5, "item": "guns_smg_common", "x": 11, "y": 9 },
        { "chance": 5, "item": "guns_smg_common", "x": 8, "y": 9 },
        { "chance": 10, "item": "guns_pistol_common", "x": 5, "y": 9 },
        { "chance": 5, "item": "guns_pistol_common", "x": 2, "y": 9 },
        { "chance": 25, "item": "office", "x": 4, "y": 3 }
      ],
      "items": {
        "w": { "item": "casings", "chance": 60, "repeat": 4 },
        "%": { "item": "casings", "chance": 66, "repeat": 150 },
        "#": { "item": "casings", "chance": 40 },
        "c": { "item": "ear_protection", "chance": 10 },
        "X": { "item": "guns_safe", "chance": 100 },
        "d": { "item": "ear_protection", "chance": 80 }
      },
      "place_signs": [
        { "signage": "<family_name> Family Shooting Range", "x": 10, "y": 4 },
        { "signage": "Open sunrise to sunset, everyday besides Sundays", "x": 13, "y": 4 },
        { "signage": "5 YARDS", "x": 1, "y": 14 },
        { "signage": "5 YARDS", "x": 22, "y": 14 },
        { "signage": "10 YARDS", "x": 1, "y": 19 },
        { "signage": "10 YARDS", "x": 22, "y": 19 },
        { "signage": "15 YARDS", "x": 1, "y": 24 },
        { "signage": "15 YARDS", "x": 22, "y": 24 },
        { "signage": "20 YARDS", "x": 1, "y": 29 },
        { "signage": "20 YARDS", "x": 22, "y": 29 },
        { "signage": "25 YARDS", "x": 1, "y": 34 },
        { "signage": "25 YARDS", "x": 22, "y": 34 },
        { "signage": "30 YARDS", "x": 1, "y": 39 },
        { "signage": "30 YARDS", "x": 22, "y": 39 }
      ]
    }
  },
  {
    "type": "mapgen",
    "method": "json",
    "om_terrain": "shootingrange_1a_roof",
    "object": {
      "fill_ter": "t_shingle_flat_roof",
      "rows": [
        "                        ",
        "  ......                ",
        "  ......                ",
        "  ......                ",
        "  ......                ",
        "  ......                ",
        "                        ",
        " ...................... ",
        " ...................... ",
        " ...................... ",
        " ...................... ",
        "                        ",
        "                        ",
        "                        ",
        "                        ",
        "                        ",
        "                        ",
        "                        ",
        "                        ",
        "                        ",
        "                        ",
        "                        ",
        "                        ",
        "                        "
      ],
      "palettes": [ "roof_palette" ],
      "terrain": { ".": "t_shingle_flat_roof" }
    }
  }
]
