[
  {
    "type": "mapgen",
    "method": "json",
    "om_terrain": [ "s_thrift" ],
    "weight": 500,
    "object": {
      "fill_ter": "t_floor",
      "rows": [
        "_____________________ss'",
        "y____y____y____y____ysss",
        "y____y____y____y____ysss",
        "y____y____y____y____ysss",
        "y____y____y____y____ysss",
        "y____y____y____y____ysss",
        "yyyyyyyyyyyyyyyyyyyyysss",
        "ssssssssssssssssssssssss",
        "                ssss sss",
        " ||||--------||||gg||sss",
        " |I............-Voo.|s<s",
        " |H...A..A..A..-Woo.|+||",
        " |I...A..A..A..||gg||.L|",
        " |H...A..A.......oo.|+||",
        " |I...A..A.......oo.|.J|",
        " |.........C....CCCC|FJ|",
        " |F.F.H....C....CF..+.K|",
        " |F.F.H......oo.....||||",
        " |....H..AAAAooAAA...A| ",
        " |+||........oo......A| ",
        " |.B|AAAAAAAAooAAA...A| ",
        " ||||||||||||||||||+||| ",
        "   4           sUUssU   ",
        "                        "
      ],
      "terrain": {
        ".": "t_floor",
        "+": "t_door_locked",
        " ": "t_region_groundcover_urban",
        "s": "t_sidewalk",
        "U": "t_sidewalk",
        "-": "t_wall_glass",
        "g": "t_door_glass_c",
        "o": "t_carpet_purple",
        "_": "t_pavement",
        "'": "t_sidewalk",
        "y": "t_pavement_y",
        "|": "t_wall_w",
        "4": "t_gutter_downspout",
        "<": "t_ladder_up"
      },
      "furniture": {
        "'": "f_street_light",
        "A": "f_rack",
        "C": "f_counter",
        "D": "f_sink",
        "E": "f_sink",
        "F": "f_chair",
        "G": "f_locker",
        "H": "f_table",
        "I": "f_sofa",
        "J": "f_desk",
        "K": "f_filing_cabinet",
        "L": "f_locker",
        "U": "f_dumpster"
      },
      "vendingmachines": { "W": { "item_group": "vending_drink" }, "V": { "item_group": "vending_food" } },
      "toilets": { "B": {  } },
      "items": {
        "U": { "item": "trash_dumpster", "chance": 80 },
        "J": { "item": "office", "chance": 30 },
        "K": { "item": "office_paper", "chance": 30 },
        "L": { "item": "cleaning", "chance": 20, "repeat": [ 2, 4 ] }
      },
      "place_items": [
        { "item": "thrift_misc", "x": [ 9, 12 ], "y": 18, "chance": 75, "repeat": [ 1, 6 ] },
        { "item": "thrift_misc", "x": [ 15, 17 ], "y": 18, "chance": 75, "repeat": [ 1, 6 ] },
        { "item": "thrift_misc", "x": [ 5, 12 ], "y": 20, "chance": 75, "repeat": [ 1, 9 ] },
        { "item": "thrift_misc", "x": [ 15, 17 ], "y": 20, "chance": 75, "repeat": [ 1, 6 ] },
        { "item": "thrift_misc", "x": 6, "y": [ 11, 14 ], "chance": 75, "repeat": [ 1, 6 ] },
        { "item": "thrift_misc", "x": 9, "y": [ 11, 14 ], "chance": 75, "repeat": [ 1, 6 ] },
        { "item": "thrift_misc", "x": 12, "y": [ 11, 12 ], "chance": 75, "repeat": [ 1, 6 ] },
        { "item": "thrift_books", "x": 21, "y": [ 18, 20 ], "chance": 75, "repeat": [ 1, 10 ] }
      ]
    }
  },
  {
    "type": "mapgen",
    "method": "json",
    "om_terrain": "s_thrift_roof",
    "object": {
      "fill_ter": "t_flat_roof",
      "rows": [
        "                        ",
        "                        ",
        "                        ",
        "                        ",
        "                        ",
        "                        ",
        "                        ",
        "                        ",
        "                        ",
        " -------------------####",
        " -..................##>#",
        " -..................####",
        " -.....................-",
        " -.....................-",
        " -.....................-",
        " -.....................-",
        " -.....................-",
        " -....................--",
        " -....................- ",
        " -....................- ",
        " -....................- ",
        " --5------------------- ",
        "                        ",
        "                        "
      ],
      "palettes": [ "roof_palette" ],
      "terrain": { ">": "t_ladder_down" },
      "place_nested": [
        {
          "chunks": [
            [ "null", 20 ],
            [ "roof_2x2_utilities_b", 15 ],
            [ "roof_2x2_utilities_c", 5 ],
            [ "roof_2x2_utilities_d", 40 ],
            [ "roof_2x2_utilities", 50 ],
            [ "roof_2x2_golf", 20 ],
            [ "roof_3x3_wine", 30 ]
          ],
          "x": [ 3, 15 ],
          "y": [ 11, 13 ]
        },
        {
          "chunks": [
            [ "null", 20 ],
            [ "roof_4x4_party", 15 ],
            [ "roof_4x4_utility", 40 ],
            [ "roof_6x6_survivor", 20 ],
            [ "roof_6x6_utility", 20 ]
          ],
          "x": [ 3, 12 ],
          "y": 15
        }
      ]
    }
  }
]
