[
  {
    "type": "mapgen",
    "method": "json",
    "om_terrain": "trailerparksmall0",
    "object": {
      "fill_ter": "t_floor",
      "rows": [
        "      d   dddd  d  dd   ",
        "     d|||||||||||||WW||d",
        " cccc||T,|,,|,,tt|FoCa| ",
        " cccc||,,|,,+,,,b|,,,,| ",
        " cccc||,,|,,|,,,,,,,,,|d",
        " cccc||S,+,@|,,,,,,,,,|d",
        " cccc||j,|,@|HH,,,,,,^| ",
        " ccccd||||W|||W|||||+||d",
        " cccc ddd sd dd  ds g   ",
        " .......................",
        "{.......................",
        "{.......................",
        "{.......................",
        " .......................",
        " .......................",
        " cccc    dd  sss   g d  ",
        " cccc ||||W|||W||||+||| ",
        " cccc||,,|,@|HHHt,,,,&|d",
        " cccc||S,+,@|,,,,,,,,,| ",
        " cccc||,,|,,|,,,,,,,,,|d",
        " cccc||,,|,,+,,b,|a,,,|d",
        " cccc||jT|,,|,,tt|aoCF| ",
        "     d|||||||||||||WW||d",
        "       d     d  d  d d  "
      ],
      "palettes": [ "trailer_park" ],
      "items": { "{": { "item": "trash_dumpster", "chance": 80 }, "F": { "item": "SUS_fridge", "chance": 100 } },
      "place_items": [
        { "chance": 10, "item": "kitchen_nonfood", "x": 20, "y": 3 },
        { "chance": 20, "item": "cannedfood", "x": 20, "y": 21 },
        { "chance": 20, "item": "alcohol", "x": 19, "y": 21 },
        { "chance": 30, "item": "livingroom", "x": 15, "y": 3 },
        { "chance": 5, "item": "hardware", "x": 4, "y": 6 },
        { "chance": 25, "item": "trash", "x": 0, "y": [ 11, 12 ] },
        { "chance": 35, "item": "fast_trash", "x": 0, "y": 10 },
        { "chance": 15, "item": "stoner", "x": 16, "y": 3 },
        { "chance": 35, "item": "magazines", "x": 16, "y": 17 },
        { "chance": 20, "item": "clutter_bedroom", "x": 10, "y": 20 },
        { "chance": 20, "item": "clutter_bedroom", "x": 11, "y": 18 },
        { "chance": 10, "item": "chem_home", "x": 13, "y": 3 },
        { "chance": 10, "item": "chem_home", "x": 10, "y": 3 },
        { "chance": 10, "item": "textbooks", "x": 15, "y": 21 },
        { "chance": 10, "item": "softdrugs", "x": 7, "y": 20 },
        { "chance": 10, "item": "softdrugs", "x": 8, "y": 3 },
        { "chance": 30, "item": "kitchen", "x": 19, "y": 3 },
        { "chance": 5, "item": "road", "x": 5, "y": 10 },
        { "chance": 5, "item": "road", "x": 2, "y": 8 }
      ],
      "place_monster": [ { "group": "GROUP_ZOMBIE", "x": [ 14, 23 ], "y": [ 10, 16 ], "repeat": [ 1, 6 ] } ]
    }
  },
  {
    "type": "mapgen",
    "method": "json",
    "om_terrain": "trailerparksmall0_roof",
    "object": {
      "fill_ter": "t_tar_flat_roof",
      "rows": [
        "                        ",
        "      ................. ",
        "     ...............&.. ",
        "     ..........%....... ",
        "     .................. ",
        "     .................. ",
        "     .............=.... ",
        "      ................. ",
        "                        ",
        "                        ",
        "                        ",
        "                        ",
        "                        ",
        "                        ",
        "                        ",
        "                        ",
        "      ................. ",
        "     .................. ",
        "     ...............&.. ",
        "     .................. ",
        "     ...=.....%........ ",
        "     .................. ",
        "      ................. ",
        "                        "
      ],
      "palettes": [ "roof_palette" ],
      "terrain": { ".": "t_tar_flat_roof" },
      "furniture": { "%": "f_TV_antenna" }
    }
  },
  {
    "type": "mapgen",
    "method": "json",
    "om_terrain": "trailerparksmall1",
    "object": {
      "fill_ter": "t_floor",
      "rows": [
        "         .......        ",
        "  #   #  .......  d     ",
        "    #d  d....... ddd#  d",
        " 4# 4#  d.......||||||d ",
        " d# ##   .......|,,,,|#d",
        "   d d#4 .......w,,,,|#d",
        " #  #  #d.......w,,,,|d ",
        "  # 4# dd.......|,,,,| d",
        " dd d ddd.......||||+|  ",
        "........................",
        "........................",
        "........................",
        "........................",
        "........................",
        "........................",
        " cccc  s  dss  dd  g ss ",
        " cccc ||||W|||W||||+||| ",
        " cccc||,,|,@|HHHt,,,,&|d",
        " cccc||S,+,@|,,,,,,,,,| ",
        " cccc||,,|,,|,,,,,,,,,|d",
        " cccc||,,|,,+,,b,|a,,o|d",
        " cccc||jT|,,|,,tt|aCCF| ",
        "     d|||||||||||||WW||d",
        "       d     d  d  d d  "
      ],
      "palettes": [ "trailer_park" ],
      "items": { "F": { "item": "SUS_fridge", "chance": 100 } },
      "place_item": [ { "item": "blanket", "repeat": 1, "x": 11, "y": 17 } ],
      "place_items": [
        { "chance": 45, "item": "cannedfood", "x": 20, "y": 21 },
        { "chance": 35, "item": "magazines", "x": 16, "y": 17 },
        { "chance": 45, "item": "alcohol", "x": 19, "y": 21 },
        { "chance": 25, "item": "clutter_bedroom", "x": 10, "y": 20 },
        { "chance": 35, "item": "clutter_bedroom", "x": 11, "y": 18 },
        { "chance": 15, "item": "textbooks", "x": 15, "y": 21 },
        { "chance": 35, "item": "softdrugs", "x": 7, "y": 20 }
      ],
      "place_monster": [
        { "group": "GROUP_ZOMBIE", "x": [ 7, 13 ], "y": [ 16, 23 ], "repeat": [ 1, 6 ] },
        { "group": "GROUP_ZOMBIE", "x": [ 14, 20 ], "y": [ 10, 16 ], "repeat": [ 1, 6 ] },
        { "group": "GROUP_DOGS", "x": [ 0, 6 ], "y": [ 11, 17 ], "repeat": [ 1, 2 ] }
      ],
      "place_loot": [ { "item": "television", "x": 20, "y": 6, "chance": 100 }, { "item": "stepladder", "x": 19, "y": 5, "chance": 100 } ]
    }
  },
  {
    "type": "mapgen",
    "method": "json",
    "om_terrain": "trailerparksmall1_roof",
    "object": {
      "fill_ter": "t_tar_flat_roof",
      "rows": [
        "                        ",
        "                        ",
        "                        ",
        "                ......  ",
        "                ......  ",
        "                ......  ",
        "                ......  ",
        "                ......  ",
        "                ......  ",
        "                        ",
        "                        ",
        "                        ",
        "                        ",
        "                        ",
        "                        ",
        "                        ",
        "      ................. ",
        "     .................. ",
        "     .........&........ ",
        "     .................. ",
        "     ......=........... ",
        "     .............%.... ",
        "      ................. ",
        "                        "
      ],
      "palettes": [ "roof_palette" ],
      "furniture": { "%": "f_TV_antenna" },
      "terrain": { ".": "t_tar_flat_roof" }
    }
  },
  {
    "type": "mapgen",
    "method": "json",
    "om_terrain": "trailerparksmall2",
    "object": {
      "fill_ter": "t_floor",
      "rows": [
        "      ddd d   d  d      ",
        " ||W||||||||||||||      ",
        " |aCF|tHH,|,,D|jT||cccc ",
        "d|o,,|,,,,+,,,|,,||cccc ",
        " |,,,,,,,,|,,,|,,||cccc ",
        " |,,,,,,,,|@@,+,,||cccc ",
        "d|,,,,,bt&|@@,|,S||cccc ",
        " ||+|||WW|||W|||||dcccc ",
        "   gd s    dds     cccc ",
        "....................... ",
        ".......................{",
        ".......................{",
        ".......................{",
        "....................... ",
        "....................... ",
        " cccc  sd  ss  d d g ss ",
        " cccc ||||W|||W||||+||| ",
        " cccc||,,|,@|,,At,,,,&|d",
        " cccc||S,+,@|,,,,,,,,,| ",
        " cccc||,,|,,|,,,,,,,,,|d",
        " cccc||,,|,,+,,b,|a,,o|d",
        " cccc||jT|,D|,,tt|aCCF| ",
        "     d|||||||||||||WW||d",
        "        d    d  d  d d  "
      ],
      "palettes": [ "trailer_park" ],
      "items": { "{": { "item": "trash_dumpster", "chance": 80 }, "F": { "item": "SUS_fridge", "chance": 100 } },
      "place_items": [
        { "chance": 20, "item": "table_livingroom", "x": 16, "y": 21 },
        { "chance": 20, "item": "table_livingroom", "x": 9, "y": 2 },
        { "chance": 45, "item": "cannedfood", "x": 20, "y": 21 },
        { "chance": 35, "item": "alcohol", "x": 19, "y": 21 },
        { "chance": 75, "item": "bed", "x": 11, "y": 17 },
        { "chance": 75, "item": "bed", "x": 15, "y": 3 },
        { "chance": 75, "item": "bed", "x": 14, "y": [ 2, 3 ] },
        { "chance": 35, "item": "kitchen_nonfood", "x": 5, "y": 2 },
        { "chance": 35, "item": "magazines", "x": 16, "y": 17 },
        { "chance": 45, "item": "clutter_bedroom", "x": 10, "y": 20 },
        { "chance": 20, "item": "clutter_bedroom", "x": 11, "y": 18 },
        { "chance": 10, "item": "textbooks", "x": 15, "y": 21 },
        { "chance": 35, "item": "clothing_female", "x": 11, "y": 21 },
        { "chance": 35, "item": "dresser", "x": 13, "y": 6 },
        { "chance": 45, "item": "kitchen", "x": 18, "y": 21 },
        { "chance": 30, "item": "kitchen", "x": 6, "y": 2 }
      ],
      "place_monster": [
        { "group": "GROUP_ZOMBIE", "x": [ 14, 20 ], "y": [ 10, 16 ], "repeat": [ 1, 6 ] },
        { "group": "GROUP_DOGS", "x": [ 0, 6 ], "y": [ 11, 17 ], "repeat": [ 1, 2 ] }
      ]
    }
  },
  {
    "type": "mapgen",
    "method": "json",
    "om_terrain": "trailerparksmall2_roof",
    "object": {
      "fill_ter": "t_tar_flat_roof",
      "rows": [
        "                        ",
        " .................      ",
        " ..................     ",
        " ..................     ",
        " ......&....=......     ",
        " ..................     ",
        " .......%..........     ",
        " .................      ",
        "                        ",
        "                        ",
        "                        ",
        "                        ",
        "                        ",
        "                        ",
        "                        ",
        "                        ",
        "      ................. ",
        "     .................. ",
        "     .............%.... ",
        "     .......&.......... ",
        "     ........=......... ",
        "     .................. ",
        "      ................. ",
        "                        "
      ],
      "palettes": [ "roof_palette" ],
      "terrain": { ".": "t_tar_flat_roof" },
      "furniture": { "%": "f_TV_antenna" }
    }
  }
]
