[
  {
    "type": "mapgen",
    "method": "json",
    "om_terrain": [ "tutorial_0" ],
    "weight": 100,
    "object": {
      "fill_ter": "t_thconc_floor",
      "rows": [
        "||||||||||||||||||||||||",
        "|,AAA,||||....D.+.E...,|",
        "|AAAAA||||.,.||||||||..|",
        "|AAAAA.B.C...|||||||||.|",
        "|AAAAA||||||||||||||||F|",
        "|,AAA,||||||||||||||||.|",
        "||||||||||||||||||||||w|",
        "||...|||||||||||||||||.|",
        "||...|||||||||||||||||.|",
        "||.,.||||.,.||||.,.|||.|",
        "||...||||...||||...||..|",
        "||...K..J...I..H...G..,|",
        "||...||||...||||...|||||",
        "||.,.||||.,.||||.,.|||||",
        "||...|||||||||||||||||||",
        "|||L||.........|,.....,|",
        "|||.||.|||||||.|......i|",
        "|||.||.|...P...|.......g",
        "|||.||.|||||||.|.......g",
        "|||M||.......|.|.......g",
        "||...|||||||.|.|RRR....g",
        "||...N...O...|.|..R....|",
        "||...|||||||||....R...,|",
        "||||||||||||||||||||||||"
      ],
      "zones": {
        "A": { "type": "TUT_MARKER", "faction": "your_followers", "name": "LESSON_INTRO;LESSON_MOVE" },
        "B": { "type": "TUT_MARKER", "faction": "your_followers", "name": "LESSON_LOOK" },
        "C": { "type": "TUT_MARKER", "faction": "your_followers", "name": "LESSON_MESSAGE_LOG" },
        "D": { "type": "TUT_MARKER", "faction": "your_followers", "name": "LESSON_OPEN" },
        "E": { "type": "TUT_MARKER", "faction": "your_followers", "name": "LESSON_CLOSE" },
        "F": { "type": "TUT_MARKER", "faction": "your_followers", "name": "LESSON_WINDOW" },
        "G": { "type": "TUT_MARKER", "faction": "your_followers", "name": "LESSON_PICKUP" },
        "H": { "type": "TUT_MARKER", "faction": "your_followers", "name": "LESSON_WIELD_DROP" },
        "I": { "type": "TUT_MARKER", "faction": "your_followers", "name": "LESSON_WEAR" },
        "J": { "type": "TUT_MARKER", "faction": "your_followers", "name": "LESSON_TAKEOFF" },
        "K": { "type": "TUT_MARKER", "faction": "your_followers", "name": "LESSON_INVENTORY" },
        "L": { "type": "TUT_MARKER", "faction": "your_followers", "name": "LESSON_INVENTORY_DROP" },
        "M": { "type": "TUT_MARKER", "faction": "your_followers", "name": "LESSON_RELOAD_ACTIVATE" },
        "N": { "type": "TUT_MARKER", "faction": "your_followers", "name": "LESSON_ACTIVATE_NOTE" },
        "O": { "type": "TUT_MARKER", "faction": "your_followers", "name": "LESSON_UNLOAD_DEACTIVATE" },
        "P": { "type": "TUT_MARKER", "faction": "your_followers", "name": "LESSON_ACTIVATE_WORN" },
        "R": { "type": "TUT_MARKER", "faction": "your_followers", "name": "LESSON_INTERACT" }
      },
      "terrain": {
        "+": "t_door_c",
        "|": "t_brick_wall",
        ",": "t_thconc_floor_olight",
        "w": "t_window",
        "i": "t_gates_mech_control",
        "g": "t_door_metal_locked"
      },
      "place_loot": [
        { "item": "stick", "x": 17, "y": 11, "chance": 100 },
        { "item": "jeans", "x": 10, "y": 11, "chance": 100 },
        { "item": "backpack", "x": 3, "y": 11, "chance": 100 },
        { "item": "pipe", "x": 3, "y": 7, "chance": 100 },
        { "item": "jacket_jean", "x": 3, "y": 7, "chance": 100 },
        { "item": "socks", "x": 3, "y": 7, "chance": 100 },
        { "item": "tshirt", "x": 3, "y": 7, "chance": 100 },
        { "item": "sneakers", "x": 3, "y": 7, "chance": 100 },
        { "item": "light_battery_cell", "x": 3, "y": 21, "ammo": 100, "chance": 100 },
        { "item": "flashlight", "x": 3, "y": 21, "chance": 100 },
        { "item": "wearable_light", "x": 8, "y": 17, "chance": 100 }
      ]
    }
  },
  {
    "type": "mapgen",
    "method": "json",
    "om_terrain": [ "tutorial_1" ],
    "weight": 100,
    "object": {
      "fill_ter": "t_thconc_floor",
      "rows": [
        "||||||||||||||||||||||||",
        "|,...,|,.....,|,......,|",
        "|.....|.......|........|",
        "|....,|,.....,|........|",
        "|...|.|.|||||||,......,|",
        "|...|B|D|,...,|J||||||||",
        "|...|.|.|.....|.||,...,|",
        "|,..|.|.|.....|.,|.....|",
        "|||||.|.|.....|I||.....|",
        "|||,.,|,|.....|.||.....|",
        "|||.|||.|.....|.,|.....|",
        "|||.|||.|,...,|H||.....|",
        "|||.|||.|||F|||,||,...,|",
        "|||A|||C|||E|||G|||K||||",
        "|||.|||.|||.|||.|||.||||",
        "|||+|||+|||+|||+|||+||||",
        "|,...,...,...,...,...,i|",
        ".......................g",
        ".......................g",
        ".......................g",
        ".......................g",
        "|,...,...,...,...,...,||",
        "||||||||||||||||||||||||",
        "||||||||||||||||||||||||"
      ],
      "zones": {
        "A": { "type": "TUT_MARKER", "faction": "your_followers", "name": "LESSON_MELEE_WEAPONS" },
        "B": { "type": "TUT_MARKER", "faction": "your_followers", "name": "LESSON_MELEE_ATTACK" },
        "C": { "type": "TUT_MARKER", "faction": "your_followers", "name": "LESSON_REACH_WEAPONS" },
        "D": { "type": "TUT_MARKER", "faction": "your_followers", "name": "LESSON_REACH_ATTACK" },
        "E": { "type": "TUT_MARKER", "faction": "your_followers", "name": "LESSON_THROWING_WEAPONS" },
        "F": { "type": "TUT_MARKER", "faction": "your_followers", "name": "LESSON_THROWING" },
        "G": { "type": "TUT_MARKER", "faction": "your_followers", "name": "LESSON_RANGED_WEAPONS" },
        "H": { "type": "TUT_MARKER", "faction": "your_followers", "name": "LESSON_FIREARM_RELOAD_MAGAZINE" },
        "I": { "type": "TUT_MARKER", "faction": "your_followers", "name": "LESSON_FIREARM_RELOAD_GUN" },
        "J": { "type": "TUT_MARKER", "faction": "your_followers", "name": "LESSON_RANGED_ATTACK" },
        "K": { "type": "TUT_MARKER", "faction": "your_followers", "name": "LESSON_INJURIES" }
      },
      "terrain": {
        "+": "t_door_c",
        "|": "t_brick_wall",
        ",": "t_thconc_floor_olight",
        "i": "t_gates_mech_control",
        "g": "t_door_metal_locked"
      },
      "place_graffiti": [
        { "text": "Lesson: Basic melee.", "x": 4, "y": 15 },
        { "text": "Lesson: Reach attacks.", "x": 8, "y": 15 },
        { "text": "Lesson: Throwing.", "x": 12, "y": 15 },
        { "text": "Lesson: Ranged attacks.", "x": 16, "y": 15 },
        { "text": "Lesson: Injuries.", "x": 20, "y": 15 }
      ],
      "place_loot": [
        { "item": "bat", "x": 5, "y": 7, "chance": 100 },
        { "item": "spear_wood", "x": 7, "y": 7, "chance": 100 },
        { "item": "throwing_knife", "x": 12, "y": 11, "chance": 100, "repeat": 10 },
        { "item": "powered_earmuffs", "x": 16, "y": 7, "chance": 100, "magazine": 100, "ammo": 100 },
        { "item": "m16a4", "x": 16, "y": 7, "chance": 100 },
        { "item": "stanag30", "x": 16, "y": 10, "chance": 100 },
        { "item": "556", "x": 16, "y": 10, "chance": 100 },
        { "item": "1st_aid", "x": 21, "y": 12, "chance": 100 },
        { "item": "arm_splint", "x": 21, "y": 12, "chance": 100 },
        { "item": "leg_splint", "x": 21, "y": 12, "chance": 100 },
        { "item": "morphine", "x": 21, "y": 12, "chance": 100 },
        { "item": "syringe", "x": 21, "y": 12, "chance": 100 }
      ],
      "place_monster": [
        { "monster": "mon_tutorial", "x": 2, "y": 2 },
        { "monster": "mon_tutorial", "x": 2, "y": 4 },
        { "monster": "mon_tutorial", "x": 2, "y": 6 },
        { "monster": "mon_tutorial", "x": 13, "y": 1 },
        { "monster": "mon_tutorial", "x": 13, "y": 2 },
        { "monster": "mon_tutorial", "x": 13, "y": 3 },
        { "monster": "mon_tutorial", "x": 10, "y": 6 },
        { "monster": "mon_tutorial", "x": 12, "y": 6 },
        { "monster": "mon_tutorial_angry", "x": 19, "y": 6 },
        { "monster": "mon_tutorial_angry", "x": 20, "y": 6 },
        { "monster": "mon_tutorial_angry", "x": 21, "y": 6 }
      ]
    }
  },
  {
    "type": "mapgen",
    "method": "json",
    "om_terrain": [ "tutorial_2" ],
    "weight": 100,
    "object": {
      "fill_ter": "t_thconc_floor",
      "rows": [
        "||||||||||||||||||||||||",
        "|bb.|,.,.,||,......,|,.|",
        "|...|.|...||.......f|..|",
        "|...|.|,.,||,......,|..|",
        "|||C|.||||||G||||||||.||",
        "|...|.|,..,|.|,...,...,|",
        "|,..|.|.....,|...|.....|",
        "|...|,|,..,|||||||.....|",
        "|||B|.|||F||,...,|.....|",
        "|...|.|||.||.....|.....|",
        "|,..|.|ww.,|.....|...cc|",
        "|...|.|ww..|.....|....c|",
        "|||A|D|ww.,|,...,|,...,|",
        "|||.|.|||E|||||H|||I|..|",
        "|||.|,..|,..|||.|||.|..|",
        "|||+|||+|||+|||+|||+||||",
        "|,...,...,...,...,...,i|",
        ".......................g",
        ".......................g",
        ".......................g",
        ".......................g",
        "|,...,...,...,...,...,||",
        "||||||||||||||||||||||||",
        "||||||||||||||||||||||||"
      ],
      "zones": {
        "A": { "type": "TUT_MARKER", "faction": "your_followers", "name": "LESSON_FOOD" },
        "B": { "type": "TUT_MARKER", "faction": "your_followers", "name": "LESSON_WATER" },
        "C": { "type": "TUT_MARKER", "faction": "your_followers", "name": "LESSON_REST" },
        "D": { "type": "TUT_MARKER", "faction": "your_followers", "name": "LESSON_MORALE_FOCUS" },
        "E": { "type": "TUT_MARKER", "faction": "your_followers", "name": "LESSON_RAW_WATER" },
        "F": { "type": "TUT_MARKER", "faction": "your_followers", "name": "LESSON_BOILING" },
        "G": { "type": "TUT_MARKER", "faction": "your_followers", "name": "LESSON_FIRE" },
        "H": { "type": "TUT_MARKER", "faction": "your_followers", "name": "LESSON_DRAG_ITEMS" },
        "I": { "type": "TUT_MARKER", "faction": "your_followers", "name": "LESSON_DRAG_FURNITURE" }
      },
      "terrain": {
        "+": "t_door_c",
        "|": "t_brick_wall",
        ",": "t_thconc_floor_olight",
        "i": "t_gates_mech_control",
        "w": "t_water_sh_underground",
        "g": "t_door_metal_locked"
      },
      "furniture": { "b": "f_bed", "f": "f_fireplace", "c": "f_chair" },
      "place_vehicles": [ { "vehicle": "engine_crane", "chance": 100, "fuel": -1, "rotation": 270, "status": 0, "x": 20, "y": 7 } ],
      "place_graffiti": [
        { "text": "Lesson: Food, Water, Rest.", "x": 4, "y": 15 },
        { "text": "Lesson: Morale and Focus.", "x": 8, "y": 15 },
        { "text": "Lesson: Cooking.", "x": 12, "y": 15 },
        { "text": "Lesson: Dragging items.", "x": 16, "y": 15 },
        { "text": "Lesson: Moving furniture.", "x": 20, "y": 15 }
      ],
      "place_loot": [
        { "item": "pillow", "x": 1, "y": 1, "chance": 100 },
        { "item": "blanket", "x": 1, "y": 1, "chance": 100 },
        { "item": "down_blanket", "x": 2, "y": 1, "chance": 100 },
        { "item": "choc_drink", "x": 1, "y": 6, "chance": 100 },
        { "item": "fish_canned", "x": 1, "y": 10, "chance": 100 },
        { "item": "bleach", "x": 8, "y": 2, "chance": 100 },
        { "item": "shavingkit", "x": 8, "y": 2, "chance": 100 },
        { "item": "candy", "x": 8, "y": 2, "chance": 100 },
        { "item": "bottle_plastic", "x": 10, "y": 11, "chance": 100 },
        { "item": "pot", "x": 8, "y": 6, "chance": 100 },
        { "item": "splinter", "x": 16, "y": 1, "chance": 100, "repeat": 4 },
        { "item": "2x4", "x": 16, "y": 1, "chance": 100, "repeat": 3 },
        { "item": "lighter", "x": 14, "y": 1, "chance": 100 },
        { "item": "bottle_glass", "x": 18, "y": 3, "chance": 100 },
        { "item": "v8_combustion", "x": 13, "y": 10, "chance": 100 },
        { "item": "log", "x": 15, "y": 10, "chance": 100, "repeat": 5 }
      ],
      "place_monster": [  ]
    }
  }
]
