[
  {
    "type": "mapgen",
    "method": "json",
    "om_terrain": "wind_turbine_ground",
    "object": {
      "fill_ter": "t_metal_floor_no_roof",
      "rows": [
        "                        ",
        "                        ",
        "                        ",
        "                        ",
        "                        ",
        "                        ",
        "                        ",
        "                        ",
        "                        ",
        "           #X#          ",
        "          ##-##         ",
        "          #I-H#         ",
        "          ##S##         ",
        "           ###          ",
        "                        ",
        "                        ",
        "                        ",
        "                        ",
        "                        ",
        "                        ",
        "                        ",
        "                        ",
        "                        ",
        "                        "
      ],
      "terrain": {
        " ": "t_region_groundcover",
        "H": "t_ladder_up",
        "-": "t_metal_floor_no_roof",
        "S": "t_switchgear_l",
        "X": "t_door_metal_locked",
        "I": "t_metal_floor_no_roof",
        "#": "t_wall_metal"
      },
      "furniture": { "I": "f_electrical_conduit" }
    }
  },
  {
    "type": "mapgen",
    "method": "json",
    "om_terrain": "wind_turbine_pillar",
    "object": {
      "fill_ter": "t_open_air",
      "rows": [
        "                        ",
        "                        ",
        "                        ",
        "                        ",
        "                        ",
        "                        ",
        "                        ",
        "                        ",
        "                        ",
        "           ###          ",
        "          ## ##         ",
        "          #I H#         ",
        "          ## ##         ",
        "           ###          ",
        "                        ",
        "                        ",
        "                        ",
        "                        ",
        "                        ",
        "                        ",
        "                        ",
        "                        ",
        "                        ",
        "                        "
      ],
      "terrain": {
        " ": "t_open_air",
        "H": "t_ladder_up_down",
        "=": "t_metal_floor_no_roof",
        "I": "t_metal_floor_no_roof",
        "#": "t_wall_metal"
      },
      "furniture": { "I": "f_electrical_conduit" }
    }
  },
  {
    "type": "mapgen",
    "method": "json",
    "om_terrain": "wind_turbine_pillar_platform",
    "object": {
      "fill_ter": "t_open_air",
      "rows": [
        "                        ",
        "                        ",
        "                        ",
        "                        ",
        "                        ",
        "                        ",
        "                        ",
        "                        ",
        "                        ",
        "           ###          ",
        "          ##=##         ",
        "          #I=H#         ",
        "          ##S##         ",
        "           ###          ",
        "                        ",
        "                        ",
        "                        ",
        "                        ",
        "                        ",
        "                        ",
        "                        ",
        "                        ",
        "                        ",
        "                        "
      ],
      "terrain": {
        " ": "t_open_air",
        "H": "t_ladder_up_down",
        "=": "t_metal_floor_no_roof",
        "I": "t_metal_floor_no_roof",
        "S": "t_switchgear_l",
        "#": "t_wall_metal"
      },
      "furniture": { "I": "f_electrical_conduit" }
    }
  },
  {
    "type": "mapgen",
    "method": "json",
    "om_terrain": "wind_turbine_nacelle",
    "object": {
      "fill_ter": "t_open_air",
      "rows": [
        "                        ",
        "                        ",
        "                        ",
        "                        ",
        "                        ",
        "            W           ",
        "           #+#          ",
        "          ##+##         ",
        "          #|+=#         ",
        "          #|+=#         ",
        "          #&&&#         ",
        "          #I|H#         ",
        "          #E|=#         ",
        "          #C&&#         ",
        "          #C&&#         ",
        "          #####         ",
        "                        ",
        "                        ",
        "                        ",
        "                        ",
        "                        ",
        "                        ",
        "                        ",
        "                        "
      ],
      "furniture": { "I": "f_electrical_conduit", "C": "f_capacitor" },
      "terrain": {
        " ": "t_open_air",
        "H": "t_ladder_up_down",
        "+": "t_machinery_light",
        "C": "t_metal_floor_no_roof",
        "=": "t_metal_floor_no_roof",
        "&": "t_generator_broken",
        "E": "t_machinery_electronic",
        "|": "t_machinery_heavy",
        "I": "t_metal_floor_no_roof",
        "#": "t_wall_metal",
        "W": "t_wind_turbine_rotor"
      }
    }
  },
  {
    "type": "mapgen",
    "method": "json",
    "om_terrain": "wind_turbine_roof",
    "object": {
      "fill_ter": "t_open_air",
      "rows": [
        "                        ",
        "                        ",
        "                        ",
        "                        ",
        "                        ",
        "            =           ",
        "           ===          ",
        "          =====         ",
        "          =====         ",
        "          =====         ",
        "          =====         ",
        "          ===H=         ",
        "          =====         ",
        "          =====         ",
        "          =?=?=         ",
        "          =====         ",
        "                        ",
        "                        ",
        "                        ",
        "                        ",
        "                        ",
        "                        ",
        "                        ",
        "                        "
      ],
      "terrain": {
        " ": "t_open_air",
        "H": "t_ladder_down",
        "+": "t_open_air",
        "=": "t_metal_floor_no_roof",
        ">": "t_metal_floor_no_roof",
        "?": "t_metal_floor_no_roof"
      },
      "furniture": { "?": "f_cellphone_booster" }
    }
  }
]
