[
  {
    "type": "mapgen",
    "method": "json",
    "om_terrain": [ "ws_survivor_bunker_f0" ],
    "weight": 1000,
    "object": {
      "rows": [
        ".b.,..,..,.b..,.,T....b.",
        ".,..T,w.T..,.,.Y..,.b.,.",
        ".b.,..b,.pbppTp...Y,.T..",
        "...T..Y.,ppTpYp.b.,T.,..",
        "..b..b.,.Tpw>Tpw.T.,.b..",
        ".Y.Y..T..pT.Tppb.,..Y.,.",
        ".,.T..w..Tpp,pT..T.Y.b,.",
        ".b.,,.T..b..Y.,w,T.,.,..",
        ".,.Y.,b.YwY..,.T...T..Y.",
        ".,,..T...T..b.,T,.b.,...",
        ".,Y.,.b,...T,T,.b.,..Y.b",
        "...T..Y,T.T,T,.T.T.Y.,..",
        ".,..T.,.b,.T,T,bTY.,..b.",
        "..T.,.Y,..T.T.Y.T.,.Y...",
        "..b.T.Y..,.T.,,b.Y..,.,.",
        ".T.,..T....T.,....,.b...",
        ".,T.b.,.T.....Y..b..Y,..",
        ".,..Y,Y,b.,....,.Y,..,b.",
        ",Y.,.,.Y.,..b.,.Y..T..,.",
        ",.b..Y.Y..T..Y...b...Tb.",
        "T.,T.,.Y...,.T..b.T...,,",
        ".b.,.Y..,YT...b.T.,,...,",
        ".,.T.,..T...,T..,..Y.T..",
        ",.,...T.,.b.,..,,.,,..,."
      ],
      "terrain": {
        ".": "t_grass",
        ",": "t_dirt",
        "T": "t_tree",
        "Y": "t_tree_young",
        "b": "t_underbrush",
        ">": "t_ladder_down",
        "p": "t_pit_spiked",
        "w": "t_dirt"
      }
    }
  },
  {
    "type": "mapgen",
    "method": "json",
    "om_terrain": [ "ws_survivor_bunker_f-1" ],
    "weight": 1000,
    "object": {
      "fill_ter": "t_rock_floor",
      "rows": [
        "########################",
        "########################",
        "############r###########",
        "###########rrr##########",
        "##########rr<r##########",
        "###########r2r##########",
        "###########r1r##########",
        "##########r1.r##########",
        "##########SsS###########",
        "##########.1.###########",
        "#########--D--##########",
        "#########|b.t|##########",
        "#########|..h|##########",
        "#########|k.W|##########",
        "#########|C.B|##########",
        "#########|C.B|##########",
        "#########--D--##########",
        "##########r.ssrr########",
        "###########rr.rrr#######",
        "############rr.rrr######",
        "##############rr########",
        "########################",
        "########################",
        "########################"
      ],
      "terrain": { "#": "t_rock", "<": "t_ladder_up", "-": "t_wall_wood", "|": "t_wall_wood", "D": "t_door_locked_interior" },
      "furniture": {
        "r": "f_rubble_rock",
        "s": "f_sandbag_half",
        "S": "f_sandbag_wall",
        "B": "f_makeshift_bed",
        "b": "f_bookcase",
        "t": "f_table",
        "h": "f_chair",
        "W": "f_woodstove",
        "C": "f_crate_c"
      },
      "items": {
        "b": { "item": "homebooks", "chance": 40 },
        "C": { "item": "oa_ig_sb_rare", "chance": 40 },
        "B": { "item": "bed", "chance": 80 },
        "k": { "item": "oa_ig_sb_water", "chance": 60 },
        "W": { "item": "oa_ig_sb_wood", "chance": 70 }
      },
      "place_loot": [
        { "item": "ash", "chance": 2, "x": 12, "y": 13, "repeat": 2 },
        { "item": "charcoal", "chance": 3, "x": 12, "y": 13 },
        { "item": "survnote", "chance": 2, "x": 12, "y": 11 }
      ],
      "traps": { "1": { "trap": "tr_beartrap" }, "2": { "trap": "tr_tripwire" } },
      "place_items": [
        { "item": "oa_ig_sb_food", "x": 10, "y": 14, "chance": 50, "repeat": 3 },
        { "item": "oa_ig_sb_food", "x": 10, "y": 15, "chance": 50, "repeat": 3 },
        { "item": "oa_ig_sb_equipment", "x": 10, "y": 14, "chance": 40, "repeat": 2 },
        { "item": "oa_ig_sb_equipment", "x": 10, "y": 15, "chance": 40, "repeat": 2 },
        { "item": "homebooks", "x": 10, "y": 11, "chance": 40, "repeat": 2 },
        { "item": "oa_ig_sb_wood", "x": 12, "y": 13, "chance": 40, "repeat": 2 },
        { "item": "oa_ig_sb_wood", "x": 11, "y": 17, "chance": 40, "repeat": 2 }
      ],
      "place_monsters": [
        { "monster": "GROUP_ZOMBIE_BUNKER", "x": 14, "y": 19 },
        { "monster": "GROUP_ZOMBIE_BUNKER", "x": 15, "y": 20 },
        { "monster": "GROUP_ZOMBIE_BUNKER", "x": 16, "y": 19 }
      ]
    }
  }
]
