[
  {
    "type": "mapgen",
    "om_terrain": [
      [ "null", "necropolis_level_1_2" ],
      [ "necropolis_level_1_10", "null" ]
    ],
    "method": "json",
    "object": {
      "fill_ter": "t_shingle_flat_roof",
      "rows": [
        "                                                ",
        "                                                ",
        "                                       --------5",
        "                                       -.......-",
        "                               ---------.......-",
        "                               -...............-",
        "                               -...............-",
        "                               -...............-",
        "                               -...............-",
        "                            ----...............-",
        "                            -..................-",
        "                            -..................-",
        "                            -..................-",
        "                            -..................-",
        "                            -..................-",
        "                            -..................-",
        "                            -........-----------",
        "                            -........-          ",
        "                            -........-          ",
        "                            -........-          ",
        "                            5---------          ",
        "                                                ",
        "                                                ",
        "                                                ",
        "                                                ",
        "                                                ",
        "    -------------------                         ",
        "    -.................-                         ",
        "    -.................-                         ",
        "    -.................-                         ",
        "    -.................-                         ",
        "    -.................-                         ",
        "    ---.........------5                         ",
        "      -.........-                               ",
        "      -.........-                               ",
        "      -.........-                               ",
        "      -.........-                               ",
        "      -.........-                               ",
        "      ---.......----                            ",
        "        -..........-                            ",
        "        -..........-                            ",
        "        -..........-                            ",
        "        -..........-                            ",
        "        -..........-                            ",
        "        5-----------                            ",
        "                                                ",
        "                                                ",
        "                                                "
      ],
      "palettes": [ "roof_palette" ],
      "terrain": { ".": "t_shingle_flat_roof" }
    }
  },
  {
    "type": "mapgen",
    "method": "json",
    "om_terrain": [ "necropolis_level_1_12" ],
    "object": {
      "fill_ter": "t_flat_roof",
      "rows": [
        "                        ",
        "                        ",
        "                        ",
        "                        ",
        "                        ",
        "                        ",
        "                        ",
        "                        ",
        "                        ",
        "                        ",
        "                        ",
        "                        ",
        "                        ",
        "5-------------          ",
        "-............-          ",
        "-............-          ",
        "-............-          ",
        "-............-          ",
        "-............-          ",
        "-............-          ",
        "-............-          ",
        "-............-          ",
        "-............-          ",
        "--------------          "
      ],
      "palettes": [ "roof_palette" ]
    }
  }
]
