[
  {
    "type": "mapgen",
    "om_terrain": "water_tower_corner",
    "weight": 1000,
    "method": "json",
    "object": {
      "fill_ter": "t_water_pool",
      "rows": [
        "###MMMMMMMMMMMMMMMMMMMMM",
        "##MM....................",
        "#MM.....................",
        "MM......................",
        "M.......................",
        "M.......................",
        "M.......................",
        "M.......................",
        "M.......................",
        "M.......................",
        "M..........M..M.........",
        "M.......................",
        "M.......................",
        "M..........M..M.........",
        "M.......................",
        "M.......................",
        "M.......................",
        "M.......................",
        "M.......................",
        "M.......................",
        "M.......................",
        "M.......................",
        "M.......................",
        "M......................."
      ],
      "palettes": [ "water_tower" ],
      "terrain": { "m": "t_door_metal_locked", "#": "t_rock", ".": "t_water_pool" }
    }
  }
]
