[
  {
    "type": "mapgen",
    "om_terrain": "water_tower_-1zl",
    "weight": 1000,
    "method": "json",
    "object": {
      "fill_ter": "t_rock",
      "rows": [
        "........................",
        "........................",
        "........................",
        "........................",
        "....MM...........MM.....",
        "....MM...........MM.....",
        "........................",
        "........................",
        "........MMMMMMMM........",
        "........MMMMMMMM........",
        "........MM    MM........",
        "........MM >> MM........",
        "........MM << MM........",
        "........MM    MM........",
        "........MMMMMMMM........",
        "........MMMMMMMM........",
        "........................",
        "........................",
        "....MM............MM....",
        "....MM............MM....",
        "........................",
        "........................",
        "........................",
        "........................"
      ],
      "palettes": [ "water_tower" ],
      "terrain": { " ": "t_metal_floor", ".": "t_rock" }
    }
  }
]
