[
  {
    "type": "mapgen",
    "om_terrain": "water_tower_2zl",
    "weight": 1000,
    "method": "json",
    "object": {
      "fill_ter": "t_open_air",
      "rows": [
        "........................",
        "........................",
        "........................",
        "........................",
        "....MM,,,,,,,,,,,,MM....",
        "....MM,,,,,,,,,,,,MM....",
        "....,,,,,,,,,,,,,,,,....",
        "....,,,,,,,,,,,,,,,,....",
        "....,,,,MMMMMMMM,,,,....",
        "....,,,,MMMMMMMM,,,,....",
        "....,,,,MM    MM,,,,....",
        "....,,,,MM << MM,,,,....",
        "....,,,,MM >> MM,,,,....",
        "....,,,,MM    MM,,,,....",
        "....,,,,MMMMMMMM,,,,....",
        "....,,,,MMMMMMMM,,,,....",
        "....,,,,,,,,,,,,,,,,....",
        "....,,,,,,,,,,,,,,,,....",
        "....MM,,,,,,,,,,,,MM....",
        "....MM,,,,,,,,,,,,MM....",
        "........................",
        "........................",
        "........................",
        "........................"
      ],
      "palettes": [ "water_tower" ],
      "terrain":{
       " ": "t_metal_floor",
       ",": "t_open_air_rooved",
       ".": "t_open_air"
      }
    }
  }
]
