[
    {
        "type": "mapgen",
        "om_terrain": "water_tower_tank",
        "weight": 1000,
        "method": "json",
        "object": {
            "fill_ter": "t_water_pool",
            "rows": [
                "........................",
                "........................",
                "........................",
                "........................",
                "....MM............MM....",
                "....MM............MM....",
                "........................",
                "........................",
                "........................",
                ".........M....M.........",
                "..........    ..........",
                ".......... << ..........",
                ".......... << ..........",
                "..........    ..........",
                ".........M....M.........",
                "........................",
                "........................",
                "........................",
                "....MM............MM....",
                "....MM............MM....",
                "........................",
                "........................",
                "........................",
                "........................"
            ],
           "palettes": [ "water_tower" ],
           "terrain":{
             " ": "t_metal_floor",
             ".": "t_water_pool"
            }
        }
    }
]
