[
  {
    "type": "mapgen",
    "om_terrain": "water_tower_5zl",
    "weight": 1000,
    "method": "json",
    "object": {
      "fill_ter": "t_od_metal_floor",
      "rows": [
        "........................",
        "........................",
        "........................",
        ".....              .....",
        "....                ....",
        "...                  ...",
        "...                  ...",
        "...                  ...",
        "...                  ...",
        "...                  ...",
        "...        sc        ...",
        "...                  ...",
        "...        >>        ...",
        "...                  ...",
        "...                  ...",
        "...                  ...",
        "...                  ...",
        "...                  ...",
        "...                  ...",
        "....                ....",
        ".....              .....",
        "........................",
        "........................",
        "........................"
      ],
      "palettes": [ "water_tower" ],
      "terrain":{
       " ": "t_od_metal_floor",
       ".": "t_open_air"
      },
      "furniture": {
        "s": "f_small_satelitte_dish",
        "c": "f_cellphone_booster"
      }
    }
  }
]
