[
  {
    "type": "mapgen",
    "om_terrain": "water_tower_5zl",
    "weight": 1000,
    "method": "json",
    "object": {
      "fill_ter": "t_open_air_rooved",
      "rows": [
        "........................",
        "........................",
        "........................",
        ".....MMMMMMMMMMMMMM.....",
        "....MM            MM....",
        "...MM              MM...",
        "...M                M...",
        "...M                M...",
        "...M                M...",
        "...M                M...",
        "...M      M,,M      M...",
        "...M      ,>>,      M...",
        "...M      ,<<,      M...",
        "...M      M,,M      M...",
        "...M                M...",
        "...M                M...",
        "...M                M...",
        "...M                M...",
        "...MM              MM...",
        "....MM            MM....",
        ".....MMMMMMMMMMMMMM.....",
        "........................",
        "........................",
        "........................"
      ],
      "palettes": [ "water_tower" ],
      "terrain":{
       " ": "t_open_air_rooved",
       ",": "t_bridge",
       ".": "t_open_air"
      }
    }
  }
]
