[
  {
    "type": "mapgen",
    "method": "json",
    "om_terrain": [ "cove_shoal" ],
    "object": {
      "fill_ter": "t_water_dp",
      "rows": [
        "~~~~~~~~~~~~~~~~~~~~~~~~",
        "~~~~~~~~~~~~~~~~~~~~~~~~",
        "~~~~~~~~????????~~~~~~~~",
        "~~~~~~??        ??~~~~~~",
        "~~~~??            ??~~~~",
        "~~~?                ?~~~",
        "~~?                  ?~~",
        "~~?                  ?~~",
        "~?                    ?~",
        "~?                    ?~",
        "?                      ?",
        "                        ",
        "                        ",
        "                        ",
        "                        ",
        "                        ",
        "                        ",
        "                        ",
        "                        ",
        "                        ",
        "                        ",
        "                        ",
        "                        ",
        "                        "
      ],
      "terrain": {
        "~": "t_water_sh"
      },
      "furniture": { "~": [ [ "f_null", 8 ], "f_rubble_rock", "f_boulder_small" ] },
      "place_vehicles": [ { "vehicle": "cove_boats", "x": [ 11, 12 ], "y": [ 15, 16 ], "rotation": 90, "chance": 25 } ]
    }
  }
]
