[
  {
    "type": "mapgen",
    "method": "json",
    "om_terrain": [ "cove_shoal" ],
    "object": {
      "fill_ter": "t_water_dp",
      "rows": [
        "........................",
        "........................",
        "...........,,...........",
        ".....,~~~~~~~~~~~~,.....",
        "...,~~~~~~~??~~~~~~~,...",
        "...~~~~~~?    ?~~~~~~...",
        "..,~~?            ?~~,..",
        "..~~~              ~~~..",
        "..~~~              ~~~..",
        "..~~~              ~~~..",
        "..~~~              ~~~..",
        "..~~?              ?~~..",
        ".,~~                ~~,.",
        ".~~?                ?~~.",
        ",~~                  ~~,",
        "~~?                  ?~~",
        "~?                    ?~",
        "?                      ?",
        "                        ",
        "                        ",
        "                        ",
        "                        ",
        "                        ",
        "                        "
      ],
      "terrain": {
        ".": "t_region_groundcover",
        "~": "t_water_sh",
        ",": [ "t_region_groundcover", "t_water_sh" ],
        "?": [ "t_water_dp", "t_water_sh" ]
      },
      "furniture": { "~": [ [ "f_null", 18 ], "f_rubble_rock", "f_boulder_small" ] },
      "place_vehicles": [ { "vehicle": "cove_boats", "x": [ 11, 12 ], "y": [ 14, 15 ], "rotation": 90, "chance": 25 } ]
    }
  }
]
