[
  {
    "type": "overmap_special",
    "id": "Crtbase1",
    "overmaps": [
      { "point": [ 0, 0, 0 ], "overmap": "Crtbase1_0_0_north" },
      { "point": [ 1, 0, 0 ], "overmap": "Crtbase1_0_1_north" },
      { "point": [ 0, 1, 0 ], "overmap": "Crtbase1_1_0_north" },
      { "point": [ 1, 1, 0 ], "overmap": "Crtbase1_1_1_north" },
      { "point": [ 0, 0, 1 ], "overmap": "Critroof_0_0_north" },
      { "point": [ 1, 0, 1 ], "overmap": "Critroof_0_1_north" },
      { "point": [ 0, 1, 1 ], "overmap": "Critroof_1_0_north" },
      { "point": [ 1, 1, 1 ], "overmap": "Critroof_1_1_north" }
    ],
    "locations": [ "wilderness" ],
    "city_distance": [ 10, -1 ],
    "city_sizes": [ 0, 20 ],
    "occurrences": [ 1, 5 ],
    "flags": [ "CLASSIC" ]
  },
  {
    "type": "mapgen",
    "method": "json",
    "om_terrain": [ [ "Crtbase1_0_0", "Crtbase1_0_1" ], [ "Crtbase1_1_0", "Crtbase1_1_1" ] ],
    "weight": 100,
    "object": {
      "fill_ter": "t_strconc_floor",
      "rows": [
        "...............yyyyyyyyyyyyyyyyyy...............",
        "............///yyyyyyyyyyyyyyyyyy///............",
        ".../////////...yyyyyyyyyyyyyyyyyy.../////////...",
        ".../....../....yyyyyyyyyyyyyyyyyy..../....../...",
        ".../...../.....yyyyyyyyyyyyyyyyyy...../...../...",
        ".../..../...XXXZZZZZZZZZZZZZZZZZZXXX.../..../...",
        ".../.../....X5÷÷÷÷÷÷÷÷÷÷÷÷÷÷÷÷÷÷÷Q÷X..../.../...",
        ".../../.....Xu÷*÷÷÷÷÷*÷÷÷÷*÷÷÷÷÷*÷÷X...../../...",
        "..././.....XX÷÷÷÷÷÷÷÷÷÷÷÷÷÷÷÷÷÷÷÷÷bXX....././...",
        "...//.....XXX3÷÷÷÷÷÷÷÷÷÷÷÷÷÷÷÷÷÷÷÷bXXX.....//...",
        ".../.....XXWXu÷÷÷÷÷÷÷÷÷÷÷÷÷÷÷÷÷÷÷÷5XWXX...../...",
        "../.....XXq*Xn÷÷÷÷÷÷÷÷÷÷÷÷÷÷÷÷÷÷÷÷bX*qXX...../..",
        "./.....XXqq÷X÷÷*÷÷÷÷÷*÷÷÷÷*÷÷÷÷÷*÷bX÷qqXX...../.",
        "./....XXqqq÷X÷÷÷÷÷÷÷÷÷÷÷÷÷÷÷÷÷÷÷÷÷÷X÷qqqXX..../.",
        "./...XXq÷÷÷*w÷÷÷÷÷÷÷÷÷÷÷÷÷÷÷÷÷÷÷÷÷÷w*÷÷÷qXX.../.",
        "./..XXXXXXXXXX+XXXXXXXXXXXXXXX+XXXXXXXXXXXXX../.",
        "./..X)÷)÷÷)÷)X÷X÷÷÷÷÷÷÷X÷÷÷÷DX÷÷÷÷÷XXXXXXXXX../.",
        "./..X÷*÷÷÷÷*÷X÷X÷j÷j÷j÷X÷ht÷÷X÷÷XXXXXllllllX../.",
        "./..X)÷)÷÷)÷)X÷X÷÷÷÷÷÷÷Xhtt*÷w÷÷X÷÷XX÷÷÷÷÷lX../.",
        "./..X÷÷÷÷÷÷÷÷X÷X*g÷g÷g*X÷ht÷÷X÷÷X÷÷ZZ÷÷*÷÷lX../.",
        "./..X)÷)÷÷)÷)X÷X÷÷÷÷÷÷÷X÷÷÷÷÷X÷÷w÷÷ZZ÷÷÷÷÷lX../.",
        "./..X÷*÷÷÷÷*÷X÷X÷÷÷j÷j÷XXXXXXX÷÷X÷CXX÷÷÷÷÷lX../.",
        "./..X)÷)÷÷)÷)X÷X÷÷÷÷÷÷÷X÷÷÷÷÷÷÷÷X÷÷XXllllllX../.",
        "./..X÷÷÷÷÷÷÷÷X÷XXXwXXXXX÷*÷÷*÷÷÷XXXXXXXXXXXX../.",
        "./..X÷÷÷÷÷÷÷÷w÷÷÷÷÷÷÷÷^÷÷÷÷÷÷÷÷÷???XXXXXXXXX../.",
        "./..XXXXXXXXXX÷÷÷÷÷÷÷÷÷÷÷÷÷÷÷÷÷÷÷÷÷÷÷??????X../.",
        "./..XUmUmmUmUX÷÷÷÷÷÷÷÷÷÷÷÷÷÷÷÷÷÷÷÷÷÷÷÷÷÷÷÷÷X../.",
        "./..X+m+mm+m+X÷÷÷÷???^???^÷÷÷÷÷÷÷÷÷÷÷÷÷XXXXX../.",
        "./..X÷*÷÷÷÷*÷w÷÷÷XXXXXXXXXX÷÷÷÷÷÷*÷÷÷÷÷w÷*÷X../.",
        "./..X÷÷÷÷÷÷÷÷X÷÷÷X÷÷÷÷÷÷÷÷X÷÷÷÷÷÷÷÷÷÷÷÷X÷C÷X../.",
        "./..X~~~~~~~~X÷÷÷w÷÷÷÷÷÷÷÷X÷÷C÷÷÷÷÷÷÷÷÷XZXZX../.",
        "./..XXXXXXXXXXXXXX÷÷bbbbb÷XZZX÷÷÷÷÷÷÷÷÷X÷X$X../.",
        "./..XXppp÷p÷p÷÷÷÷X÷÷ttttt÷X÷÷X÷÷÷÷÷÷÷÷÷X÷XXX../.",
        "./...XXp÷p÷p÷÷÷÷÷w÷÷bbbbb÷X<<X÷÷÷???÷÷÷X÷XX.../.",
        "./....XX÷pp÷÷oo÷÷X*÷÷÷÷÷÷*XXXXwwXXXXXwXXXX..../.",
        "./.....XXp÷p÷**÷iX÷÷bbbbb÷X÷a*÷÷÷÷÷Xe÷÷XX...../.",
        "../.....XXp÷÷oo÷fX÷÷ttttt÷X^÷÷÷÷A9÷XePXX...../..",
        ".../.....XX÷÷÷÷÷fX÷÷bbbbb÷Xb÷÷÷÷÷*FXeXX...../...",
        "...//.....XXi÷÷÷fX*÷÷÷÷÷÷*Xb÷÷÷÷÷*FXXX.....//...",
        "..././.....XX**÷nX÷÷bbbbb÷Xb÷÷÷÷A9÷XX....././...",
        ".../../.....XffffX÷÷ttttt÷Xb÷uuu÷÷÷X...../../...",
        ".../.../....XXXXXXXXXXXXXXXXXXXXXXXX..../.../...",
        ".../..../............................../..../...",
        ".../...../............................/...../...",
        ".../....../........................../....../...",
        ".../////////......................../////////...",
        "............////////////////////////............",
        "................................................"
      ],
      "palettes": [ "crt_universe" ],
      "terrain": { ".": "t_grass", "P": "t_console" },
      "computers": {
        "C": {
          "name": "C.R.I.T. H.S.P.O. Door",
          "security": 6,
          "options": [ { "name": "Unlock door?", "action": "unlock_disarm", "security": 7 } ],
          "failures": [ { "action": "damage" }, { "action": "shutdown" } ]
        }
      },
      "place_vehicles": [
        { "vehicle": "military_cargo_truck", "x": 18, "y": 11, "chance": 100, "rotation": 90, "status": 1 },
        { "vehicle": "military_cargo_truck", "x": 30, "y": 10, "chance": 100, "rotation": 0, "status": -1 }
      ],
      "place_item": [ { "item": "blade_crt", "x": 42, "y": 31 } ],
      "items": {
        "p": {
          "item": {
            "subtype": "distribution",
            "entries": [
              { "group": "military_patrol_food", "prob": 90, "count": [ 3, 5 ] },
              { "group": "infantry_common_gear", "prob": 5, "count": [ 1, 2 ] },
              { "group": "mil_food", "prob": 40, "count": [ 1, 5 ] },
              { "group": "infantry_medical_gear", "prob": 5, "count": [ 1, 2 ] }
            ]
          },
          "chance": 55
        },
        "l": {
          "item": {
            "subtype": "distribution",
            "entries": [
              { "group": "military_standard_guns", "prob": 50 },
              { "group": "military_standard_pistols", "prob": 25 },
              { "group": "crt_lab_loot", "prob": 4 },
              { "group": "crt_eng_set", "prob": 10 }
            ]
          },
          "chance": 70,
          "repeat": 2
        },
        "q": {
          "item": {
            "subtype": "distribution",
            "entries": [
              { "group": "supplies_electronics", "prob": 25 },
              { "group": "supplies_metal", "prob": 25 },
              { "group": "supplies_mechanics_milspec", "prob": 100 },
              { "group": "hardware", "prob": 50 }
            ]
          },
          "chance": 70,
          "repeat": 2
        },
        "f": { "item": "SUS_fridge", "chance": 90, "repeat": 2 },
        "o": { "item": "SUS_oven", "chance": 75 }
      },
      "place_monster": [
        { "monster": "mon_zombie_hulk", "x": 24, "y": 17 },
        { "monster": "mon_zombie_ichor_brute", "x": 24, "y": 18 },
        { "monster": "mon_zombie_kevlar_2", "x": 25, "y": 17 },
        { "monster": "mon_zombie_ichor_brute", "x": 40, "y": 31 },
        { "group": "GROUP_MIL_STRONG", "x": [ 16, 22 ], "y": [ 16, 22 ], "repeat": [ 3, 4 ] },
        { "group": "GROUP_MIL_WEAK", "x": [ 5, 12 ], "y": [ 16, 23 ], "repeat": [ 3, 6 ] },
        { "group": "GROUP_MIL_WEAK", "x": [ 29, 31 ], "y": [ 35, 36 ], "repeat": [ 3, 6 ] }
      ]
    }
  },
  {
    "type": "overmap_terrain",
    "id": [ "Crtbase1_0_0", "Crtbase1_0_1", "Crtbase1_1_0", "Crtbase1_1_1" ],
    "name": "C.R.I.T. Defensive Outpost",
    "sym": "C",
    "color": "red",
    "see_cost": 5,
    "extras": "build",
    "mondensity": 2
  },
  {
    "type": "mapgen",
    "method": "json",
    "om_terrain": [ [ "Critroof_0_0", "Critroof_0_1" ], [ "Critroof_1_0", "Critroof_1_1" ] ],
    "weight": 100,
    "object": {
      "fill_ter": "t_dirt",
      "rows": [
        "................................................",
        "................................................",
        "................................................",
        "................................................",
        "................................................",
        "............<<<<<<<<<<<<<<<<<<<<<<<<............",
        "............<<<<<<<<<<<<<<<<<<<<<<<<............",
        "............<<<<<<<<AAA<<AAA<<<<<<<<............",
        "...........<<<<<<<<<AAA<<AAA<<<<<<<<<...........",
        "..........<<<<<<<<<AAAA<<AAAA<<<<<<<<<..........",
        ".........<<<<<<<<<<AAAA<<AAAA<<<<<<<<<<.........",
        "........<<<<<<<<<<<fhfAAAAfhf<<<<<<<<<<<........",
        ".......<<bb<<<<bb<<AAAAAAAAAA<<bb<<<<bb<<.......",
        "......<<<bb<<<<bb<<AAAAAAAAAA<<bb<<<<bb<<<......",
        ".....<<<<bb<<<<bb<<<AAAAAAAA<<<bb<<<<bb<<<<.....",
        "....<<<<<bb<<<<bb<<<AAA<<AAA<<<bb<<<<bb<<<<<....",
        "....<<<<<bbbbbbbb<<<AAA<<AAA<<<bbbbbbbb<<<<<....",
        "....<<<<<bbbbbbbb<<<AAA<<AAA<<<bbbbbbbb<<<<<....",
        "....<<<<<bb<<<<bb<<<AAA<<AAA<<<bb<<<<bb<<<<<....",
        "....<<<<<bb<<<<bb<<<AAA<<AAA<<<bb<<<<bb<<<<<....",
        "....<<<<<bb<<<<bb<<<AAA<<AAA<<<bb<<<<bb<<<<<....",
        "....<<<<<bb<<<<bb<<<AAA<<AAA<<<bb<<<<bb<<<<<....",
        "....<<<<<<<<<<<<<<<<AAA<<AAA<<<<<<<<<<<<<<<<....",
        "....<<<<<<<<<<<<<<<<AAA<<AAA<<<<<<<<<<<<<<<<....",
        "....<<<<<<<<<<<<<<<<AAA<<AAA<<<<<<<<<<<<<<<<....",
        "....<<<<<<<<<<<<<<<<AAA<<AAA<<<<<<<<<<<<<<<<....",
        "....<<<<<bb<<<<bb<<<AAA<<AAA<<<<<<<<<<<<<<<<....",
        "....<<<<<bb<<<<bb<<<AAA<<AAA<<<<<<<<<<<<<<<<....",
        "....<<<<<bb<<<<bb<<<AAA<<AAA<<<<<<<<<<<<<<<<....",
        "....<<<<<bb<<<<bb<<<AAA<<AAA<<<<<<<<<<<<<<<<....",
        "....<<<<<bbbbbbbb<<<AAA<<AAA<<<<<<<<<<<<<<<<....",
        "....<<<<<bbbbbbbb<<<AAA<<AAA<<<<<<<<<<<<<<<<....",
        "....<<<<<bb<<<<bb<<<AAAAAAAA<<<<<<<<<<<<<<<<....",
        ".....<<<<bb<<<<bb<<AAAAAAAAAA<<<<<<<<<<<<<<.....",
        "......<<<bb<<<<bb<<AAAAAAAvvA<<<<<<<<<<<<<......",
        ".......<<bb<<<<bb<<AAAAAAAAAA<<<<<<<<<<<<.......",
        "........<<<<<<<<<<<fhfA<<Afhf<<<<<<<<<<<........",
        ".........<<<<<<<<<<AAAA<<AAAA<<<<<<<<<<.........",
        "..........<<<<<<<<<<AAA<<AAA<<<<<<<<<<..........",
        "...........<<<<<<<<<AAA<<AAA<<<<<<<<<...........",
        "............<<<<<<<<<<<<<<<<<<<<<<<<............",
        "............<<<<<<<<<<<<<<<<<<<<<<<<............",
        "................................................",
        "................................................",
        "................................................",
        "................................................",
        "................................................",
        "................................................"
      ],
      "terrain": {
        "<": "t_flat_roof",
        "v": "t_stairs_down",
        "A": "t_metal_floor",
        "f": "t_machinery_light",
        "b": "t_pavement_y",
        "h": "t_machinery_light",
        ".": "t_open_air"
      },
      "place_vehicles": [
        { "vehicle": "mil_helicopters", "x": 15, "y": 16, "chance": 100, "rotation": 180, "status": -1 },
        { "vehicle": "mil_helicopters", "x": 34, "y": 16, "chance": 100, "rotation": 180, "status": -1 },
        { "vehicle": "mil_helicopters", "x": 15, "y": 35, "chance": 100, "rotation": 0, "status": -1 },
        { "vehicle": "crt_medblimp", "x": 34, "y": 35, "chance": 100, "rotation": 0, "status": -1 }
      ]
    }
  },
  {
    "type": "overmap_terrain",
    "id": [ "Critroof_0_0", "Critroof_0_1", "Critroof_1_0", "Critroof_1_1" ],
    "name": "C.R.I.T. Defensive Outpost Roof",
    "sym": "H",
    "color": "red",
    "see_cost": 5,
    "extras": "build",
    "mondensity": 2
  }
]
