[
  {
    "type": "mapgen",
    "method": "json",
    "om_terrain": "nest_dermatik",
    "object": {
      "fill_ter": "t_region_groundcover",
      "rows": [
        "                        ",
        "       t  t   -     t   ",
        "  t   -    ----         ",
        "     ---...-..---       ",
        "    --.--..-...--- -    ",
        "    -..0#.-#0..------   ",
        "   --#.##.###..-..---   ",
        " t---#....-#.###..-- t  ",
        "  -###..###.....#0---   ",
        "  -#..###..#....#--.-   ",
        "  --#.######....##0.--  ",
        "   --...#.#.....##...-- ",
        "  --#.##.#.......#..--- ",
        " t--######......#.#0--  ",
        "  -...#........###...-  ",
        " -#.0.##.........##.--  ",
        "  --.#.........##.---   ",
        " --###.......###.#.0--  ",
        "--.0..#..#.#.#..0#...-  ",
        " -#.##########......--  ",
        " ------...##..0....--   ",
        "   ----#..0##-.-----    ",
        "  t   ---------- -   t  ",
        "       --- --           "
      ],
      "terrain": {
        "t": [ "t_region_tree", "t_region_groundcover" ],
        ",": [ "t_region_tree" ],
        "-": [ "t_wall_dirt" ],
        "#": [ [ "t_paper", 3 ], "t_wall_dirt" ],
        ".": [ "t_mud_underground", [ "t_floor_paper", 2 ] ],
        "0": [ "t_pit_shallow" ]
      },
      "monster": { "0": { "group": "GROUP_DERMATIK_INCUB", "chance": 70 } },
      "place_fields": [
        { "field": "fd_blood", "x": [ 3, 19 ], "y": [ 4, 20 ], "repeat": [ 30, 50 ] },
        { "field": "fd_blood_insect", "x": [ 3, 19 ], "y": [ 4, 20 ], "repeat": [ 20, 30 ] }
      ],
      "place_monster": [
        { "monster": "mon_dermatik_larva", "x": [ 8, 16 ], "y": [ 8, 16 ], "repeat": [ 2, 3 ] },
        { "monster": "mon_dermatik_midwife", "x": [ 10, 12 ], "y": [ 14, 17 ], "repeat": [ 1, 2 ] },
        { "monster": "mon_dermatik", "x": [ 0, 23 ], "y": [ 0, 23 ], "repeat": [ 4, 6 ] }
      ]
    }
  },
  {
    "type": "mapgen",
    "method": "json",
    "om_terrain": "nest_dermatik_roof",
    "object": {
      "fill_ter": "t_open_air",
      "rows": [
        "                        ",
        "                        ",
        "            ,,          ",
        "      ,,,,,,,,,         ",
        "     ,,,,,,,,,,,,,      ",
        "    ,,,,,,,,,,,,,,,,    ",
        "    ,,,,,,,,,,,,,,,,    ",
        "    ,,,,,,,,,,,,,,,,    ",
        "   ,,,,,,,,,,,,,,,,,    ",
        "   ,,,,,,,,,,,,,,,,,,   ",
        "   ,,,,,,,,,,,,,,,,,,,  ",
        "   ,,,,,,,,,,,,,,,,,,,  ",
        "   ,,,,,,,,,,,,,,,,,,,  ",
        "   ,,,,,,,,,,,,,,,,,,,  ",
        "  ,,,,,,,,,,,,,,,,,,,,  ",
        "  ,,,,,,,,,,,,,,,,,,,,  ",
        "  ,,,,,,,,,,,,,,,,,,,   ",
        " ,,,,,,,,,,,,,,,,,,,,   ",
        " ,,,,,,,,,,,,,,,,,,,,,  ",
        " ,,,,,,,,,,,,,,,,,,,,,  ",
        "   ,,,,,,,,,,,,,,,,,,   ",
        "       ,,,,,,,,,,,,     ",
        "        ,,,   ,         ",
        "                        "
      ],
      "terrain": { ",": [ "t_roof_paper" ] },
      "place_monster": [ { "monster": "mon_dermatik", "x": [ 6, 16 ], "y": [ 6, 16 ], "repeat": [ 1, 4 ] } ]
    }
  }
]
