[
  {
    "type": "mapgen",
    "method": "json",
    "om_terrain": [
      [ "steel_mill_0_1_2", "steel_mill_0_2_2", "steel_mill_0_3_2", "steel_mill_0_4_2" ],
      [ "steel_mill_1_1_2", "steel_mill_1_2_2", "steel_mill_1_3_2", "steel_mill_1_4_2" ],
      [ "steel_mill_2_1_2", "steel_mill_2_2_2", "steel_mill_2_3_2", "steel_mill_2_4_2" ],
      [ "steel_mill_3_1_2", "steel_mill_3_2_2", "steel_mill_3_3_2", "steel_mill_rail_1_2" ],
      [ "steel_mill_4_1_2", "steel_mill_4_2_2", "steel_mill_4_3_2", "steel_mill_rail_2_2" ]
    ],
    "object": {
      "fill_ter": "t_carpet_concrete",
      "rows": [
        "::::::::::::::::::::::::::::::::::::::::::::::::::::::::::::::::::::::::::::::::::::::::::::::::",
        "::::::::::::::::::::::::::::::::::::::::::::::::::::::::::::::::::::::::::::::::::::::::::::::::",
        "::::::::::::::::::::::::::::::::::::::::::::::::::::::::::::::::::::::::::::::::::::::::::::::::",
        ":::::]]]]]]]]]]]]**]]]**]]**]]**]:::::::::::::::::::::::::::::::::::::::::::::::::::::::::::::::",
        ":::::]aa]aa]>> #ch  #ch  #Sch  S]:::::::::::::::::::::::::::::::::::::::::::::::::::::::::::::::",
        ":::::]aa@aa]>> #ddd #ddd #Sddd  ]:::::::::::::::::::::::::::::::::::::::::::::::::::::::::::::::",
        ":::::]xx]xx]   # h  # h  #  h   ]rrrrrrrrrr:::::::::::::::::::::::::::::::::::::::::::::::::::::",
        ":::::]         #   S#   S#77   T]rrrrrrrrrr:::::::::::::::::::::::::::::::::::::::::::::::::::::",
        ":::::*         #+####+#######+##]rrrrrrrrrr:::::::::::::::::::::::::::::::::::::::::::::::::::::",
        ":::::*                          *rrrrrrrrrr:::::::::::::::::::::::::::::::::::::::::::::::::::::",
        ":::::]hTh DV                    *rrrrrrrrrr:::::::::::::::::::::::::::::::::::::::::::::::::::::",
        ":::::]######   #################]rrrrrrrrrr:::::::::::::::::::::::::::::::::::::::::::::::::::::",
        ":::::]W sll#   +            yyyy]rrrrrrrrrr:::::::::::::::::::::::::::::::::::::::::::::::::::::",
        ":::::]W    #   +     h h  h     *rrrrrrrrrr:::::::::::::::::::::::::::::::::::::::::::::::::::::",
        ":::::]W    #   #   hTTTTTTTT    *:::::::::::::::::::::::::::::::::::::::::::::::::::::::::::::::",
        ":::::]w    +   #7   TTTTTTTTh   ]:::::::::::::::::::::::::::::::::::::::::::::::::::::::::::::::",
        ":::::]w    #####7   TTTTTTTT    *:::::::::::::::::::::::::::::::::::::::::::::::::::::::::::::::",
        ":::::]AAAA +   #7      h  h     *:::::::::::::::::::::::::::::::::::::::::::::::::::::::::::::::",
        ":::::]]]]]]]UUU#                ]:::::::::::::::::::::::::::::::::::::::::::::::::::::::::::::::",
        ":::::::::::]]]]]**]]]**]]]**]**]]:::::::::::::::::::::::::::::::::::::::::::::::::::::::::::::::",
        ":::::::::::::::::::::::::rrrrrrr::::::::::::::::::::::::::::::::::::::::::::::::::::::::::::::::",
        ":::::::::::::::::::::::::rrrrrrr::::::::::::::::::::::::::::::::::::::::::::::::::::::::::::::::",
        ":::::]]]]]]]]]]]]]]]:::::rrrrrrr::::::::::::::::::::::::::::::::::::::::::::::::::::::::::::::::",
        ":::::]33333333333<>]:::::rrrrrrr::::::::::::::::::::::::::::::::::::::::::::::::::::::::::::::::",
        ":::::]FFFFE3aaaa333]rrrrrrrrrrrrr:::::::::::::::::::::::::::::::::::::::::::::::::::::::::::::::",
        ":::::]FaaF33aaaaa33]rrrrrrrrrrrrr:::::::::::::::::::::::::::::::::::::::::::::::::::::::::::::::",
        ":::::]FaaF3aaaaaa33Rrrrrrrrrrrrrrrrrrrrrrrrrrrr:::::::::::::::::::::::::::::::::::::::::::::::::",
        ":::::]FFFF3aaaaaa33]]]]]]]]]]]rrrrrrrrrrrrrrrrr:::::::::::::::::::::::::::::::::::::::::::::::::",
        ":::::]33333aaaaaa333333333333]rrrrrrrrrrrrrrrrr:::::::::::::rrrrrrrrrr::::::::::::::::::::::::::",
        ":::::]FFFF3aaaaaa333333333333]rrrrrrrrrrrrrrrrr:::::::::::::rrrrrrrrrr::::::::::::::::::::::::::",
        ":::::]FaaF3aaaaaaaaaaaaaaaa33]rrrrrrrrrrrrrrrrr:::::::::::::rrrrrrrrrr::::::::::::::::::::::::::",
        ":::::]FaaF3aaaaaaaaaaaaaaaa33]rrrrrrrrrrrrrrrrr:::::::::::::rrrrrrrrrr::::::::::::::::::::::::::",
        ":::::]FFFF3aaaaaaaaaaaaaaaa33Rrrrrrrrrrrrrrrrrr:::::::::::::rrrrrrrrrr::::::::::::::::::::::::::",
        ":::::]33333aaaaaaaaaaaaaaaa33Rrrrrrrrrrrrrrrrrr:::::::::::::rrrrrrrrrr::::::::::::::::::::::::::",
        ":::::]FFFF3aaaaaaaaaaaaaa3333]rrrrrrrrrrrrrrrrr:::::::::::::::::::::::::::::::::::::::::::::::::",
        ":::::]FaaF3aaaaaaaaaaaaaa3333]rrrrrrrrrrrrrrrrr:::::::::::::::::::::::::::::::::::::::::::::::::",
        ":::::]FaaF33aaaaaaaaaaaaa333>]rrrrrrrrrrrrrrrrr:::::::::::::::::::::::::::::::::::::::::::::::::",
        ":::::]FFFFE3aaaaaaaaaaaaa333>]rrrrrrrrrrrrrrrrr:::::::::::::::::::::::::::::::::::::::::::::::::",
        ":::::]PaaP33aaaaaaaaaaaaa3ee@]rrrrrrrrrrrrrrrrr:::::::::::::::::::::::::::::::::::::::::::::::::",
        ":::::]PaaP3a>>aaaaaaaaaaa3eee]rrrrrrrrrrrrrrrrr:::::::::::::::::::::::::::::::::::::::::::::::::",
        ":::::]33333a33aaEEaaaaaaa3eee]rrrrrrrrrrrrrrrrr::::::::::::::rrrrrrr::::::::::::::::::::::::::::",
        ":::::]3EE33333aaEEaaaaaaa3333Rrrrrrrrrrrrrrrrrr::::::::::::::rrrrrrr:::::::::::::rrrrrrr::::::::",
        ":::::]3cc33a>>aaaaaaaaaaa3333Rrrrrrrrrrrrrrrrrr::::::::::::::rrrrrrr:::::::::::::rrrrrrr::::::::",
        ":::::]33333aaaaaaaaaaaaaa3333]rrrrrrrrrrrrrrrrr::::::::::::::rrrrrrr:::::::::::::rrrrrrr::::::::",
        ":::::]##++#aaaaa>33>aaaaa3333]rrrrrrrrrrrrrrrrr::::::::::::::::::::::::::::::::::rrrrrrr::::::::",
        ":::::]>>  #aaaaa>33>aaaaa3333]rrrrrrrrrrrrrrrrr::::::::::::::rrrrrrr:::rrrrrrr::::::::::::::::::",
        ":::::]    Raaaaaaaaaaaaaa3333]rrrrrrrrrrrrrrrrr::::::::::::::rrrrrrr:::rrrrrrr::::::::::::::::::",
        ":::::]lh  Raaaa33333aaaaa3333Rrrrrrrrrrrrrrrrrr::::::::::::::rrrrrrr:::rrrrrrr::::::::::::::::::",
        ":::::]TTA #aaaaIE33Eaaaaaa333Rrrrrrrrrrrrrrrrrr::::::::::::::rrrrrrr:::rrrrrrr::::::::::::::::::",
        ":::::]#####aaaa3E33Eaaaaaaa33]rrrrrrrrrrrrrrrrr:::::::::::::::::::::::::::::::::::::::::::::::::",
        ":::::]aaaaaaaaa3ammaaaaaaaa33]]]]rrrrrrrrrrrrrr:::::::::::::::::::::::::::::::::::::::::::::::::",
        ":::::]]aaaaaaaa33mmaaaaaaaaaaaaaRrrrrrrrrrrrrrr:::::::::::::::::::::::::::::::::::::::::::::::::",
        "::::::]aaaaaaaa3ammaaaaaaaaaaaaaRrrrrrrrrrrrrrr:::::::::::::::::::::::::::::::::::::::::::::::::",
        ":::::]]aaaaaaaa3EppEaaaaaaaaaaaa]rrrrrrrrrrrrrr:::::::::::::::::::::::::::::::::::::::::::::::::",
        ":::::]aaaaaaaaa3EppEaaaaaaaaaaaa]rrrrrrrrrrrrrr:::::::::::::::::::::::::::::::::::::::::::::::::",
        ":::::]aaaaaaaaa3ammaaaaaaaaaaaaa]rrrrrrrrrrrrrr:::::::::::::::::::::::::::::::::::::::::::::::::",
        ":::::]aaaaaaaaa3ammaaaaaaaaaaaaa]rrrrrrrrrrrrrr:::::::::::::::::::::::::::::::::::::::::::::::::",
        ":::::]aaaaaaaaa3ammaaaaaaaaaaaaaRrrrrrrrrrrrrrr:::::::::::::::::::::::::::::::::::::::::::::::::",
        ":::::]aaaaaaaaaI333EaaaaaaaaaaaaRrrrrrrrrrrrrrr:::::::::::::::::::::::::::::::::::::::::::::::::",
        ":::::]aaaaaaaaa3E333aPPPPPPPPPaa]rrrrrrrrrrrrrr:::::::::::::::::::::::::::::::::::::::::::::::::",
        ":::::]aaa33333333333aaaaaaaaaaaa]rrrrrrrrrrrrrr:::::::::::::::::::::::::::::::::::::::::::::::::",
        ":::::]aaa3E3aaaaammaaaaaaaaaaaaa]rrrrrrrrrrrrrr:::::::::::::::::::::::::::::::::::::::::::::::::",
        ":::::]aaa3E3mmmmmmmaaaaaaaaaaaaa]rrrrrrrrrrrrrr:::::::::::::::::::::::::::::::::::::::::::::::::",
        ":::::]aaaammmaaaammaaaaaaaaaaaaaRrrrrrrrrrrrrrr:::::::::::::::::::::::::::::::::::::::::::::::::",
        ":::::]aaaammaaaaammaaaaaaaaaaaaaRrrrrrrrrrrrrrr::::::::::::::]]RR]]RR]]:::::::::::::::::::::::::",
        ":::::]aaaaaaaaaaammaaaaaaaaaaaaa]rrrrrrrrrrrrrr::::::::::::::]2      T]:::::::::::::::::::::::::",
        ":::::]aaaaaaaaaaammaaaaaaaaaaaaa]rrrrrrrrrrrrrr::::::::::::::]5h     T]:::::::::::::::::::::::::",
        ":::::]aaaaaaaaaaammaaaaaaaaaaaaa]rrrrrrrrrrrrrr::::::::::::::]5    h  ]:::::::::::::::::::::::::",
        ":::::]aaaaaaaaaaE33mmmmmmaaaaaaa]rrrrrrrrrrrrrr::::::::::::::] cc  cc>]:::::::::::::::::::::::::",
        ":::::]aaaaaaaaaaammaaaaaaaaaaaaaRrrrrrrrrrrrrrr::::::::::::::]]RR]]RR]]:::::::::::::::::::::::::",
        ":::::]aaaaaaaaaaammaaaaaaaaaaaaaRrrrrrrrrrrrrrr:::::::::::::::::::::::::::::::::::::::::::::::::",
        ":::::]aaaaaaaaaaaaaaaaaaaaaaaaaa]rrrrrrrrrrrrrr::::::::::::::::::::::%%gG::::::Gg%%gG::::::Gg%%:",
        ":::::]aaaaaaaaaaaaaaaaaaaaaaaaaa]rrrrrrrrrrrrrr::::::::::::::rrrrr:::%%gG::::::Gg%%gG::::::Gg%%:",
        ":::::]aaaaaaaaaaaaaaaaaaaaaaaaaa]rrrrrrrrrrrrrr::::::::::::::rrrrr::GGGGGGGGGGGGGGGGGGGGGGGGGGG:",
        ":::::]aaaaaaaaaaaaaaaaaaaaaaaaaa]rrrrrrrrrrrrrr::::::::::::::rrrrr::GG::G::::G::::::::G::::G::G:",
        ":::::]aaaaaaaaaaaaaaaaaaaaaaaaaaRrrrrr:::::::::::::::::::::::rrrrr::GI::G::::G::::::::G::::G::G:",
        ":::::]aaaaaaaaaaaaaaaaaaaaaaaaaaRrrrrr:::::::::::::::::::::::rrrrr::GG::G::::G::::::::G::::G::G:",
        ":::::]]]]]aaaaaaaaaaaaaaaaaaaaaa]rrrrr:::::::::::::::::::::::rrrrr::GGGGGGGGGGGGGGGGGGGGGGGGGGG:",
        ":::::::::]aaaaaaaaaaaaaaaaaaaaaa]rrrrr:::::::::::::::::::::::rrrrr:::%%gG::::::Gg%%gG::::::Gg%%:",
        ":::::::::]aaaaaaaaaaaaaaaaaaaaaa]rrrrr:::::::::::::::::::::::::::::::%%gG::::::Gg%%gG::::::Gg%%:",
        ":::::::::]aaaaaaaaaaaaaaaaaaaaaa]rrrrr::::::::::::::::::::::::::::::::::::::::::::::::::::::::::",
        ":::::::::]]]aaaaaaaaaaaaaaaaa]]]]::::::::::::::::::::::::::::rrrrr::::::::::::::::::::::::::::::",
        ":::::::::::::::::::::::::::::::::::::::::::::::::::::::::::::rrrrr::::::::::::::::::::::::::::::",
        ":::::::::::::::::::::::::::::::::::::::::::::::::::::::::::::rrrrr::::::::::::::::::::::::::::::",
        ":::::::::::::::::::::::::::::::::::::::::::::::::::::::::::::rrrrr::::::::::::::::::::::::::::::",
        ":::::::::::::::::::::::::::::::::::::::::::::::::::::::::::::rrrrr::::::::::::::::::::::::::::::",
        ":::::::::::::::::::::::::::::::::::::::::::::::::::::::::::::rrrrr::::::::::::::::::::::::::::::",
        ":::::::::::::::::::::::::::::::::::::::::::::::::::::::::::::rrrrr::::::::::::::::::::::::::::::",
        "::::::::::::::::::::::::::::::::::::::::::::::::::::::::::::::::::::::::::::::::::::::::::::::::",
        "::::::::::::::::::::::::::::::::::::::::::::::::::::::::::::::::::::::::::::::::::::::::::::::::",
        "::::::::::::::::::::::::::::::::::::::::::::::::::::::::::::::::::::::::::::::::::::::::::::::::",
        "::::::::::::::::::::::::::::::::::::::::::::::::::::::::::::::::::::::::::::::::::::::::::::::::",
        "::::::::::::::::::::::::::::::::::::::::::::::::::::::::::::::::::::::::::::::::::::::::::::::::",
        "::::::::::::::::::::::::::::::::::::::::::::::::::::::::::::::::::::::::::::::::::::::::::::::::",
        ":::::::::::::::::::::::::::::::::::::::::::::::::::::::::::::::::::::%%gG::::::Gg%%gG::::::Gg%%:",
        ":::::::::::::::::::::::::::::::::::::::::::::::::::::::::::::::::::::%%gG::::::Gg%%gG::::::Gg%%:",
        "::::::::::::::::::::::::::::::::::::::::::::::::::::::::::::::::::::GGGGGGGGGGGGGGGGGGGGGGGGGGG:",
        "::::::::::::::::::::::::::::::::::::::::::::::::::::::::::::::::::::GG::G::::G::::::::G::::G::G:",
        ":::::::::::::::rrrrrrrrrr]]RR]]]]]]]]]]]]]]]]]]]]:::::::::::::::::::GI::G::::G::::::::G::::G::G:",
        ":::::::::::::::rrrrrrrrrr]3333aaaaaaaaaaaaaaaaaa]::::::::::::rrrrr::GG::G::::G::::::::G::::G::G:",
        ":::::::::::::::rrrrrrrrrr]3333aaaaaaaaaaaaaaaaaa]::::::::::::rrrrr::GGGGGGGGGGGGGGGGGGGGGGGGGGG:",
        ":::::::::::::::rrrrrrrrrr]3333aaaaaaaaaaaaaaaaaa]::::::::::::rrrrr:::%%gG::::::Gg%%gG::::::Gg%%:",
        ":::::::::::::::rrrrrrrrrr]3333aaaaaaaaaaaaaaaaaa]::::::::::::rrrrr:::%%gG::::::Gg%%gG::::::Gg%%:",
        ":::::::::::::::rrrrrrrrrr]I333aaaaaaaaaaaaaaaaaa]::::::::::::rrrrr::::::::::::::::::::::::::::::",
        ":::::::::::::::rrrrrrrrrr]@e33aaaaaaaaaaaaaaaaaa]::::::::::::rrrrr::::::::::::::::::::::::::::::",
        ":::::::::::::::rrrrrrrrrr]ee33aaaaaaaaaaaaaaaaaa]::::::::::::rrrrr::::::::::::::::::::::::::::::",
        ":::::::::::::::::::::::::]3333333333333333333333]:::::::::::::::::::::::::::::::::::::::::::::::",
        ":::::::::::::::::::::::::]333333333333333FFFEFFF]:::::::::::::::::::::::::::::::::::::::::::::::",
        ":::::::::::::::::::::::::]33333333333333cFaFPFaF]:::::::::::::::::::::::::::::::::::::::::::::::",
        ":::::::::::::::::::::::::]33333333333333cFFF3FFF]:::::::::::::::::::::::::::::::::::::::::::::::",
        ":::::::::::::::::::::::::]]]]]]]]]]]]]]]]]]]]]]]]:::::::::::::::::::::::::::::::::::::::::::::::",
        "::::::::::::::::::::::::::::::::::::::::::::::::::::::::::::::::::::::::::::::::::::::::::::::::",
        "::::::::::::::::::::::::::::::::::::::::::::::::::::::::::::::::::::::::::::::::::::::::::::::::",
        "::::::::::::::::::::::::::::::::::::::::::::::::::::::::::::::::::::::::::::::::::::::::::::::::",
        "::::::::::::::::::::::::::::::::::::::::::::::::::::::::::::::::::::::::::::::::::::::::::::::::",
        "::::::::::::::::::::::::::::::::::::::::::::::::::::::::::::::::::::::::::::::::::::::::::::::::",
        "::::::::::::::::::::::::::::::::::::::::::::::::::::::::::::::::::::::::::::::::::::::::::::::::",
        "::::::::::::::::::::::::::::::::::::::::::::::::::::::::::::::::::::::::::::::::::::::::::::::::",
        "::::::::::::::::::::::::::::::::::::::::::::::::::::::::::::::::::::::::::::::::::::::::::::::::",
        "::::::::::::::::::::::::::::::::::::::::::::::::::::::::::::::::::::::::::::::::::::::::::::::::"
      ],
      "terrain": { "3": "t_grate_indoor" },
      "palettes": [ "steel_mill_palette" ],
      "place_monsters": [
        { "monster": "GROUP_STEEL_MILL", "x": [ 12, 23 ], "y": [ 5, 18 ], "repeat": [ 0, 1 ], "density": 1 },
        { "monster": "GROUP_STEEL_MILL", "x": [ 24, 33 ], "y": [ 5, 18 ], "repeat": [ 0, 1 ], "density": 1 }
      ]
    }
  }
]
