[
  {
    "type": "mapgen",
    "method": "json",
    "om_terrain": [ "mil_base_tunnels_j" ],
    "weight": 250,
    "object": {
      "fill_ter": "t_thconc_floor",
      "rows": [
        "@@@@@@@@@@@@@@@@@@@@@@@@",
        "@@@@@@@@@@@@@@@@@@@@@@@@",
        "@@@@@@@@@@@@@@@@@@@@@@@@",
        "@@@@@@@@@@@@@@@@@@@@@@@@",
        "@@@@@@@@@@@@@@@@@@@@@@@@",
        "@@@@@@@@@@@@@@@@@@@@@@@@",
        "@@@@@@@@@@@@@@@@@@@@@@@@",
        "@@@@@@@@@@@@@@@@@@@@@@@@",
        "@@@@@@@@@@@@@@@@@@@@@@@@",
        "@@@@@@@@@@@@@@@@@@@@@@@@",
        "@@@@@@@@@@@@@@@@@@@@@@@@",
        "@@@@@@@@@///////////////",
        "@@@@@@@@@/u..u..uuuuu..u",
        "@@@@@@@@@/u..u.........u",
        "@@@@@@@@@/u.............",
        "@@@@@@@@@/u.....uuuuu...",
        "@@@@@@@@@/]]]]((]]]]]((]",
        "@@@@@@@@@/..............",
        "@@@@@@@@@/..............",
        "@@@@@@@@@/]((]/]]]((]]]/",
        "@@@@@@@@@/C.../C......C/",
        "@@@@@@@@@/C.../C......C/",
        "@@@@@@@@@/C.uu/C.CCCC.C/",
        "@@@@@@@@@///////////////"
      ],
      "palettes": [ "mil_base_palette" ],
      "place_loot": [
        { "group": "ammo_rifle_milspec", "x": 10, "y": [ 12, 15 ], "chance": 75, "repeat": 15 },
        { "group": "ammo_milspec", "x": 10, "y": [ 12, 15 ], "chance": 75, "repeat": 10 },
        { "group": "mags_milspec", "x": 10, "y": [ 12, 15 ], "chance": 75, "repeat": 5 },
        { "group": "military_standard_shotguns", "x": 13, "y": [ 12, 13 ], "chance": 75, "repeat": 5 },
        { "group": "guns_shotgun_milspec", "x": 13, "y": [ 12, 13 ], "chance": 75, "repeat": 5 },
        { "group": "military_standard_sniper_rifles", "x": [ 16, 20 ], "y": 12, "chance": 75, "repeat": 5 },
        { "group": "guns_rifle_milspec", "x": [ 16, 20 ], "y": 12, "chance": 75, "repeat": 5 },
        { "group": "guns_smg_milspec", "x": [ 16, 20 ], "y": 12, "chance": 75, "repeat": 5 },
        { "group": "military_standard_assault_rifles", "x": [ 16, 20 ], "y": 15, "chance": 75, "repeat": 20 },
        { "group": "military_standard_lmgs", "x": [ 16, 20 ], "y": 15, "chance": 75, "repeat": 10 },
        { "group": "mil_base_hmg", "x": [ 16, 20 ], "y": 15, "chance": 75, "repeat": 2 },
        { "group": "military_standard_pistols", "x": 23, "y": [ 12, 13 ], "chance": 75, "repeat": 10 },
        { "group": "guns_pistol_milspec", "x": 23, "y": [ 12, 13 ], "chance": 75, "repeat": 5 },
        { "group": "military", "x": 10, "y": [ 20, 21 ], "chance": 75, "repeat": 10 },
        { "group": "pwr_armor", "x": 10, "y": 22, "chance": 75 },
        { "group": "pwr_armor_acc", "x": 10, "y": 22, "chance": 75, "repeat": 3 },
        { "item": "adv_UPS_off", "x": 12, "y": 22, "chance": 75, "repeat": 2 },
        { "item": "plut_cell", "x": 12, "y": 22, "chance": 75, "repeat": 4 },
        { "group": "mech_power_cell_spawn", "x": 13, "y": 22 },
        { "group": "guns_launcher_rocket", "x": 15, "y": [ 20, 22 ], "chance": 75, "repeat": 5 },
        { "group": "grenades", "x": [ 17, 20 ], "y": 22, "chance": 75, "repeat": 20 },
        { "group": "guns_launcher_grenade", "x": 22, "y": [ 20, 22 ], "chance": 75, "repeat": 5 },
        { "group": "ammo_launcher_grenade", "x": 22, "y": [ 20, 22 ], "chance": 75, "repeat": 5 }
      ],
      "place_monster": [ { "group": "GROUP_ROBOTS_MIL", "x": [ 11, 22 ], "y": [ 13, 21 ], "repeat": [ 2, 3 ] } ]
    }
  },
  {
    "type": "mapgen",
    "method": "json",
    "om_terrain": [ "mil_base_tunnels_a" ],
    "weight": 250,
    "object": {
      "fill_ter": "t_thconc_floor",
      "rows": [
        "@@@@@@@@@@@@@@@@@@@@@@@@",
        "@@@@@@@@@@@@@@@@@@@@@@@@",
        "@@@@@@@@@@@@@@@@@@@@@@@@",
        "@@@@@@@@@@@@@@@@@@@@@@@@",
        "@@@@@@@@@@@@@@@@@@@@@@@@",
        "@@@@@@@@@@@@@@@@@@@@@@@@",
        "@@@@@@@@@@@@@@@@@@@@@@@@",
        "@@@@@@@@@@@@@@@@@@@@@@@@",
        "@@@@@@@@@@@@@@@@@@@@@@@@",
        "@@@@@@@@@@@@@@@@@@@@@@@@",
        "@@@@@@@@@@@@@@@@@@@@@@@@",
        "////@@@@@@@@@@@@@@@@@@@@",
        "..u/@@@@@@@@@@@@@@@@@@@@",
        "..u/////@@@@@@@@@@@@@@@@",
        "..u/..</@@@@@@@@@@@@@@@@",
        "..u/..</@@@@@@@@@@@@@@@@",
        "]]]/..//////////////////",
        "...D..z.................",
        "...D..z.................",
        "ω/ω/5//..///////////////",
        "////@@/../@@@@@@@@@@@@@@",
        "@@@@@@/../@@@@@@@@@@@@@@",
        "@@@@@@/../@@@@@@@@@@@@@@",
        "@@@@@@/../@@@@@@@@@@@@@@"
      ],
      "palettes": [ "mil_base_palette" ],
      "monster": { "ω": { "monster": "mon_turret_medium" } },
      "place_loot": [
        { "group": "ammo_rifle_milspec", "x": 2, "y": [ 12, 15 ], "chance": 75, "repeat": 15 },
        { "group": "ammo_milspec", "x": 2, "y": [ 12, 15 ], "chance": 75, "repeat": 10 },
        { "group": "mags_milspec", "x": 2, "y": [ 12, 15 ], "chance": 75, "repeat": 5 }
      ],
      "place_monster": [ { "group": "GROUP_ROBOTS_MIL", "x": [ 4, 5 ], "y": [ 14, 18 ], "repeat": [ 1, 2 ] } ]
    }
  },
  {
    "type": "mapgen",
    "method": "json",
    "om_terrain": [ "mil_base_tunnels_b" ],
    "weight": 250,
    "object": {
      "fill_ter": "t_thconc_floor",
      "rows": [
        "@@@@@@/../@@@@@@@@@@@@@@",
        "@@@@@@/../@@@@@@@@@@@@@@",
        "@@@@@@/../@@@@@@@@@@@@@@",
        "@@@@@@/../@@@@@@@@@@@@@@",
        "@@@@@@/../@@@@@@@@@@@@@@",
        "@@@@@@/../@@@@@@@@@@@@@@",
        "@@@@@@/../@@@@@@@@@@@@@@",
        "@@@@@@/../@@@@@@@@@@@@@@",
        "@@@@@@/../@@@@@@@@@@@@@@",
        "@@@@@@/../@@@@@@@@@@@@@@",
        "@@@@@@/../@@@@@@@@@@@@@@",
        "@@@@@@/../@@@@@@@@@@@@@@",
        "@@@@@@/../@@@@@@@@@@@@@@",
        "@@@@@@/../@@@@@@@@@@@@@@",
        "@@@@@@/../@@@@@@@@@@@@@@",
        "@@@@@@/../@@@@@@@@@@@@@@",
        "@@@@@@/../@@@@@@@@@@@@@@",
        "@@@@@@/../@@@@@@@@@@@@@@",
        "@@@@@@/../@@@@@@@@@@@@@@",
        "@@@@@@/../@@@@@@@@@@@@@@",
        "@@@@@@/../@@@@@@@@@@@@@@",
        "@@@@@@/../@@@@@@@@@@@@@@",
        "@@@@@@/../@@@@@@@@@@@@@@",
        "@@@@@@/../@@@@@@@@@@@@@@"
      ],
      "palettes": [ "mil_base_palette" ]
    }
  },
  {
    "type": "mapgen",
    "method": "json",
    "om_terrain": [ "mil_base_tunnels_c" ],
    "weight": 250,
    "object": {
      "fill_ter": "t_thconc_floor",
      "rows": [
        "@@@@@@/../@@@@@@@@@@@@@@",
        "///////../@@@@@@@@@@@@@@",
        "........./@@@@@@@@@@@@@@",
        "........./@@@@@@@@@@@@@@",
        "///////../@@@@@@@@@@@@@@",
        "@///@@/../@@@@@@@@@@@@@@",
        "@/</@@/../@@@@@@@@@@@@@@",
        "//.////../@@@@@@@@@@@@@@",
        ".....e/../@@@@@@@@@@@@@@",
        "......D../@@@@@@@@@@@@@@",
        "///////../@@@@@@@@@@@@@@",
        "/////@/../@@@@@@@@@@@@@@",
        "l.#t/@/../@@@@@@@@@@@@@@",
        "..#h/@/../@@@@@@@@@@@@@@",
        "..#./@/../@@@@@@@@@@@@@@",
        "..../@/../@@@@@@@@@@@@@@",
        ".`$$/@/../@@@@@@@@@@@@@@",
        "/////@/../@@@@@@@@@@@@@@",
        "`OOO/@/../@@@@@@@@@@@@@@",
        "..ht/@/../@@@@@@@@@@@@@@",
        ".###/@/../@@@@@@@@@@@@@@",
        "..../@/../@@@@@@@@@@@@@@",
        "Y.$$/@/../@@@@@@@@@@@@@@",
        "/////@/../@@@@@@@@@@@@@@"
      ],
      "items": {
        "t": [ { "item": "trash_cart", "chance": 75, "repeat": [ 1, 10 ] } ],
        "#": [ { "item": "SUS_office_desk", "chance": 10, "repeat": [ 1, 2 ] } ],
        "$": [ { "item": "SUS_office_filing_cabinet", "chance": 50, "repeat": [ 1, 5 ] } ],
        "O": [ { "item": "mil_base_books", "chance": 30, "repeat": [ 1, 5 ] } ],
        "Y": [ { "item": "mil_base_coats", "chance": 25, "repeat": [ 1, 2 ] } ],
        "l": [ { "item": "mil_base_coats", "chance": 25, "repeat": [ 1, 2 ] } ]
      },
      "palettes": [ "mil_base_palette" ]
    }
  },
  {
    "type": "mapgen",
    "method": "json",
    "om_terrain": [ "mil_base_tunnels_d" ],
    "weight": 250,
    "object": {
      "fill_ter": "t_thconc_floor",
      "rows": [
        "@//////../@@@@@@@@@@@@@@",
        "@/<.D..../@@@@@@@@@@@@@@",
        "@////e.../@@@@@@@@@@@@@@",
        "@@@@//////@@@@@@@@@@@@@@",
        "@@@@@@@@@@@@@@@@@@@@@@@@",
        "@@@@@@@@@@@@@@@@@@@@@@@@",
        "@@@@@@@@@@@@@@@@@@@@@@@@",
        "@@@@@@@@@@@@@@@@@@@@@@@@",
        "@@@@@@@@@@@@@@@@@@@@@@@@",
        "@@@@@@@@@@@@@@@@@@@@@@@@",
        "@@@@@@@@@@@@@@@@@@@@@@@@",
        "@@@@@@@@@@@@@@@@@@@@@@@@",
        "@@@@@@@@@@@@@@@@@@@@@@@@",
        "@@@@@@@@@@@@@@@@@@@@@@@@",
        "@@@@@@@@@@@@@@@@@@@@@@@@",
        "@@@@@@@@@@@@@@@@@@@@@@@@",
        "@@@@@@@@@@@@@@@@@@@@@@@@",
        "@@@@@@@@@@@@@@@@@@@@@@@@",
        "@@@@@@@@@@@@@@@@@@@@@@@@",
        "@@@@@@@@@@@@@@@@@@@@@@@@",
        "@@@@@@@@@@@@@@@@@@@@@@@@",
        "@@@@@@@@@@@@@@@@@@@@@@@@",
        "@@@@@@@@@@@@@@@@@@@@@@@@",
        "@@@@@@@@@@@@@@@@@@@@@@@@"
      ],
      "palettes": [ "mil_base_palette" ]
    }
  },
  {
    "type": "mapgen",
    "method": "json",
    "om_terrain": [ "mil_base_tunnels_e" ],
    "weight": 250,
    "object": {
      "fill_ter": "t_thconc_floor",
      "rows": [
        "@@@@@@@@@@@@@@@@@@@@@@@@",
        "////////////////////////",
        "........................",
        "........................",
        "////////////////////////",
        "@@@@@@@@@@@@@@@@@@@@@@@@",
        "@@@@@@@@@@@@@@@@@@@@@@@@",
        "@@@@@@@@@@@@@//////ω/ω//",
        "@@@@@@@@@@@@@/[l......D.",
        "@@@@@@@@@@@@@/[hC.....D.",
        "@@@@@@@@@@@@@/##///ω/ω/5",
        "@/////////////ll////////",
        "@/`..Y/......$l$h....../",
        "@/$.../................/",
        "@/$.#.=../////zz/////..=",
        "@/$h#./../$$$....$$$/../",
        "@/$t#./../........../../",
        "@//////../[........[/../",
        "@/t#.l/../[.hhhhhh.[/../",
        "@/h#../../[.''''''.[/../",
        "@/.#..=../........../..=",
        "@/...`/..z..hhhhhh..z../",
        "@/$$$O/..z..''''''..z../",
        "///////../..........////"
      ],
      "palettes": [ "mil_base_palette" ],
      "items": {
        "t": [ { "item": "trash_cart", "chance": 75, "repeat": [ 1, 10 ] } ],
        "#": [ { "item": "SUS_office_desk", "chance": 10, "repeat": [ 1, 2 ] } ],
        "$": [ { "item": "SUS_office_filing_cabinet", "chance": 50, "repeat": [ 1, 5 ] } ],
        "O": [ { "item": "mil_base_books", "chance": 30, "repeat": [ 1, 3 ] } ],
        "Y": [ { "item": "mil_base_coats", "chance": 25, "repeat": [ 1, 2 ] } ]
      },
      "monster": { "ω": { "monster": "mon_turret_medium" } },
      "place_monsters": [ { "monster": "GROUP_MIL_BASE", "x": [ 7, 22 ], "y": [ 13, 23 ], "repeat": [ 4, 5 ], "density": 0.1 } ]
    }
  },
  {
    "type": "mapgen",
    "method": "json",
    "om_terrain": [ "mil_base_tunnels_f" ],
    "weight": 250,
    "object": {
      "fill_ter": "t_thconc_floor",
      "rows": [
        "/OAAAY/../[.hhhhhh.[/@@@",
        "/.....+../[.''''''.[/@@@",
        "/l..../../[........[/@@@",
        "/l.[[[/../........../@@@",
        "/...../../.'..[[..'./@@@",
        "/OAAAO/../h'..[[..'h/@@@",
        "///////../$'..[[..'$/@@@",
        "/T/T/T/../$........$/@@@",
        "/+/+/+/..//........//@@@",
        "/.....+..//''''''''/@@@@",
        "/ScScS//////////////@@@@",
        "///////@@@@@@@@@@@@@@@@@",
        "@@@@@@@@@@@@@@@@@@@@@@@@",
        "@@@@@@@@@@@@@@@@@@@@@@@@",
        "@@@@@@@@@@@@@@@@@@@@@@@@",
        "@@@@@@@@@@@@@@@@@@@@@@@@",
        "@@@@@@@@@@@@@@@@@@@@@@@@",
        "@@@@@@@@@@@@@@@@@@@@@@@@",
        "@@@@@@@@@@@@@@@@@@@@@@@@",
        "@@@@@@@@@@@@@@@@@@@@@@@@",
        "@@@@@@@@@@@@@@@@@@@@@@@@",
        "@@@@@@@@@@@@@@@@@@@@@@@@",
        "@@@@@@@@@@@@@@@@@@@@@@@@",
        "@@@@@@@@@@@@@@@@@@@@@@@@"
      ],
      "palettes": [ "mil_base_palette" ],
      "items": {
        "$": [ { "item": "SUS_office_filing_cabinet", "chance": 50, "repeat": [ 1, 5 ] } ],
        "O": [ { "item": "mil_base_books", "chance": 30, "repeat": [ 1, 3 ] } ],
        "Y": [ { "item": "mil_base_coats", "chance": 25, "repeat": [ 1, 2 ] } ]
      },
      "place_loot": [
        { "item": "militarymap", "x": 14, "y": 5 },
        { "group": "SUS_coffee_cupboard", "x": 1, "y": 2, "chance": 50, "repeat": [ 1, 2 ] },
        { "group": "dinnerware", "x": 1, "y": 1, "chance": 2, "repeat": [ 5, 10 ] },
        { "group": "liquor_and_spirits", "x": 1, "y": 3, "chance": 50, "repeat": [ 3, 4 ] }
      ],
      "place_monsters": [ { "monster": "GROUP_MIL_BASE", "x": [ 11, 19 ], "y": [ 0, 8 ], "repeat": [ 1, 2 ], "density": 0.1 } ]
    }
  },
  {
    "type": "mapgen",
    "method": "json",
    "om_terrain": [ "mil_base_tunnels_g" ],
    "weight": 250,
    "object": {
      "fill_ter": "t_thconc_floor",
      "rows": [
        "@@@@@@@@@@@@@@@@@@@@@@@@",
        "////////////////////////",
        "........................",
        "........................",
        "////////////////////////",
        "@@@@@@@@@@@@@@@@@@@@@@@@",
        "@@@@@@@@@@@@@@@@@@@@@@@@",
        "@@@@@@@@@@@@@@@@@@@@@@@@",
        "@@@@@@@@@@@@@@@@@@@@@@@@",
        "@@@@@@@@@@@@@@@@@@@@@@@@",
        "@@@@@@@@@@@@@@@@@@@@@@@@",
        "@@@@@@@@@@@@@@@@@@@@@@@@",
        "@@@@@@@@@@@@@@@@@@@@@@@@",
        "@@@@@@@@@@@@@@@@@@@@@@@@",
        "@@@@@@@@@@@@@@@@@@@@@@@@",
        "@@@@@@@@@@@@@@@@@@@@@@@@",
        "@@@@@@@@@@@@@@@@@@@@@@@@",
        "@@@@@@@@@@@@@@@@@@@@@@@@",
        "@@@@@@@@@@@@@@@@@@@@@@@@",
        "@@@@@@@@@@@@@@@@@@@@@@@@",
        "@@@@@@@@@@@@@@@@@@@@@@@@",
        "@@@@@@@@@@@@@@@@@@@@@@@@",
        "@@@@@@@@@@@@@@@@@@@@@@@@",
        "@@@@@@@@@@@@@@@@@@@@@@@@"
      ],
      "palettes": [ "mil_base_palette" ]
    }
  },
  {
    "type": "mapgen",
    "method": "json",
    "om_terrain": [ "mil_base_tunnels_h" ],
    "weight": 250,
    "object": {
      "fill_ter": "t_thconc_floor",
      "rows": [
        "@@@@@@@@@@@@@@@@///@@@@@",
        "@@@@@@@@@@@@@@@@/<//////",
        "@@@@@@@@@@@@@@@@/.......",
        "@@@@@@@@@@@@@@@@/.......",
        "@@@@@@@@@@@@@@@@////////",
        "@@@@@@@@@@@@@@@@@@@@@@@@",
        "@@@@@@@@@@@@@@@@@@@@@@@@",
        "@@@@@@@@@@@@@@@@@@@@@@@@",
        "@@@@@@@@@@@@@@@@@@@@@@@@",
        "@@@@@@@@@@@@@@@@@@@@@@@@",
        "@@@@@@@@@@@@@@@@@@@@@@@@",
        "@@@@@@@@@@@@@@@@@@@@@@@@",
        "@@@@@@@@@@@@@@@@@@@@@@@@",
        "@@@@@@@@@@@@@@@@@@@@@@@@",
        "@@@@@@@@@@@@@@@@@@@@@@@@",
        "@@@@@@@@@@@@@@@@@@@@@@@@",
        "@@@@@@@@@@@@@@@@@@@@@@@@",
        "@@@@@@@@@@@@@@@@@@@@@@@@",
        "@@@@@@@@@@@@@@@@@@@@@@@@",
        "@@@@@@@@@@@@@@@@@@@@@@@@",
        "@@@@@@@@@@@@@@@@@@@@@@@@",
        "@@@@@@@@@@@@@@@@@@@@@@@@",
        "@@@@@@@@@@@@@@@@@@@@@@@@",
        "@@@@@@@@@@@@@@@@@@@@@@@@"
      ],
      "palettes": [ "mil_base_palette" ]
    }
  },
  {
    "type": "mapgen",
    "method": "json",
    "om_terrain": [ "mil_base_tunnels_i" ],
    "weight": 250,
    "object": {
      "fill_ter": "t_thconc_floor",
      "rows": [
        "@@@@@@@@@@@@@@@@@@@@@@@@",
        "@@@@@@@@@@@@@@@@@@@@@@@@",
        "@@@@@@@@@@@@@@@@@@@@@@@@",
        "@@@@@@@@@@@@@@@@@@@@@@@@",
        "@@@@@@@@@@@@@@@@@@@@@@@@",
        "@@@@@@@@@@@@@@@@@@@@@@@@",
        "@@@@@@@@@@@//////@@@@@@@",
        "@@@@@@@@@@@/uuuu/@@@@@@@",
        "@@@@@@@@@@@/..../@@@@@@@",
        "@@@@@//////////d///@@@@@",
        "@@@@@/aaaaaaaB...c/@@@@@",
        "@@@@@/...........c/@@///",
        "@@@@@/...........B/@@/..",
        "@@@@@/aaaaaaaB...B/@@/..",
        "@@@@@/aaaaaaaB...B//@/..",
        "@@@@@/............</@/..",
        "//////BBBBB......c//@/..",
        ".....D...........c/@@/..",
        "....e/!!!!!!!....c/@@/..",
        "/..////////////////@@/..",
        "/../@@@@@@@@@@@@@@@@@/..",
        "/../@@@@@@@@@@@@@@@@@/..",
        "/../@@@@@@@@@@@@@@@@@/..",
        "/..///////////////////.."
      ],
      "palettes": [ "mil_base_palette" ],
      "furniture": { "B": "f_bench" },
      "terrain": { "B": "t_thconc_floor" },
      "place_loot": [
        { "item": "detergent", "x": [ 12, 13 ], "y": 7, "chance": 75, "repeat": [ 25, 50 ] },
        { "item": "bleach", "x": [ 14, 15 ], "y": 7, "chance": 75, "repeat": [ 25, 50 ] },
        { "item": "towel", "x": 17, "y": [ 10, 11 ], "chance": 75, "repeat": 15 },
        { "group": "mil_bedding", "x": 17, "y": [ 16, 18 ], "chance": 75, "repeat": 30 }
      ],
      "place_vehicles": [
        { "vehicle": "laundry_cart", "x": 14, "y": 18, "chance": 75, "status": 0 },
        { "vehicle": "laundry_cart", "x": 15, "y": 18, "chance": 75, "status": 0 },
        { "vehicle": "laundry_cart", "x": 16, "y": 18, "chance": 75, "status": 0 }
      ]
    }
  },
  {
    "type": "mapgen",
    "method": "json",
    "om_terrain": [ "mil_base_tunnels_l" ],
    "weight": 250,
    "object": {
      "fill_ter": "t_thconc_floor",
      "rows": [
        "@@@@@@@@@@@@@@@@@@@@@@@@",
        "@@@@@@@@@@@@@@@@@@@@@@@@",
        "@@@@@@@@@@@@@@@@@@@@@@@@",
        "@@@@@@@@@@@@@@@@@@@@@@@@",
        "@@@@@@@@@@@@@@@@@@@@@@@@",
        "@@@@@@@@@@@@@@@@@@@@@@@@",
        "@@@@@@@@@@@@@@@@@@@@@@@@",
        "@@@@@@@@@@@@@@@@@@@@@@@@",
        "@@@@@@@@@@@@@@@@@@@@@@@@",
        "@@@@@@@@@@@@@@@@@@@@@@@@",
        "@@@@@@@@@@@@@@@@@@@@@@@@",
        "//////////@@@@@@@@@@@@@@",
        "........./@@@@@@@@@@@@@@",
        "........./@@@@@@@@@@@@@@",
        "iiiiiii../@@@@@@@@@@@@@@",
        "iiiiiii../@///@@///@@@@@",
        "iiiiiii..///ω////ω/@@@@@",
        "iiiiiii..../....../@@@@@",
        "iiiiiii....D....uu/@@@@@",
        "iiiiiii....D....uu/@@@@@",
        "iiiiiii....5....../@@@@@",
        "iiiiiii..///ω////ω/@@@@@",
        "iiiiiii../@///@@///@@@@@",
        "iiiiiiiα./@@@@@@@@@@@@@@"
      ],
      "palettes": [ "mil_base_palette" ],
      "monster": { "ω": { "monster": "mon_turret_medium" } },
      "place_loot": [ { "group": "steel_mill_storage", "x": [ 16, 17 ], "y": [ 18, 19 ], "chance": 75, "repeat": 3 } ],
      "place_monster": [
        { "monster": [ "mon_mech_combat", "mon_mech_recon" ], "x": 15, "y": [ 18, 19 ] },
        { "group": "GROUP_ROBOTS_MIL", "x": [ 0, 8 ], "y": [ 12, 22 ], "repeat": [ 1, 2 ] }
      ]
    }
  },
  {
    "type": "mapgen",
    "method": "json",
    "om_terrain": [ "mil_base_tunnels_m" ],
    "weight": 250,
    "object": {
      "fill_ter": "t_thconc_floor",
      "rows": [
        "........./@////////@@@@@",
        "........./@/uuuuuu/@@@@@",
        "..&&&..../@/....../@@@@@",
        "..&&&..../@/....../@@@@@",
        "..&&&....///..CC??/@@@@@",
        "..&&&....../..CC??/@@@@@",
        "..&&&......z....../@@@@@",
        "..&&&......z....../@@@@@",
        "..&&&....../..CC??/@@@@@",
        "..&&&....///..CC??/@@@@@",
        "..&&&..../@/....../@@@@@",
        "..&&&..../@/....../@@@@@",
        "........./@/uuuuuu/@@@@@",
        "........./@////////@@@@@",
        "//////////@@@@@@@@@@@@@@",
        "@@@@@@@@@@@@@@@@@@@@@@@@",
        "@@@@@@@@@@@@@@@@@@@@@@@@",
        "@@@@@@@@@@@@@@@@@@@@@@@@",
        "@@@@@@@@@@@@@@@@@@@@@@@@",
        "@@@@@@@@@@@@@@@@@@@@@@@@",
        "@@@@@@@@@@@@@@@@@@@@@@@@",
        "@@@@@@@@@@@@@@@@@@@@@@@@",
        "@@@@@@@@@@@@@@@@@@@@@@@@",
        "@@@@@@@@@@@@@@@@@@@@@@@@"
      ],
      "palettes": [ "mil_base_palette" ],
      "items": {
        "?": [ { "item": "SUS_welding_gear", "chance": 75 } ],
        "C": [
          { "item": "supplies_electronics", "chance": 75, "repeat": 2 },
          { "item": "supplies_metal", "chance": 75, "repeat": 4 }
        ],
        "u": [ { "item": "fuel_barrel", "chance": 75 } ]
      },
      "place_monster": [ { "group": "GROUP_ROBOTS_MIL", "x": [ 0, 8 ], "y": [ 0, 13 ], "repeat": [ 2, 3 ] } ]
    }
  },
  {
    "type": "mapgen",
    "method": "json",
    "om_terrain": [ "mil_base_tunnels_n" ],
    "weight": 250,
    "object": {
      "fill_ter": "t_thconc_floor",
      "rows": [
        "/....................z..",
        "/....................z..",
        "//////////////////////..",
        "@@@@@@@@@@@@@@@@@@@@@/..",
        "@@@@@@@@@@@@@@@@@@@@@/..",
        "@@@@@@@@@@@@@@@@@@@@@/..",
        "@@@@@@@@@@@@@@@@@@@@@/..",
        "@@@@@@@@@@@@@@@@@@@@@/..",
        "@@@@@@@@@@@@@@@@@@@@@/..",
        "@@@@@@@@@@@@@@@@@@@@@/..",
        "@@@@@@@@@@@@@@@@@@@@@/..",
        "@@@@@@@@@@@@@@@@@@@@@/..",
        "@@@@@@@@@@@@@@@@@@@@@/..",
        "@@@@@@@@@@@@@@@@@@@@@/..",
        "@@@@@@@@@@@@@@@@@@@@@///",
        "@@@@@@@@@@@@@@@@@@@@@@@@",
        "@@@@@@@@@@@@@@@@@@@@@@@@",
        "@@@@@@@@@@@@@@@@@@@@@@@@",
        "@@@@@@@@@@@@@@@@@@@@@@@@",
        "@@@@@@@@@@@@@@@@@@@@@@@@",
        "@@@@@@@@@@@@@@@@@@@@@@@@",
        "@@@@@@@@@@@@@@@@@@@@@@@@",
        "@@@@@@@@@@@@@@@@@@@@@@@@",
        "@@@@@@@@@@@@@@@@@@@@@@@@"
      ],
      "palettes": [ "mil_base_palette" ]
    }
  }
]
