[
  {
    "//": "Basement - variant 1: kid's bedroom, rec room, laundry, storage ",
    "type": "mapgen",
    "om_terrain": "2storyModern01_basement",
    "weight": 20,
    "method": "json",
    "object": {
      "palettes": [ "standard_domestic_palette", "standard_domestic_basement_palette" ],
      "fill_ter": "t_floor",
      "rows": [
        "^^^^^^^^^^^^^^^^^^^^^^^^",
        "^^^^^^^^^^^^^^^^^^^^^^^^",
        "^^^^^^^^^^^^^^^^^^^^^^^^",
        "^^^^^^^^^^^^^^^^^^^^^^^^",
        "^^^^|||||||||||||||||||^",
        "^^^^|@@__hI|L|  V!V  R|^",
        "^^^^|_____I|+|       R|^",
        "^^^^|dD______| %lll%  |^",
        "^^^^|||||==__| %%%%% y|^",
        "^^^^^^^^||||+| sHHHs ||^",
        "^^^^^^^^#$g| | %%%%% |^^",
        "^^^^^^^^#..+ |E      |^^",
        "^^^^^^^^#Z.| |T   iii|^^",
        "^^^^^^^^#W.| ||||+||||^^",
        "^^^^^^^^#|||  &&  y u|^^",
        "^^^^^^^^^|           ||^",
        "^^^^^^^^^|RRR   y    <|^",
        "^^^^^^^^^|||||+||||||||^",
        "^^^^^^^^^##m...Y.q#^^^^^",
        "^^^^^^^^^^#m.....U#^^^^^",
        "^^^^^^^^^^##zzzz.N#^^^^^",
        "^^^^^^^^^^^########^^^^^",
        "^^^^^^^^^^^^^^^^^^^^^^^^",
        "^^^^^^^^^^^^^^^^^^^^^^^^"
      ],
      "terrain": {
        "_": "t_carpet_purple",
        "@": "t_carpet_purple",
        "h": "t_carpet_purple",
        "I": "t_carpet_purple",
        "=": "t_carpet_purple",
        "D": "t_carpet_purple",
        "d": "t_carpet_purple",
        "L": "t_carpet_purple",
        "l": "t_carpet_yellow",
        "H": "t_carpet_yellow",
        "s": "t_carpet_yellow",
        "%": "t_carpet_yellow",
        "z": "t_thconc_floor",
        "m": "t_thconc_floor",
        "N": "t_thconc_floor",
        "U": "t_thconc_floor",
        "q": "t_thconc_floor",
        "g": "t_thconc_floor",
        "$": "t_thconc_floor",
        "Z": "t_thconc_floor",
        "W": "t_thconc_floor",
        "Y": "t_thconc_floor"
      },
      "furniture": { "!": "f_entertainment_center", "$": "f_sink", "&": "f_table", "=": "f_rack" },
      "items": {
        "V": { "item": "consumer_electronics", "chance": 30, "repeat": [ 1, 2 ] },
        "=": { "item": "toy_box", "chance": 30, "repeat": [ 1, 2 ] },
        "&": { "item": "livingroom", "chance": 30, "repeat": [ 1, 2 ] },
        "$": { "item": "cleaning", "chance": 30, "repeat": [ 1, 2 ] }
      },
      "place_loot": [ { "item": "television", "x": 17, "y": 5, "chance": 100 } ],
      "rotation": [ 2 ]
    }
  },
  {
    "//": "Basement - variant 2: storage",
    "type": "mapgen",
    "om_terrain": "2storyModern01_basement",
    "weight": 20,
    "method": "json",
    "object": {
      "palettes": [ "standard_domestic_palette", "standard_domestic_basement_palette" ],
      "fill_ter": "t_thconc_floor",
      "rows": [
        "^^^^^^^^^^^^^^^^^^^^^^^^",
        "^^^^^^^^^^^^^^^^^^^^^^^^",
        "^^^^^^^^^^^^^^^^^^^^^^^^",
        "^^^^^^^^^^^^^^^^^^^^^^^^",
        "^^^^###################^",
        "^^^^#U  #       $z$$$z#^",
        "^^^^#U  #       zz$zz$#^",
        "^^^^#g                #^",
        "^^^^#####     !!!!!!  #^",
        "^^^^^^^^#     !!!!!! ##^",
        "^^^^^^^^#$z   !!!!!! #^^",
        "^^^^^^^^#$z $z     NN#^^",
        "^^^^^^^^#z$ $     ####^^",
        "^^^^^^^^#zz       %ZW#^^",
        "^^^^^^^^##$          #^^",
        "^^^^^^^^^#u          ##^",
        "^^^^^^^^^#E_/}[      <#^",
        "^^^^^^^^^#AT={    #####^",
        "^^^^^^^^^##&??{   #^^^^^",
        "^^^^^^^^^^#&~~0  b#^^^^^",
        "^^^^^^^^^^##,,0   #^^^^^",
        "^^^^^^^^^^^########^^^^^",
        "^^^^^^^^^^^^^^^^^^^^^^^^",
        "^^^^^^^^^^^^^^^^^^^^^^^^"
      ],
      "furniture": {
        "!": "f_large_groundsheet",
        "$": "f_cardboard_box",
        "%": "f_sink",
        "&": "f_table",
        "_": "f_dresser",
        "=": "f_rack",
        "~": "f_desk",
        "?": "f_filing_cabinet",
        "/": "f_wardrobe",
        ",": "f_coffee_table",
        "0": "f_bed",
        "{": "f_bookcase",
        "}": "f_glass_cabinet",
        "[": "f_rack_coat"
      },
      "rotation": [ 2 ]
    }
  },
  {
    "//": "Basement - variant 3: laundry, office, pool table",
    "type": "mapgen",
    "om_terrain": "2storyModern01_basement",
    "weight": 20,
    "method": "json",
    "object": {
      "palettes": [ "standard_domestic_palette", "standard_domestic_basement_palette" ],
      "fill_ter": "t_floor",
      "rows": [
        "^^^^^^^^^^^^^^^^^^^^^^^^",
        "^^^^^^^^^^^^^^^^^^^^^^^^",
        "^^^^^^^^^^^^^^^^^^^^^^^^",
        "^^^^^^^^^^^^^^^^^^^^^^^^",
        "^^^^###################^",
        "^^^^#r  %PP#   Y$$$$$$#^",
        "^^^^#rh    +         A#^",
        "^^^^#r   RR#T    eee A#^",
        "^^^^#########    eee A#^",
        "^^^^^^^^#  b#        ##^",
        "^^^^^^^^#u  +  VVT   #^^",
        "^^^^^^^^#####+####   #^^",
        "^^^^^^^^#zz#    z#L  #^^",
        "^^^^^^^^#z + qq z##+##^^",
        "^^^^^^^^##########=  #^^",
        "^^^^^^^^^#NNN..UU#=  ##^",
        "^^^^^^^^^#N......+   <#^",
        "^^^^^^^^^#N......######^",
        "^^^^^^^^^##i.....g#^^^^^",
        "^^^^^^^^^^#i......#^^^^^",
        "^^^^^^^^^^##&...ZW#^^^^^",
        "^^^^^^^^^^^########^^^^^",
        "^^^^^^^^^^^^^^^^^^^^^^^^",
        "^^^^^^^^^^^^^^^^^^^^^^^^"
      ],
      "terrain": {
        "N": "t_thconc_floor",
        "U": "t_thconc_floor",
        "i": "t_thconc_floor",
        "&": "t_thconc_floor",
        "Z": "t_thconc_floor",
        "W": "t_thconc_floor",
        "g": "t_thconc_floor"
      },
      "furniture": { "$": "f_counter", "%": "f_shredder", "&": "f_sink", "=": "f_table" },
      "items": {
        "$": { "item": "bar_alcohol", "chance": 15 },
        "=": { "item": "table_foyer", "chance": 25 },
        "&": { "item": "cleaning", "chance": 50 }
      },
      "place_loot": [ { "item": "laptop", "x": 5, "y": 6, "chance": 50 } ],
      "rotation": [ 2 ]
    }
  },
  {
    "//": "Ground Floor - Variant 1",
    "type": "mapgen",
    "om_terrain": "2storyModern01_first",
    "weight": 20,
    "method": "json",
    "object": {
      "palettes": [ "standard_domestic_palette", "standard_domestic_lino_bathroom" ],
      "fill_ter": "t_floor_waxed",
      "rows": [
        "........................",
        "........................",
        ".....-----..............",
        ".....-----..............",
        "....||%||:::::::||oo|||.",
        "....|y  | hfffh |67n5J|.",
        "....o     =fff= |    O|.",
        "....|HƏH| =h=h=   JJ  o.",
        "....|||||yy     |    Yo.",
        ".......?||||||  |421F||.",
        "........:s x y  ||||||^.",
        "........:E      a|t_9o?.",
        "........:       a|S_Q|?.",
        "........:sHHHs   ||+|||.",
        "........||||||       <o.",
        ".~~~~~~..oƏ VV   b   ||.",
        ".~~~~~~.|||     R|+| >|.",
        ".~~~~~~.-*     RR|q|o||.",
        ".~~~~~~.-oL    |||||??..",
        ".~~~~~~.-|||+| + z|?....",
        ".~~~~~~..??|z|y|zz|.....",
        ".~~~~~~...?|||o||||.....",
        ".~~~~~~.p...............",
        ".~~~~~~................."
      ],
      "terrain": {
        "|": "t_strconc_wall",
        "G": "t_region_groundcover_urban",
        "c": "t_region_groundcover_urban",
        "K": "t_region_groundcover_urban",
        "!": "t_region_groundcover_urban",
        "_": "t_linoleum_gray",
        "=": "t_carpet_red",
        "f": "t_carpet_red",
        "h": "t_carpet_red",
        "?": "t_shrub",
        "~": "t_pavement",
        "%": "t_door_glass_c"
      },
      "furniture": { "!": "f_flower_tulip" },
      "place_loot": [ { "item": "television", "x": 11, "y": 10, "chance": 100 } ],
      "place_vehicles": [ { "vehicle": "suv", "x": 3, "y": 18, "chance": 20, "status": 50, "rotation": 270 } ],
      "place_nested": [ { "chunks": [ "NC_res_frontlawn_3X3" ], "x": 3, "y": 11 }, { "chunks": [ "NC_res_backyard_3X3" ], "x": 20, "y": 0 } ],
      "rotation": [ 2 ]
    }
  },
  {
    "//": "Ground Floor - Variant 2",
    "type": "mapgen",
    "om_terrain": "2storyModern01_first",
    "weight": 20,
    "method": "json",
    "object": {
      "palettes": [ "standard_domestic_palette", "standard_domestic_lino_bathroom", "standard_domestic_lino_kitchen" ],
      "fill_ter": "t_floor_waxed",
      "rows": [
        "........................",
        "....&&&&&&&&&...........",
        "....&!,KK,!!!--.........",
        "....&!!!!!!!!--.........",
        "....|:%:|:::::::||oo|||.",
        "....|y y| hfffhy|67n5J|.",
        "....o     =fff=y|____O|.",
        "....|iii| =h=h=  _JJA_o.",
        "....|||||      R|____Yo.",
        ".......?|||||  R|421F||.",
        "........:sHHs   ||||||^.",
        "........:[][]   a|t_9o?.",
        "........:][][   a|S_Q|?.",
        "........:sHHs   |||+|||.",
        "........|||||  R|U|  <o.",
        ".........|z|Ə  R|+|  ||.",
        "........||+|c        >|.",
        "..-------*       yy|o||.",
        ".--------oL|||+|||||??..",
        ".--------|||T    R|?....",
        ".------..??|E    R|.....",
        ".------...?|||oo|||.....",
        ".------.p...............",
        ".------................."
      ],
      "terrain": {
        "|": "t_strconc_wall",
        "!": "t_floor_noroof",
        "&": "t_glass_railing",
        "_": "t_linoleum_gray",
        "A": "t_linoleum_gray",
        "Y": "t_linoleum_gray",
        "[": "t_carpet_red",
        "]": "t_carpet_yellow",
        "=": "t_carpet_green",
        "f": "t_carpet_green",
        "h": "t_carpet_green",
        "?": "t_shrub",
        "%": "t_door_glass_c",
        ",": "t_floor_noroof",
        "K": "t_floor_noroof"
      },
      "furniture": { ",": "f_chair" },
      "place_vehicles": [ { "vehicle": "bicycle", "x": 21, "y": 3, "chance": 30, "status": 100, "rotation": 180 } ],
      "place_nested": [ { "chunks": [ "NC_res_frontlawn_3X3" ], "x": 2, "y": 13 } ],
      "rotation": [ 2 ]
    }
  },
  {
    "//": "Ground Floor - Variant 3",
    "type": "mapgen",
    "om_terrain": "2storyModern01_first",
    "weight": 20,
    "method": "json",
    "object": {
      "palettes": [ "standard_domestic_palette", "standard_domestic_lino_bathroom" ],
      "fill_ter": "t_floor_waxed",
      "rows": [
        "........................",
        ".....................{..",
        "........................",
        ".....---[[[[[[[..[[[[[[.",
        "....|:%:||:::::||:::::|.",
        "....|Ə  y      y|JJn5J|.",
        "....o    =h=h=  |2   O|.",
        "....|TEsy=fff=       7|.",
        "....|||||hfffh       6|.",
        ".......?|=h=h= y|4Y1F||.",
        ".......[||||||  ||||||^.",
        ".{.....[:HHHsy  a|q Uo?.",
        ".......[:H      a|q U|?.",
        ".......[:H ll   |||+|||.",
        ".......[||           <o.",
        ".......[[o(A  R||+|| ||.",
        ".......[||y   R|t_9| >|.",
        "....?----*    R|S_Q|o||.",
        "....?----:LƏ  ||||||??-.",
        "....?----|||  + ,r|?---.",
        "....?----??|RR|  r|----.",
        "....?-----?||||oo||----.",
        "....?------------------.",
        "....p------------------."
      ],
      "terrain": {
        "|": "t_strconc_wall",
        "}": "t_shrub_lilac",
        "{": "t_tree_birch",
        "_": "t_linoleum_gray",
        "[": "t_dirtmound",
        "=": "t_carpet_yellow",
        "f": "t_carpet_yellow",
        "h": "t_carpet_yellow",
        "?": "t_shrub",
        "%": "t_door_glass_c"
      },
      "furniture": {
        ",": "f_chair",
        "(": "f_piano",
        "[": [
          "f_black_eyed_susan",
          "f_mutpoppy",
          "f_lily",
          "f_flower_tulip",
          "f_datura",
          "f_flower_spurge",
          "f_dahlia",
          "f_chamomile",
          "f_sunflower",
          "f_chicory",
          "f_dandelion"
        ]
      },
      "place_nested": [ { "chunks": [ "NC_res_frontlawn_3X3" ], "x": 2, "y": 13 }, { "chunks": [ "NC_res_backyard_3X3" ], "x": 1, "y": 1 } ],
      "rotation": [ 2 ]
    }
  },
  {
    "//": "Second Floor - Variant 1 ",
    "type": "mapgen",
    "om_terrain": "2storyModern01_second",
    "weight": 100,
    "method": "json",
    "object": {
      "palettes": [ "standard_domestic_palette", "standard_domestic_lino_bathroom" ],
      "fill_ter": "t_floor_waxed",
      "rows": [
        "........................",
        "........................",
        "........................",
        "........................",
        "....|||||:::::::||oo|||.",
        "....or  +       |¤@@ d|.",
        "....orh ||+||V  | @@ do.",
        "....|ryP|z P|V  +     o.",
        "....||||||||||y |ɸ b D|.",
        "........|BBYQ|  |||||||.",
        "........o~~~~+  || hro..",
        "........|tS88|  ||R r|^.",
        "........||||||y V||+||..",
        "........|U +     y  y||.",
        "........||$|RRR      >o.",
        ".........||||||+|||   |.",
        ".........|&&|dd  ¤|ƏƏƏ|.",
        ".........=__%   @@||oo|.",
        ".........=__%   @@||....",
        ".........||||b   ¤|.....",
        "...........|vyII D|.....",
        "...........|||oo|||.....",
        "........................",
        "........................"
      ],
      "terrain": {
        "|": "t_strconc_wall",
        "%": "t_door_glass_c",
        "~": "t_linoleum_gray",
        "Y": "t_linoleum_gray",
        "=": "t_glass_railing",
        "_": "t_concrete",
        "&": "t_concrete",
        ".": "t_open_air"
      },
      "furniture": { "$": "f_utility_shelf", "&": "f_table" },
      "rotation": [ 2 ]
    }
  },
  {
    "//": "Second Floor - Variant 2 ",
    "type": "mapgen",
    "om_terrain": "2storyModern01_second",
    "weight": 100,
    "method": "json",
    "object": {
      "palettes": [ "standard_domestic_palette" ],
      "fill_ter": "t_floor_waxed",
      "rows": [
        "........................",
        "........................",
        "........................",
        "........................",
        "....||o|||:::::|||oo|||.",
        "....|8~BB|y   y|z|ysHH|.",
        "....oS~~~+     |+|    o.",
        "....|t~ww|iiii   +    o.",
        "....||o|||||||  V|y xx|.",
        "........|¤  D|b V||||||.",
        "........o@@ D|  V|r R|..",
        "........o@@ y|  ||rh |^.",
        "........|¤   +  ||r  o..",
        "........|b  d|R |||+|||.",
        "........||  d|R      >o.",
        ".........|%:||R RR||+||.",
        ".........|__|||+|||U L|.",
        ".........=_$|,T  d|||||.",
        ".........=_$|&,  d||....",
        ".........||||,,  ¤o.....",
        "...........|ɸ   @@|.....",
        "...........||||o|||.....",
        "........................",
        "........................"
      ],
      "terrain": {
        "|": "t_strconc_wall",
        "%": "t_door_glass_c",
        "~": "t_linoleum_gray",
        "B": "t_linoleum_gray",
        "Y": "t_linoleum_gray",
        "Q": "t_linoleum_gray",
        "t": "t_linoleum_gray",
        "S": "t_linoleum_gray",
        "w": "t_linoleum_gray",
        "8": "t_linoleum_gray",
        ",": "t_carpet_purple",
        "&": "t_carpet_purple",
        "T": "t_carpet_purple",
        "=": "t_glass_railing",
        "_": "t_concrete",
        "$": "t_concrete",
        ".": "t_open_air"
      },
      "furniture": { "$": [ "f_indoor_plant", "f_indoor_plant_y" ], "&": "f_exercise" },
      "place_loot": [ { "item": "television", "x": 21, "y": 8, "chance": 100 }, { "item": "laptop", "x": 18, "y": 11, "chance": 50 } ],
      "rotation": [ 2 ]
    }
  },
  {
    "//": "Second Floor - Variant 3: Holdout",
    "type": "mapgen",
    "om_terrain": "2storyModern01_second",
    "weight": 10,
    "method": "json",
    "object": {
      "palettes": [ "standard_domestic_palette" ],
      "fill_ter": "t_floor_waxed",
      "rows": [
        "........................",
        "........................",
        "........................",
        "........................",
        "....|||||:::::::||oo|||.",
        "....or  +       |!    |.",
        "....orh ||+||   |     o.",
        "....|ryP|  P|   ,     o.",
        "....||||||||||  |  b  |.",
        "........|BB~~|  |||||||.",
        "........o~~~~+  ||  ro..",
        "........|tS88|  ||  r|^.",
        "........||||||   ||+||..",
        "........|U ,       RV||.",
        "........||$|R      RV>o.",
        ".........||||||/||| dD|.",
        ".........|&_| Ddd |   |.",
        ".........=0_%  @@ ||oo|.",
        ".........=__,  @@ ||....",
        ".........||||b    |.....",
        "...........|vyII !|.....",
        "...........|||oo|||.....",
        "........................",
        "........................"
      ],
      "terrain": {
        "|": "t_strconc_wall",
        "+": [ "t_door_frame", "t_door_o" ],
        "%": "t_door_glass_c",
        "o": "t_window_boarded_noglass",
        "~": "t_linoleum_gray",
        "B": "t_linoleum_gray",
        "Y": "t_linoleum_gray",
        "Q": "t_linoleum_gray",
        "t": "t_linoleum_gray",
        "S": "t_linoleum_gray",
        "8": "t_linoleum_gray",
        "=": "t_glass_railing",
        "_": "t_concrete",
        "0": "t_concrete",
        "&": "t_concrete",
        ".": "t_open_air",
        "/": [ "t_door_boarded", "t_door_boarded_damaged" ],
        ",": "t_door_frame"
      },
      "furniture": { "!": "f_table", "$": "f_utility_shelf", "&": "f_table", "b": "f_bigmirror_b", "0": "f_brazier" },
      "items": { "!": { "item": "nightstand", "chance": 30, "repeat": [ 1, 2 ] }, " ": { "item": "trash", "chance": 5 } },
      "place_loot": [
        { "item": "2x4", "x": 11, "y": 16, "chance": 80, "repeat": [ 4, 8 ] },
        { "item": "2x4", "x": 10, "y": 17, "chance": 100 },
        { "group": "stash_food", "x": [ 14, 17 ], "y": [ 17, 19 ], "chance": 100, "repeat": [ 3, 6 ] },
        { "group": "weapons", "x": [ 13, 14 ], "y": [ 17, 18 ], "chance": 100 },
        { "group": "homebooks", "x": [ 14, 15 ], "y": 20, "chance": 100, "repeat": [ 3, 5 ] },
        { "item": "bucket", "x": 13, "y": 20, "chance": 100 },
        { "item": "hammer", "x": 17, "y": 17, "chance": 100 },
        { "item": "nail", "x": 17, "y": 16, "chance": 100, "repeat": [ 1, 3 ] },
        { "item": "glass_shard", "x": 11, "y": 18, "chance": 30, "repeat": [ 1, 2 ] },
        { "item": "corpse_generic_female", "x": 13, "y": 18, "chance": 100 },
        { "group": "pants_female", "x": 13, "y": 18, "chance": 100 },
        { "group": "shirts", "x": 13, "y": 18, "chance": 100 },
        { "group": "clothing_outdoor_shoes", "x": 13, "y": 18, "chance": 100 }
      ],
      "rotation": [ 2 ]
    }
  },
  {
    "type": "mapgen",
    "om_terrain": "2storyModern01_roof",
    "method": "json",
    "object": {
      "palettes": [ "roof_palette" ],
      "fill_ter": "t_open_air",
      "rows": [
        "                        ",
        "                        ",
        "                        ",
        "                        ",
        "    ------------------- ",
        "    -.................- ",
        "    -...N.............- ",
        "    -.................- ",
        "    -----.............- ",
        "        -............-- ",
        "        -............5  ",
        "        -.......~....-  ",
        "        -.......~....-  ",
        "        -............-- ",
        "        --............- ",
        "         ----.........- ",
        "            -.........- ",
        "            -......---- ",
        "            -.....--    ",
        "           --.....-     ",
        "           -......-     ",
        "           --------     ",
        "                        ",
        "                        "
      ],
      "terrain": { ".": "t_shingle_flat_roof", "~": "t_shingle_flat_roof", "N": "t_shingle_flat_roof" },
      "place_nested": [
        { "chunks": [ "NC_res_roof_solar_4X4" ], "x": 13, "y": 6 },
        { "chunks": [ "NC_res_roof_chunk_3X3" ], "x": 15, "y": 15 }
      ],
      "rotation": [ 2 ]
    }
  }
]
