[
  {
    "type": "mapgen",
    "om_terrain": "2storyModern02_basement",
    "weight": 250,
    "method": "json",
    "object": {
      "palettes": [ "standard_domestic_palette", "standard_domestic_basement_palette" ],
      "fill_ter": "t_thconc_floor",
      "rows": [
        "^^^^^^^^^^^^^^^^^^^^^^^^",
        "^^^^^^^^^^^^^^^^^^^^^^^^",
        "^^^^^^^^^^^|||||||||||^^",
        "^^^^^^^^^^^|__$$$$$_A|^^",
        "^^^^^^^^^^^|&_______A|^^",
        "^^^^^^^^^^^|&__eee__A|^^",
        "^^^^^^^^^^^|&__eee__A|^^",
        "^^^^^^^^^^^|________A|^^",
        "^^^^^^^^^^^|T________|^^",
        "^^^^^^^^^^^|||+||____|^^",
        "^^^^^^^^^^^|___T|___R|^^",
        "^^^^^^^^^^^|_h__|b__R|^^",
        "^^^^^^^^^^^|rrrv||_RR|^^",
        "^^|||||||||||||||<_|||^^",
        "^^|UUU  ? = ZW|%||_|w|^^",
        "^^|           |____+_|^^",
        "^^|N          +__%%|w|^^",
        "^^|N          ||||||||^^",
        "^^|   ~~ zz   |^^^^^^^^^",
        "^^|qqq~~gzzmmm|^^^^^^^^^",
        "^^|||||||||||||^^^^^^^^^",
        "^^^^^^^^^^^^^^^^^^^^^^^^",
        "^^^^^^^^^^^^^^^^^^^^^^^^",
        "^^^^^^^^^^^^^^^^^^^^^^^^"
      ],
      "terrain": {
        "_": "t_floor",
        "w": "t_floor",
        "v": "t_floor",
        "h": "t_floor",
        "A": "t_floor",
        "e": "t_floor",
        "$": "t_floor",
        "r": "t_floor",
        "%": "t_floor",
        "R": "t_floor",
        "V": "t_floor",
        "b": "t_floor",
        "T": "t_floor",
        "&": "t_floor"
      },
      "furniture": {
        "!": "f_crate_c",
        "$": "f_counter",
        "%": "f_table",
        "&": "f_glass_cabinet",
        "=": "f_sink",
        "~": "f_chair",
        "?": "f_home_furnace"
      },
      "items": {
        "$": { "item": "beer", "chance": 15 },
        "&": { "item": "liquor_and_spirits", "chance": 50 },
        "%": { "item": "table_foyer", "chance": 40 }
      }
    }
  },
  {
    "type": "mapgen",
    "om_terrain": "2storyModern02_1",
    "weight": 250,
    "method": "json",
    "object": {
      "palettes": [ "standard_domestic_palette", "standard_domestic_lino_bathroom" ],
      "fill_ter": "t_floor_waxed",
      "rows": [
        ".0000000.p..............",
        ".0000000..||oo||oo||..%.",
        ".0000000.||Vysxxsyy||,..",
        ".0000000.:         H:,..",
        ".0000000.:y  T  ll H:,..",
        ".0000000.:y  E     H:,..",
        ".0000000.:y     HHHH:,..",
        ".0000000.||RRRR RRRR|,..",
        ".0000000..||||| |||||^..",
        "..--------,,,,| rrry||..",
        ".%-----------,o  h  V||.",
        "..|::::|-----,o     VV|.",
        ".|| h  ||----,| |||   o.",
        ".|y ff y|::*::| |>||+||.",
        ".| hffh      Ly + |S_8o.",
        ".|  ff          |||__8|.",
        ".o  h           <||t9||.",
        ".o       A A  |o||||||[.",
        ".|y    6 JJJ  o```````[.",
        ".|| aa 6      ~``G````-.",
        "..||||||F25O1||``KK``$[.",
        "..,,,,,||ooo||[`GKKG`$[.",
        "....%..,,,,,,,[[[[[[[[[.",
        "........................"
      ],
      "terrain": {
        ",": [ "t_shrub", "t_shrub", "t_shrub_strawberry", "t_shrub_blueberry" ],
        "%": [
          "t_tree",
          "t_tree_pine",
          "t_tree_pear",
          "t_tree_plum",
          "t_tree_cherry",
          "t_tree_maple",
          "t_tree_birch",
          "t_tree_apple",
          "t_tree_willow",
          "t_tree_hickory",
          "t_tree_young"
        ],
        "_": "t_linoleum_gray",
        "[": "t_railing_v",
        "0": "t_pavement",
        "`": "t_floor_noroof",
        "~": "t_door_glass_c",
        "|": "t_strconc_wall",
        "G": "t_floor_noroof",
        "K": "t_floor_noroof",
        "$": "t_floor_noroof"
      },
      "furniture": { "!": "f_table", "$": "f_table" },
      "place_loot": [ { "item": "television", "x": 15, "y": 2 } ]
    }
  },
  {
    "type": "mapgen",
    "om_terrain": "2storyModern02_2",
    "weight": 250,
    "method": "json",
    "object": {
      "palettes": [ "standard_domestic_palette", "standard_domestic_lino_bathroom" ],
      "fill_ter": "t_floor_waxed",
      "rows": [
        "........................",
        "..........||||oo||||....",
        ".........||$z|B88St||...",
        ".........|$ z|B____Q|...",
        ".........||+|||+|||||...",
        ".........o      | !@|...",
        ".........oy     |  @o...",
        ".........||sET  +   o^..",
        "..........||o|| ||++|...",
        "..............| V|Dd||..",
        "..............| V||||||.",
        "..||oo||......o V|   !|.",
        ".||y  d||.....| y|  @@o.",
        ".|    d||oo|oo|  |  @@o.",
        ".|!   d|y        +   !|.",
        ".o@@   +         ||+|||.",
        ".o@@   |RRR RRR|>|D d||.",
        ".|!    ||||+||||o||o||..",
        ".||+||+|     R|.........",
        ".||d||D|  h  R|.........",
        "..||||||Yrrr ||.........",
        ".......||o|o||..........",
        "........................",
        "........................"
      ],
      "terrain": { ".": "t_open_air", "|": "t_strconc_wall", "_": "t_linoleum_gray" },
      "furniture": { "!": "f_table", "$": "f_clothing_rail" },
      "items": { "!": { "item": "nightstand", "chance": 30 }, "$": { "item": "clothing_outdoor_shoes", "chance": 30 } }
    }
  },
  {
    "type": "mapgen",
    "om_terrain": "2storyModern02_roof",
    "weight": 250,
    "method": "json",
    "object": {
      "palettes": [ "roof_palette" ],
      "fill_ter": "t_open_air",
      "rows": [
        "                        ",
        "          ----------    ",
        "         33........||   ",
        "         3..........|   ",
        "         3..........|   ",
        "         3..........|   ",
        "         3..X....N..|   ",
        "         33.........|   ",
        "          22223.....5   ",
        "              3.....||  ",
        "              3......|| ",
        "  ------      3.......| ",
        " 33....--     3.......| ",
        " 3......-------.......| ",
        " 3.................=..| ",
        " 3....................| ",
        " 3...................|| ",
        " 3............22222222. ",
        " 3............|         ",
        " 33.~~........|         ",
        "  222222.....22         ",
        "       2222222          ",
        "                        ",
        "                        "
      ],
      "terrain": {
        ".": "t_shingle_flat_roof",
        "=": "t_shingle_flat_roof",
        "~": "t_shingle_flat_roof",
        "N": "t_shingle_flat_roof",
        "X": "t_shingle_flat_roof"
      }
    }
  }
]
