[
  {
    "type": "mapgen",
    "om_terrain": "2StoryModern05_basement",
    "method": "json",
    "object": {
      "palettes": [ "standard_domestic_palette", "standard_domestic_basement_palette" ],
      "fill_ter": "t_floor_waxed",
      "rows": [
        "^^^^^^^^^^^^^^^^^^^^^^^^",
        "^^^^^^^^^^^^^^^^^^^^^^^^",
        "^^^^^^#####||||||||^^^^^",
        "^^^^^^#qqq~|z     |^^^^^",
        "^^^^^^#~~~~|z     |^^^^^",
        "^^^^^^#]~~~|z   zz|^^^^^",
        "^^^^^^#~~~~|    zz|^^^^^",
        "^^^^^^|||+||||+||||^^^^^",
        "^^^^^^|RR         |^^^^^",
        "^^^^^^|       eee |^^^^^",
        "^^^^^^|T   s  eee |^^^^^",
        "^^^^^^|x l H      |^^^^^",
        "^^^^^^|x l H   A A|^^^^^",
        "^^^^^^|x l H   ||||^^^^^",
        "^^^^^^|        +_S|^^^^^",
        "^^^^^^|Ø       |_t|^^^^^",
        "^^^^^^|    r||+||||^^^^^",
        "^^^^^^|R  hr|b T D|^^^^^",
        "^^^^^^|R   r|r   ɸ|^^^^^",
        "^^^^^^|     |rh   |^^^^^",
        "^^^^^^| ||++|    @|^^^^^",
        "^^^^^^|<|vUU|dd ¤@|^^^^^",
        "^^^^^^|||||||||||||^^^^^",
        "^^^^^^^^^^^^^^^^^^^^^^^^"
      ],
      "terrain": {
        "t": "t_linoleum_gray",
        "S": "t_linoleum_gray",
        "#": "t_concrete_wall",
        "_": "t_linoleum_gray",
        "]": "t_concrete",
        "q": "t_concrete",
        "~": "t_concrete"
      },
      "furniture": {
        "]": "f_home_furnace",
        "$": "f_clothing_rail",
        "=": [ "f_indoor_plant", "f_indoor_plant_y" ],
        "?": [ "f_indoor_plant", "f_indoor_plant_y" ]
      },
      "place_loot": [ { "item": "television", "x": 7, "y": 12 }, { "item": "laptop", "x": 11, "y": 17 } ]
    }
  },
  {
    "type": "mapgen",
    "om_terrain": "2StoryModern05_1",
    "weight": 250,
    "method": "json",
    "object": {
      "palettes": [ "standard_domestic_palette", "standard_domestic_lino_bathroom", "standard_domestic_landscaping_palette" ],
      "fill_ter": "t_floor_waxed",
      "rows": [
        ".----...................",
        "..----.....%%.....[.....",
        "...----p#::##:::##.....[",
        "....----:`=#6   O#......",
        ".....---/`L#6 J 5:......",
        "......###``#2 J J:......",
        "......:Ə   #1 J F#%.....",
        "......:Ə        3####%..",
        "......####    ####q~#...",
        "......%#V     RRR#q~/...",
        "......%#V   h   R#UU#%..",
        "......%#V hff   R####...",
        ".##:::###  ffh   :---.G.",
        ".#s,E,#a# hff    /---.K.",
        ".:H,,,,,,  ffh  y:---G..",
        ".:H,l,,x,  h   V######..",
        ".:H,l,,x,      V#Qw_Z#..",
        ".:H,,,,,,       +___W#^.",
        ".#THHH?,,       ######..",
        ".##:::#<#  R#R  #8888#..",
        "......###  R#R  +___S#..",
        "......#>+  y#yƏy#BB_t#..",
        ".[....#####:##:#######..",
        "........^..............."
      ],
      "terrain": {
        "#": "t_concrete_wall",
        "_": "t_linoleum_gray",
        "q": "t_thconc_floor",
        "U": "t_thconc_floor",
        "`": "t_carpet_red",
        "/": "t_door_metal_pickable",
        "~": "t_thconc_floor",
        "Q": "t_linoleum_gray",
        "W": "t_linoleum_gray",
        "Z": "t_linoleum_gray",
        "G": "t_region_groundcover_urban",
        "K": "t_region_groundcover_urban",
        "=": "t_carpet_red",
        "L": "t_carpet_red",
        ",": "t_carpet_purple",
        "?": "t_carpet_purple",
        "E": "t_carpet_purple",
        "H": "t_carpet_purple",
        "s": "t_carpet_purple",
        "T": "t_carpet_purple",
        "l": "t_carpet_purple",
        "x": "t_carpet_purple"
      },
      "furniture": { "=": [ "f_indoor_plant", "f_indoor_plant_y" ], "?": [ "f_indoor_plant", "f_indoor_plant_y" ] },
      "place_loot": [ { "item": "television", "x": 7, "y": 16 } ],
      "place_nested": [ { "chunks": [ "NC_res_frontlawn_3X3" ], "x": 1, "y": 4 } ]
    }
  },
  {
    "type": "mapgen",
    "om_terrain": "2StoryModern05_2",
    "weight": 250,
    "method": "json",
    "object": {
      "palettes": [ "standard_domestic_palette", "standard_domestic_lino_bathroom" ],
      "fill_ter": "t_floor_waxed",
      "rows": [
        "........................",
        "........................",
        "......ШШШШШШШШШШШШШ.....",
        "......Ш✲ὨὨὨ▒▒▒▒▒▒▒Ш.....",
        "......Ш✲▒▒▒▒▒▒▒▒▒?Ш.....",
        "......Ш✲▒▒▒▒▒▒▒▒▒KШ.....",
        "......Ш✲▒?▒?▒▒▒▒▒?Ш.....",
        ".....#####:::¶::#####...",
        ".....#z+           y:...",
        ".....###           Ə:...",
        ".....#U+ {{{{{{{##+##...",
        ".....#q+ {¯¯¯¯¯¯#R ###..",
        ".##::### {¯¯¯¯¯¯#R  r:..",
        ".#y   D# {¯¯¯¯¯¯#R hr:..",
        ".:¤   d# {¯¯¯¯¯¯#P  r:..",
        ".:@@  d# {############..",
        ".:@@  ## Ə#8S#wQ#¤@@¤#^.",
        ".:¤    +  #8_#++# @@ #..",
        ".#yddy### #_____#d   :..",
        ".##:::#>  #t_8BB#D   :..",
        "......#   ##+####y  h#..",
        "......#VV       +  rr#..",
        "......#####:##:###::##..",
        ".........^.............."
      ],
      "terrain": {
        "¯": "t_open_air_rooved",
        ".": "t_open_air",
        "#": "t_concrete_wall",
        "_": "t_linoleum_gray",
        "Q": "t_linoleum_gray",
        "w": "t_linoleum_gray",
        "✲": "t_floor_noroof",
        "Ὠ": "t_floor_noroof",
        "?": "t_floor_noroof",
        "K": "t_floor_noroof",
        "▒": "t_floor_noroof",
        "{": "t_railing_v",
        "Ш": "t_glass_railing"
      },
      "furniture": { "?": "f_deckchair" },
      "place_loot": [ { "item": "laptop", "x": 20, "y": 13 } ],
      "sealed_item": {
        "✲": { "item": { "item": "seed_tomato" }, "furniture": "f_planter_seedling", "chance": 100 },
        "Ὠ": { "item": { "item": "seed_cucumber" }, "furniture": "f_planter_seedling", "chance": 100 }
      }
    }
  },
  {
    "type": "mapgen",
    "om_terrain": "2StoryModern05_roof",
    "weight": 250,
    "method": "json",
    "object": {
      "palettes": [ "roof_palette" ],
      "fill_ter": "t_shingle_flat_roof",
      "rows": [
        "                        ",
        "                        ",
        "                        ",
        "                        ",
        "                        ",
        "                        ",
        "                        ",
        "     ----------------   ",
        "     -........=.....-   ",
        "     -..............-   ",
        "     -..............-   ",
        "     -..............--  ",
        " -----...............-  ",
        " -.....~.....A.......-  ",
        " -...................-  ",
        " -...................-  ",
        " -...................5  ",
        " -.........X.........-  ",
        " -.............&.....-  ",
        " ------..............-  ",
        "      -..............-  ",
        "      -..............-  ",
        "      ---5------------  ",
        "                        "
      ],
      "terrain": { ".": "t_shingle_flat_roof" },
      "place_nested": [
        { "chunks": [ "NC_res_roof_solar_4X4" ], "x": 15, "y": 10 },
        { "chunks": [ "NC_res_roof_chunk_3X3" ], "x": [ 3, 6 ], "y": [ 14, 16 ] }
      ]
    }
  }
]
