[
  {
    "type": "mapgen",
    "om_terrain": "bungalow07",
    "method": "json",
    "object": {
      "palettes": [ "standard_domestic_palette", "standard_domestic_lino_bathroom", "standard_domestic_landscaping_palette" ],
      "fill_ter": "t_floor",
      "rows": [
        ".................---.p..",
        ".................---....",
        ".......%###oo###%---....",
        ".......%#D¤@@¤ #%---....",
        "..##oo###  @@  ##o*###%.",
        "..#¤@@¤D|     d|b  LL#%.",
        "..o @@  |+|    |     #%.",
        "..o    ɸ|v|  II|V  xy#%.",
        "..#++|  |||+||||V lllo%.",
        "..#dd|b +    RRy     o%.",
        "..#||||||         HHH#^.",
        "..oB____+   ==$=  sss#..",
        "..#B8tS8|R  =ff=     #..",
        "..#||||||R  $ff$    1#..",
        "..orh   +   =$==  J Fo..",
        "..#r  PR|        AJ 2o..",
        "..#||+||###¶¶###  5 O#..",
        "..#Z   U#j----j#6 J 3#..",
        "..#WzNNU#j----j#6  yY#..",
        "..##oo###j....j####oo#..",
        "........................",
        ".......[................",
        "..[...................[.",
        "........................"
      ],
      "terrain": {
        "_": "t_linoleum_gray",
        "G": "t_region_groundcover_urban",
        "K": "t_region_groundcover_urban",
        "=": "t_carpet_green",
        "f": "t_carpet_green",
        "$": "t_carpet_green"
      },
      "furniture": { "$": "f_chair" },
      "place_loot": [ { "item": "television", "x": 19, "y": 7 } ],
      "place_nested": [ { "chunks": [ "NC_res_frontlawn_3X3" ], "x": 1, "y": 1 }, { "chunks": [ "NC_res_backyard_3X3" ], "x": 15, "y": 20 } ]
    }
  },
  {
    "type": "mapgen",
    "om_terrain": "bungalow07_roof",
    "method": "json",
    "object": {
      "palettes": [ "roof_palette" ],
      "fill_ter": "t_shingle_flat_roof",
      "rows": [
        ",,,,,,,,,,,,,,,,,,,,,,,,",
        ",,,,,,,,,,,,,,,,,,,,,,,,",
        ",,,,,,,,--------,,,,,,,,",
        ",,,,,,,,-......-,,,,,,,,",
        ",,-------......-------,,",
        ",,-..................-,,",
        ",,-..................-,,",
        ",,-..................-,,",
        ",,-...N..............-,,",
        ",,-..................-,,",
        ",,-..................5,,",
        ",,-..................-,,",
        ",,-..................-,,",
        ",,-..................-,,",
        ",,-..............X...-,,",
        ",,-..................-,,",
        ",,-..................-,,",
        ",,-..................-,,",
        ",,-..................-,,",
        ",,--------------------,,",
        ",,,,,,,,,,,,,,,,,,,,,,,,",
        ",,,,,,,,,,,,,,,,,,,,,,,,",
        ",,,,,,,,,,,,,,,,,,,,,,,,",
        ",,,,,,,,,,,,,,,,,,,,,,,,"
      ],
      "terrain": { ".": "t_shingle_flat_roof", ",": "t_open_air" },
      "place_nested": [
        { "chunks": [ "NC_res_roof_solar_4X4" ], "x": 5, "y": 13 },
        { "chunks": [ "NC_res_roof_chunk_3X3" ], "x": [ 9, 16 ], "y": [ 5, 8 ] }
      ]
    }
  }
]
