[
  {
    "type": "mapgen",
    "om_terrain": "bungalow08",
    "method": "json",
    "object": {
      "palettes": [ "standard_domestic_palette", "standard_domestic_lino_bathroom", "standard_domestic_landscaping_palette" ],
      "fill_ter": "t_floor",
      "rows": [
        ".......!--!.............",
        "......p!--!.............",
        ".[.....!--!.%%%%%%%%%...",
        ".......!--!.####oo###...",
        ".......!--!.#y $  RR#...",
        ".......!----or     s#...",
        ".%%%%%%%----orh  l Ho.[.",
        ".##oo####*o##r   l Ho...",
        ".#¤@@¤|Ə```=|T   l H#...",
        ".# @@ |b```L|      s#...",
        ".o    | ```    |||||#...",
        ".o    +        |w8St#...",
        ".# |++|++|     +____o...",
        ".#ɸ|dD|WZ|  yRR|QBB8#...",
        ".#||||||||  R|||||||#...",
        "^#v+  +     R|y VV y#...",
        ".#D+  ||       ,&,, #--.",
        ".#||  y|6 J    ,ff, ¶--.",
        ".o    d|6 J F| &ff& o--.",
        ".o@@  d|7   2| ,ff, o...",
        ".#@@¤ T|4n5O1|y,,&,y#...",
        ".###oo####oo####ooo##...",
        "........................",
        ".................[......"
      ],
      "terrain": {
        "#": "t_wall_p",
        "`": "t_carpet_red",
        "_": "t_linoleum_gray",
        "|": "t_wall",
        "?": "t_column",
        ";": "t_water_sh",
        "W": "t_linoleum_gray",
        "Z": "t_linoleum_gray",
        ",": "t_carpet_yellow",
        "f": "t_carpet_yellow",
        "&": "t_carpet_yellow",
        "-": "t_concrete"
      },
      "furniture": { "$": "f_piano", "&": "f_chair", "=": "f_rack" },
      "items": { "=": { "item": "clothing_outdoor_shoes", "chance": 50 } },
      "place_loot": [ { "item": "laptop", "x": 14, "y": 6 } ],
      "place_nested": [ { "chunks": [ "NC_res_frontlawn_3X3" ], "x": 3, "y": 2 } ]
    }
  },
  {
    "type": "mapgen",
    "om_terrain": "bungalow08_roof",
    "method": "json",
    "object": {
      "palettes": [ "roof_palette" ],
      "fill_ter": "t_shingle_flat_roof",
      "rows": [
        ",,,,,,,,,,,,,,,,,,,,,,,,",
        ",,,,,,,,,,,,,,,,,,,,,,,,",
        ",,,,,,,,,,,,,,,,,,,,,,,,",
        ",,,,,,,,,,,,---------,,,",
        ",,,,,,,,,,,,-.......-,,,",
        ",,,,,,,,,,,,-.......-,,,",
        ",,,,,,,,,,,,-.......-,,,",
        ",------------.......-,,,",
        ",-..................-,,,",
        ",-..................-,,,",
        ",-..................-,,,",
        ",-..................-,,,",
        ",-..................-,,,",
        ",-..................-,,,",
        ",-..................-,,,",
        ",5..................-,,,",
        ",-.............oooo.-,,,",
        ",-.............oooo.-,,,",
        ",-.............oooo.-,,,",
        ",-.............oooo.-,,,",
        ",-..................-,,,",
        ",--------------------,,,",
        ",,,,,,,,,,,,,,,,,,,,,,,,",
        ",,,,,,,,,,,,,,,,,,,,,,,,"
      ],
      "terrain": { ".": "t_shingle_flat_roof", ",": "t_open_air" },
      "place_nested": [
        { "chunks": [ "NC_res_roof_solar_4X4" ], "x": 5, "y": 12 },
        { "chunks": [ "NC_res_roof_chunk_3X3" ], "x": [ 13, 16 ], "y": [ 4, 10 ] }
      ]
    }
  }
]
