[
  {
    "type": "mapgen",
    "om_terrain": "bungalow01_1",
    "method": "json",
    "object": {
      "palettes": [
        "standard_domestic_palette",
        "standard_domestic_lino_kitchen",
        "standard_domestic_lino_bathroom",
        "standard_domestic_landscaping_palette"
      ],
      "fill_ter": "t_floor",
      "rows": [
        ".------.p...............",
        "..------.....[..........",
        "...------...............",
        ".[..--------{{{{{{{{{{..",
        ".....-------,,qqq,,,,{..",
        ".%%%%%------,,,,,,,,G{..",
        ".##oo###oo##,,,,,,,,K{..",
        ".#d  ¤@@¤ d#,,,,,,,,G{..",
        ".#d   @@  d#o*###oo###..",
        ".#y        |L RH     #%.",
        ".#|+|||+|| |Ə RH l  x#%.",
        ".#w D|v D| |  RH l  x#%.",
        ".#||||||||+|  RH     #%.",
        ".ot______+ |   s E  y#%.",
        ".#BB8S|ZW|          To%.",
        ".#||||||||  AA       o%.",
        ".#zɸ|D |Q+ |12Y_|T   #%.",
        ".#|+||+|||+|n___|   h#%.",
        ".#¤    dd  |F_J_|  ff#^.",
        ".#@@       |5_J_| hff#%.",
        ".#@@     h |O___|   h#%.",
        ".#¤  yPPrrr|7436|y   #%.",
        ".####o###o####o##oo*##%.",
        "..................---..."
      ],
      "terrain": {
        "#": "t_wall_p",
        "_": "t_linoleum_gray",
        "{": "t_railing_v",
        ",": "t_floor_noroof",
        "Y": "t_linoleum_gray",
        "W": "t_linoleum_gray",
        "Z": "t_linoleum_gray",
        "Q": "t_null",
        "K": "t_floor_noroof",
        "G": "t_floor_noroof",
        "w": "t_null",
        "q": "t_floor_noroof"
      },
      "place_loot": [ { "item": "television", "x": 20, "y": 10 } ],
      "place_nested": [ { "chunks": [ "NC_res_frontlawn_3X3" ], "x": 17, "y": 0 } ]
    }
  },
  {
    "type": "mapgen",
    "om_terrain": "bungalow01_roof",
    "method": "json",
    "object": {
      "palettes": [ "roof_palette" ],
      "fill_ter": "t_shingle_flat_roof",
      "rows": [
        "````````````````````````",
        "````````````````````````",
        "````````````````````````",
        "````````````````````````",
        "````````````````````````",
        "````````````````````````",
        "`-----------````````````",
        "`-.........-````````````",
        "`-.........-----------``",
        "`-...................-``",
        "`-...................-``",
        "`-...................-``",
        "`-...................-``",
        "`-...................-``",
        "`-................X..-``",
        "`-...................-``",
        "`-...................-``",
        "`-.....N.............-``",
        "`-...................5``",
        "`-...................-``",
        "`-...................-``",
        "`-...................-``",
        "`---------------------``",
        "````````````````````````"
      ],
      "terrain": { ".": "t_shingle_flat_roof", "`": "t_open_air" },
      "place_nested": [
        { "chunks": [ "NC_res_roof_solar_4X4" ], "x": 7, "y": 11 },
        { "chunks": [ "NC_res_roof_chunk_3X3" ], "x": [ 14, 18 ], "y": [ 9, 12 ] }
      ]
    }
  }
]
