[
  {
    "type": "mapgen",
    "om_terrain": "bungalow20",
    "method": "json",
    "object": {
      "palettes": [
        "standard_domestic_palette",
        "parameterized_linoleum_color_kitchen",
        "parameterized_linoleum_color_bathroom",
        "standard_domestic_landscaping_palette"
      ],
      "fill_ter": "t_floor",
      "rows": [
        ".......[...p---.........",
        "............---.........",
        ".###oo####oo#*###oo##...",
        ".#UU  £| xxxƏ=L|Fn21#...",
        ".oN    |    ===|˙˙˙5o...",
        ".#q $  |       |˙J˙O#^..",
        ".#||||+|sHHHs  |˙J˙4###.",
        ".#PPy  ||||||  ˙˙˙˙˙˙6o.",
        ".#r    |RRRRy  ˙?27Y˙6o.",
        ".orh   +       |||||||#.",
        ".or  ET|y  h   |dd|tS8#.",
        ".#||||||R hffh |  +¨¨¨o.",
        ".#B¨8ZW|R  ff  |ɸ |8BB#.",
        ".#B¨¨¨¨+  hffh ||+|||##.",
        ".#Qw8St|   h   +    b#..",
        "^#||||||       |    ¤o..",
        ".#@¤   + ====  |I  @@o..",
        ".#@   T|y===ƏVV|I  @@#..",
        ".o    D###o*o###    ¤#..",
        ".#dd by#GKG,,,,#DD  y#..",
        ".###oo##,,,,,,,####oo#..",
        ".......-,,,,,,,-........",
        "..[....---------........",
        "........................"
      ],
      "terrain": {
        "#": "t_wall_P",
        ",": "t_floor_noroof",
        "K": "t_floor_noroof",
        "G": "t_floor_noroof",
        "Y": { "param": "linoleum_color_kitchen", "fallback": "t_linoleum_white" },
        "?": { "param": "linoleum_color_kitchen", "fallback": "t_linoleum_white" },
        "W": { "param": "linoleum_color_bathroom", "fallback": "t_linoleum_white" },
        "Z": { "param": "linoleum_color_bathroom", "fallback": "t_linoleum_white" },
        "=": "t_carpet_red",
        "Ə": "t_carpet_red",
        "L": "t_carpet_red"
      },
      "furniture": { "£": "f_exercise", "$": "f_treadmill", "?": "f_bookcase" },
      "place_loot": [
        { "item": "television", "x": 10, "y": 3 },
        { "item": "fermenting_book", "x": 16, "y": 8, "chance": 2 },
        { "item": "baking_book", "x": 16, "y": 8, "chance": 50 },
        { "item": "vinegar_maker", "x": 16, "y": 8, "chance": 5 },
        { "item": "cookbook_indian", "x": 16, "y": 8, "chance": 15 },
        { "item": "cookbook_daintydishes", "x": 16, "y": 8, "chance": 25 },
        { "item": "brewing_cookbook", "x": 16, "y": 8, "chance": 10 },
        { "item": "cookbook", "x": 16, "y": 8, "chance": 50 }
      ],
      "place_nested": [ { "chunks": [ "NC_res_backyard_3X3" ], "x": 17, "y": 21 } ]
    }
  },
  {
    "type": "mapgen",
    "om_terrain": "bungalow20_roof",
    "method": "json",
    "object": {
      "palettes": [ "roof_palette" ],
      "fill_ter": "t_shingle_flat_roof",
      "rows": [
        "                        ",
        "                        ",
        " --------------------   ",
        " -..................-   ",
        " -..................-   ",
        " -..................5   ",
        " -..................--- ",
        " -....................- ",
        " -....................- ",
        " -....................- ",
        " -....................- ",
        " -....X...............- ",
        " -....................- ",
        " -...................-- ",
        " -...................-  ",
        " 5...N...............-  ",
        " -...................-  ",
        " -...................-  ",
        " -.....---------.....-  ",
        " -.....-       -.....-  ",
        " -------       -------  ",
        "                        ",
        "                        ",
        "                        "
      ],
      "terrain": { ".": "t_shingle_flat_roof" },
      "place_nested": [
        { "chunks": [ "NC_res_roof_solar_4X4" ], "x": 3, "y": 5 },
        { "chunks": [ "NC_res_roof_chunk_3X3" ], "x": [ 9, 15 ], "y": [ 4, 11 ] }
      ]
    }
  }
]
