[
  {
    "type": "mapgen",
    "om_terrain": "bungalow24",
    "method": "json",
    "object": {
      "palettes": [
        "standard_domestic_palette",
        "standard_domestic_lino_kitchen",
        "standard_domestic_lino_bathroom",
        "standard_domestic_landscaping_palette"
      ],
      "fill_ter": "t_floor",
      "rows": [
        "....---------p..........",
        "..###oo###---%.[........",
        "..# ¤@@¤y#---%..........",
        "..o  @@  #o*#^%%%%##o##.",
        "..o      |L ##ooo##NNq#.",
        ".%#   T  |Ə ,sHHHs| h #.",
        ".%#Ddd||+|  ,,,,,,|   o.",
        ".##||||R    ,,lll,| qq#.",
        ".#88ZW|R    ,,,,,,|+||#.",
        ".oS___+     ,,xxx,,  R#.",
        ".#t_BB|  VV |||||||  R#.",
        ".##||||+||| 662FJJ|``r#.",
        ".%# Ddy |U+ _____O|`!ro.",
        ".%o@    |z+ Y13754|``ro.",
        ".%o@   I|||    A  y  P#.",
        "..#¤ ɸhI|y  h        P#.",
        "..######|  hff ||+|||##.",
        "....-==¶    ffh|y dd #^.",
        "....-==: y  h y|    ¤#%.",
        "....-==###oooo##   @@o%.",
        "....-=====     *   @@o%.",
        "....-===== iiii#Db  ¤#%.",
        ".[..-=₸=₸=&????###o###%.",
        "........................"
      ],
      "terrain": {
        "#": "t_wall_g",
        "~": "t_door_glass_c",
        "_": "t_linoleum_gray",
        "?": "t_railing_v",
        "=": "t_floor_noroof",
        ",": "t_carpet_red",
        "`": "t_carpet_purple",
        "!": "t_carpet_purple",
        "Y": "t_linoleum_gray",
        "r": "t_carpet_purple",
        "₸": "t_floor_noroof",
        "&": "t_column",
        "W": "t_linoleum_gray",
        "Z": "t_linoleum_gray",
        "l": "t_carpet_red",
        "x": "t_carpet_red",
        "H": "t_carpet_red",
        "s": "t_carpet_red"
      },
      "furniture": { "!": "f_chair" },
      "place_loot": [ { "item": "television", "x": 15, "y": 9 }, { "item": "laptop", "x": 21, "y": 12 } ],
      "place_nested": [ { "chunks": [ "NC_res_frontlawn_3X3" ], "x": 17, "y": 0 }, { "chunks": [ "NC_res_backyard_3X3" ], "x": 1, "y": 17 } ]
    }
  },
  {
    "type": "mapgen",
    "om_terrain": "bungalow24_roof",
    "method": "json",
    "object": {
      "palettes": [ "roof_palette" ],
      "fill_ter": "t_shingle_flat_roof",
      "rows": [
        "                        ",
        "  --------              ",
        "  -......-              ",
        "  -......----     ----- ",
        "  -.........-5-----...- ",
        "  -...................- ",
        "  -...................- ",
        " --...................- ",
        " -....................- ",
        " -....................- ",
        " -....................- ",
        " --.....X.............- ",
        "  -...................- ",
        "  -...................- ",
        "  -...................- ",
        "  -...................- ",
        "  ------........=....-- ",
        "       -.............5  ",
        "       -.............-  ",
        "       ----..........-  ",
        "          -..........-  ",
        "          -..........-  ",
        "          ------------  ",
        "                        "
      ],
      "terrain": { ".": "t_shingle_flat_roof" },
      "place_nested": [
        { "chunks": [ "NC_res_roof_solar_4X4" ], "x": 10, "y": 14 },
        { "chunks": [ "NC_res_roof_chunk_3X3" ], "x": [ 3, 18 ], "y": [ 5, 8 ] }
      ]
    }
  }
]
