[
  {
    "type": "mapgen",
    "om_terrain": "bungalow19",
    "method": "json",
    "object": {
      "palettes": [
        "standard_domestic_palette",
        "parameterized_linoleum_color_kitchen",
        "parameterized_linoleum_color_bathroom",
        "standard_domestic_landscaping_palette"
      ],
      "fill_ter": "t_floor",
      "rows": [
        "...........---..........",
        "..%##oo##..---##oo###...",
        "..%#g¨¨W#%p---oy  sso...",
        ".[%#U¨Z|#o##*##( E y#.[.",
        "..%#U¨q|rrr|    ®®® #...",
        "..%#q¨¨+ h | L|H®l® #^..",
        ".###|||| PR| /|H®l®a#%..",
        ".#¤,ɸdd|+||| Ə|H®®® #%..",
        ".o@@,,,| RRR y|T E y#%%.",
        ".o@@,,,+     V|(   y#o#.",
        ".#¤,,bD|i    V||||   y#.",
        ".#||||||i    y664˙  h #.",
        ".#¤,,,+       ˙˙˙˙ ffh#.",
        ".o@@,,|||||| |2˙JAhff o.",
        ".o@@,,d|tBB| |1˙n˙ h  o.",
        ".#¤,,,d|¨¨¨+ |O˙3A   T#.",
        ".#?II,D|S8Q| |J5F˙   y#.",
        ".##oo##|||||+#####:¶:##.",
        "...%%^#dd,D,,#₸=₸=₸===}.",
        ".....%#,,,,,,#========}.",
        ".....%#,,@@,,#========}.",
        "......#?¤@@¤&#}}}---}}}.",
        "......##o##o##..........",
        "........................"
      ],
      "terrain": {
        "}": "t_railing_v",
        "®": "t_carpet_green",
        "l": "t_carpet_green",
        "=": "t_floor_noroof",
        "₸": "t_floor_noroof",
        "q": { "param": "linoleum_color_bathroom", "fallback": "t_linoleum_white" },
        "Z": { "param": "linoleum_color_bathroom", "fallback": "t_linoleum_white" },
        "W": { "param": "linoleum_color_bathroom", "fallback": "t_linoleum_white" },
        "A": { "param": "linoleum_color_kitchen", "fallback": "t_linoleum_white" },
        "g": { "param": "linoleum_color_bathroom", "fallback": "t_linoleum_white" },
        "U": { "param": "linoleum_color_bathroom", "fallback": "t_linoleum_white" },
        ",": "t_carpet_purple",
        "ɸ": "t_carpet_purple",
        "&": "t_carpet_purple",
        "¤": "t_carpet_purple",
        "@": "t_carpet_purple",
        "D": "t_carpet_purple",
        "d": "t_carpet_purple",
        "?": "t_carpet_purple",
        "I": "t_carpet_purple",
        "b": "t_carpet_purple"
      },
      "furniture": { "(": "f_speaker_cabinet", "&": "f_floor_lamp", "?": [ "f_indoor_plant", "f_indoor_plant_y" ], "/": "f_rack" },
      "items": { "/": { "item": "clothing_outdoor_shoes", "chance": 50, "repeat": [ 2, 3 ] } },
      "place_nested": [ { "chunks": [ "NC_res_backyard_3X3" ], "x": 1, "y": 20 } ]
    }
  },
  {
    "type": "mapgen",
    "om_terrain": "bungalow19_roof",
    "method": "json",
    "object": {
      "palettes": [ "roof_palette" ],
      "fill_ter": "t_shingle_flat_roof",
      "rows": [
        "                        ",
        "   ------     -------   ",
        "   -....-     -.....-   ",
        "   -....-------.....-   ",
        "   -................-   ",
        "   -................5   ",
        " ---...............~-   ",
        " -..................-   ",
        " -..................-   ",
        " -..................--- ",
        " -....................- ",
        " -....................- ",
        " -....................- ",
        " -...X................- ",
        " -....................- ",
        " -....................- ",
        " -....................- ",
        " ----5-......---------- ",
        "      -......-          ",
        "      -......-          ",
        "      -......-          ",
        "      -......-          ",
        "      --------          ",
        "                        "
      ],
      "terrain": { ".": "t_shingle_flat_roof" },
      "place_nested": [
        { "chunks": [ "NC_res_roof_solar_4X4" ], "x": 4, "y": 8 },
        { "chunks": [ "NC_res_roof_chunk_3X3" ], "x": [ 9, 16 ], "y": [ 12, 14 ] }
      ]
    }
  }
]