[
  {
    "type": "mapgen",
    "om_terrain": "bungalow16",
    "method": "json",
    "object": {
      "palettes": [ "standard_domestic_palette", "standard_domestic_lino_bathroom", "standard_domestic_landscaping_palette" ],
      "fill_ter": "t_floor",
      "rows": [
        "..........p--...........",
        "........[..--...........",
        "...........--...........",
        ".##o##o###%--%###o##o##.",
        ".#Ry    s#%--%#¤,,,,,r#.",
        ".#R   l H#%--%#&&,,,}r#.",
        ".#R x l H#%--%#&&,,,,r#.",
        ".#    l H##o*##|,,,,,P#.",
        ".o  |||||||L |c+,{$$,,o.",
        ".#  |BtS8Q|  |||||||+|#.",
        ".#  |B____+  ƏƏ      T#^",
        ".#  |||||||           #.",
        ".#Y   TVV|y     R|+|++#.",
        ".#476           R|q|ZW#.",
        ".#2           |+||||||#.",
        ".o1 JA   |Ə  i|===ddb=o.",
        ".#5 J   h|Ə  i|=======#.",
        ".#O J  ff|L  i|@@====ɸ#.",
        ".#F   hff##:~##@@=?===#.",
        ".##o##o###----###o##o##.",
        ".......^..----..........",
        "........................",
        "..[....[................",
        "........................"
      ],
      "terrain": {
        "~": "t_door_glass_c",
        "_": "t_linoleum_gray",
        "=": "t_carpet_purple",
        ",": "t_carpet_red",
        "¤": "t_carpet_red",
        "G": "t_region_groundcover_urban",
        "?": "t_carpet_purple",
        "@": "t_carpet_purple",
        "ɸ": "t_carpet_purple",
        "d": "t_carpet_purple",
        "b": "t_carpet_purple",
        "$": "t_carpet_red",
        "{": "t_carpet_red",
        "v": "t_carpet_red",
        "&": "t_carpet_red",
        "c": "t_carpet_red",
        "P": "t_carpet_red",
        "r": "t_carpet_red",
        "}": "t_carpet_red",
        "]": "t_carpet_red",
        "W": "t_linoleum_gray",
        "Z": "t_linoleum_gray"
      },
      "furniture": {
        "$": "f_dresser",
        "&": "f_bed",
        "?": "f_exercise",
        "0": "f_table",
        "{": "f_wardrobe",
        "}": "f_chair",
        "c": "f_gunsafe_ml",
        "]": "f_table"
      },
      "items": {
        "$": [
          { "item": "SUS_dresser_mens", "chance": 50, "repeat": [ 1, 2 ] },
          { "item": "SUS_dresser_womens", "chance": 50, "repeat": [ 1, 2 ] }
        ],
        "{": [
          { "item": "SUS_wardrobe_mens", "chance": 50, "repeat": [ 1, 2 ] },
          { "item": "SUS_wardrobe_womens", "chance": 50, "repeat": [ 1, 2 ] }
        ],
        "]": { "item": "nightstand", "chance": 40 },
        "c": { "item": "guns_pistol_common", "chance": 50 }
      },
      "place_loot": [ { "item": "television", "x": 4, "y": 6, "chance": 100 } ],
      "place_nested": [ { "chunks": [ "NC_res_frontlawn_3X3" ], "x": 15, "y": 0 }, { "chunks": [ "NC_res_backyard_3X3" ], "x": 15, "y": 20 } ]
    }
  },
  {
    "type": "mapgen",
    "om_terrain": "bungalow16_roof",
    "method": "json",
    "object": {
      "palettes": [ "roof_palette" ],
      "fill_ter": "t_shingle_flat_roof",
      "rows": [
        "                        ",
        "                        ",
        "                        ",
        " ---------    --------- ",
        " -.......-    -.......- ",
        " -.......-    -.......- ",
        " -.......-    -.......- ",
        " -.N.....------.......- ",
        " -....................- ",
        " -.X..................- ",
        " -....................5 ",
        " -....................- ",
        " -....................- ",
        " -....................- ",
        " -....................- ",
        " -....=...............- ",
        " -....................- ",
        " -....................- ",
        " -.......------.......- ",
        " ------5--    --------- ",
        "                        ",
        "                        ",
        "                        ",
        "                        "
      ],
      "terrain": { ".": "t_shingle_flat_roof" },
      "place_nested": [
        { "chunks": [ "NC_res_roof_solar_4X4" ], "x": 9, "y": 12 },
        { "chunks": [ "NC_res_roof_chunk_3X3" ], "x": [ 6, 18 ], "y": [ 8, 10 ] }
      ]
    }
  }
]
