[
  {
    "type": "mapgen",
    "om_terrain": "bungalow04",
    "method": "json",
    "object": {
      "palettes": [
        "standard_domestic_palette",
        "parameterized_linoleum_color_kitchen",
        "parameterized_linoleum_color_bathroom",
        "standard_domestic_landscaping_palette"
      ],
      "fill_ter": "t_floor",
      "rows": [
        "..........p.,,,.........",
        "............,,,.........",
        "......[.....,,,.........",
        "............,,,.........",
        "............,,,.........",
        "....!!!=====---!!!......",
        "....!#####oo#*#oo#......",
        ".[..!#R~~l♦♦Ə~T♦♦#......",
        ".!!!!#s~~H~~~~~~~#...[..",
        ".##o##x~~H~~RRR~~#......",
        ".#@@¤|s~~H~~|||++#......",
        ".#@@ |R~~l~~+L|zz#///...",
        ".o   +~~~~~~|||||#///...",
        ".o   |b~~~~~+¨¨¨¨o///...",
        ".#D  ||+||~~|98St#///...",
        ".#d ɸ|Z¨W|~~|||||#///...",
        ".#######||~~+U|qq#####..",
        "..jjj.^#y   |||++|662#..",
        ".......#       ˙˙˙˙˙˙o..",
        "......-*       ˙JJJ˙Fo..",
        ".......o   ff  ˙˙˙˙˙3o..",
        ".......#y hffh ˙˙O5J1#..",
        ".......######oo###oo##..",
        "........................"
      ],
      "terrain": {
        "#": "t_adobe_brick_wall",
        "=": "t_shrub_lilac",
        ",": "t_dirt",
        "W": { "param": "linoleum_color_bathroom", "fallback": "t_linoleum_white" },
        "Z": { "param": "linoleum_color_bathroom", "fallback": "t_linoleum_white" },
        "~": "t_carpet_red",
        "R": "t_carpet_red",
        "♦": "t_carpet_red",
        "Ə": "t_carpet_red",
        "T": "t_carpet_red",
        "l": "t_carpet_red",
        "H": "t_carpet_red",
        "s": "t_carpet_red",
        "x": "t_carpet_red",
        "/": "t_dirtmound",
        "K": "t_region_groundcover_urban",
        "G": "t_region_groundcover_urban",
        "b": "t_carpet_red",
        "!": "t_dirtmound"
      },
      "furniture": { "♦": [ "f_indoor_plant", "f_indoor_plant_y" ], "&": "f_region_flower" },
      "items": { "/": { "item": "hydro", "chance": 40 } },
      "place_loot": [
        { "item": "television", "x": 6, "y": 9 },
        { "group": "tools_earthworking", "x": [ 18, 20 ], "y": [ 10, 10 ], "chance": 50, "repeat": [ 1, 2 ] }
      ],
      "place_nested": [ { "chunks": [ "NC_res_frontlawn_3X3" ], "x": 19, "y": 2 }, { "chunks": [ "NC_res_backyard_3X3" ], "x": 1, "y": 20 } ]
    }
  },
  {
    "type": "mapgen",
    "om_terrain": "bungalow04_roof",
    "method": "json",
    "object": {
      "palettes": [ "roof_palette" ],
      "fill_ter": "t_shingle_flat_roof",
      "rows": [
        "                        ",
        "                        ",
        "                        ",
        "                        ",
        "                        ",
        "                        ",
        "     -------------      ",
        "     -...........-      ",
        "     -...........-      ",
        " -----...........-      ",
        " -...............-      ",
        " -...............-      ",
        " -...............-      ",
        " -...............-      ",
        " -...=.........N.-      ",
        " -...............-      ",
        " -------.........-----  ",
        "       5.............-  ",
        "       -.............-  ",
        "       -.............-  ",
        "       -.............-  ",
        "       -.............-  ",
        "       ---------------  ",
        "                        "
      ],
      "terrain": { ".": "t_shingle_flat_roof" },
      "place_nested": [
        { "chunks": [ "NC_res_roof_solar_4X4" ], "x": 12, "y": 17 },
        { "chunks": [ "NC_res_roof_chunk_3X3" ], "x": [ 6, 12 ], "y": [ 10, 12 ] }
      ]
    }
  }
]
