[
  {
    "type": "mapgen",
    "om_terrain": "bungalow03",
    "method": "json",
    "object": {
      "palettes": [
        "standard_domestic_palette",
        "parameterized_linoleum_color_kitchen",
        "parameterized_linoleum_color_bathroom",
        "standard_domestic_landscaping_palette"
      ],
      "fill_ter": "t_floor_waxed",
      "rows": [
        "....-------------------p",
        ".[..-------------------.",
        ".##oo#####o######oo##--.",
        ".#432F51|Qt8|D |¤@@¤#--.",
        ".#6˙˙˙˙O|¨¨S|D + @@ o--.",
        ".#6˙˙nJJ|8¨B|  |    o--.",
        ".: h  AA|8¨B|$v|dd y#--.",
        ".: ff   ||+|||||||+|#--.",
        ".:hffh  |y         yo--.",
        ".: h       y#########--.",
        ".:y        Lo,,¥¥....--.",
        ".#sHHHT   ==*,,,-------.",
        ".#H       ==*,,,-------.",
        ".oH l      Əo,,¥¥.......",
        ".#H l EVV  $#%%%%%%%%%..",
        "^#|||||||  b#########%..",
        ".#rh  +     TRR|ɸddD#%..",
        ".#r  P|RRR     |    #%..",
        ".#||||||||     +  @@o...",
        ".#RR    +  y|+||  @@o...",
        ".o   h  ||+||¨¨|   ¤#.~~",
        ".# yrrr |U q|ZW|II b#.~~",
        ".##oo############oo##.~~",
        "........................"
      ],
      "terrain": {
        "#": "t_wall_r",
        ",": "t_floor_noroof",
        "~": "t_shrub_lilac",
        "¥": "t_railing_v",
        "=": "t_carpet_green",
        "W": { "param": "linoleum_color_bathroom", "fallback": "t_linoleum_white" },
        "Z": { "param": "linoleum_color_bathroom", "fallback": "t_linoleum_white" }
      },
      "furniture": { "$": "f_rack" },
      "items": { "$": { "item": "clothing_outdoor_shoes", "chance": 50 } },
      "place_loot": [ { "item": "laptop", "x": 5, "y": 21, "chance": 50 } ]
    }
  },
  {
    "type": "mapgen",
    "om_terrain": "bungalow03_roof",
    "method": "json",
    "object": {
      "palettes": [ "roof_palette" ],
      "fill_ter": "t_shingle_flat_roof",
      "rows": [
        "                        ",
        "                        ",
        " --------------------   ",
        " -..................-   ",
        " -..................-   ",
        " -..................-   ",
        " -..................-   ",
        " -..................-   ",
        " -..N...............-   ",
        " -..........---------   ",
        " -..........-           ",
        " -..........-           ",
        " -..........-           ",
        " -..........-           ",
        " -..........-           ",
        " 5..........---------   ",
        " -..................-   ",
        " -..................-   ",
        " -..................-   ",
        " -.......=..........-   ",
        " -..................-   ",
        " -..................-   ",
        " --------------------   ",
        "                        "
      ],
      "terrain": { ".": "t_shingle_flat_roof" },
      "place_nested": [
        { "chunks": [ "NC_res_roof_solar_4X4" ], "x": 11, "y": 4 },
        { "chunks": [ "NC_res_roof_chunk_3X3" ], "x": [ 3, 8 ], "y": [ 10, 14 ] }
      ]
    }
  }
]
