[
  {
    "type": "mapgen",
    "om_terrain": "bungalow20",
    "method": "json",
    "object": {
      "palettes": [
        "standard_domestic_palette",
        "standard_domestic_lino_kitchen",
        "standard_domestic_lino_bathroom",
        "standard_domestic_landscaping_palette"
      ],
      "fill_ter": "t_floor",
      "rows": [
        ".......[...p---.........",
        "............---.........",
        ".###oo####oo#*###oo##...",
        ".#UU  £| xxxƏ=L|Fn21#...",
        ".oN    |    ===|___5o...",
        ".#q $  |       |_J_O#^..",
        ".#||||+|sHHHs  |_J_4###.",
        ".#PPy  ||||||  ______6o.",
        ".#r    |RRRRy  _?27Y_6o.",
        ".orh   +       |||||||#.",
        ".or  ET|y  h   |dd|tS8#.",
        ".#||||||R hffh |  +___o.",
        ".#B_8ZW|R  ff  |ɸ |8BB#.",
        ".#B____+  hffh ||+|||##.",
        ".#Qw8St|   h   +    b#..",
        "^#||||||       |    ¤o..",
        ".#@¤   + ====  |I  @@o..",
        ".#@   T|y===ƏVV|I  @@#..",
        ".o    D###o*o###    ¤#..",
        ".#dd by#GKG,,,,#DD  y#..",
        ".###oo##,,,,,,,####oo#..",
        ".......-,,,,,,,-........",
        "..[....---------........",
        "........................"
      ],
      "terrain": {
        "#": "t_wall_P",
        "_": "t_linoleum_gray",
        ",": "t_floor_noroof",
        "K": "t_floor_noroof",
        "G": "t_floor_noroof",
        "Y": "t_linoleum_gray",
        "?": "t_linoleum_gray",
        "W": "t_linoleum_gray",
        "Z": "t_linoleum_gray",
        "=": "t_carpet_red",
        "Ə": "t_carpet_red",
        "L": "t_carpet_red"
      },
      "furniture": { "£": "f_exercise", "$": "f_treadmill", "?": "f_bookcase" },
      "place_loot": [
        { "item": "television", "x": 10, "y": 3 },
        { "item": "fermenting_book", "x": 16, "y": 8, "chance": 2 },
        { "item": "baking_book", "x": 16, "y": 8, "chance": 50 },
        { "item": "vinegar_maker", "x": 16, "y": 8, "chance": 5 },
        { "item": "cookbook_indian", "x": 16, "y": 8, "chance": 15 },
        { "item": "cookbook_daintydishes", "x": 16, "y": 8, "chance": 25 },
        { "item": "brewing_cookbook", "x": 16, "y": 8, "chance": 10 },
        { "item": "cookbook", "x": 16, "y": 8, "chance": 50 }
      ],
      "place_nested": [ { "chunks": [ "NC_res_backyard_3X3" ], "x": 17, "y": 21 } ]
    }
  },
  {
    "type": "mapgen",
    "om_terrain": "bungalow20_roof",
    "method": "json",
    "object": {
      "palettes": [ "roof_palette" ],
      "fill_ter": "t_shingle_flat_roof",
      "rows": [
        "                        ",
        "                        ",
        " --------------------   ",
        " -..................-   ",
        " -..................-   ",
        " -..................5   ",
        " -..................--- ",
        " -....................- ",
        " -....................- ",
        " -....................- ",
        " -....................- ",
        " -....X...............- ",
        " -....................- ",
        " -...................-- ",
        " -...................-  ",
        " 5...N...............-  ",
        " -...................-  ",
        " -...................-  ",
        " -.....---------.....-  ",
        " -.....-       -.....-  ",
        " -------       -------  ",
        "                        ",
        "                        ",
        "                        "
      ],
      "terrain": { ".": "t_shingle_flat_roof" },
      "place_nested": [
        { "chunks": [ "NC_res_roof_solar_4X4" ], "x": 3, "y": 5 },
        { "chunks": [ "NC_res_roof_chunk_3X3" ], "x": [ 9, 15 ], "y": [ 4, 11 ] }
      ]
    }
  }
]
