[
  {
    "type": "mapgen",
    "om_terrain": "bungalow05",
    "method": "json",
    "object": {
      "palettes": [ "standard_domestic_palette", "standard_domestic_lino_bathroom", "standard_domestic_landscaping_palette" ],
      "fill_ter": "t_floor",
      "rows": [
        "...---..................",
        "...---.......#####oo##..",
        "...---.p)))))#ZW|d  ɸ#..",
        "...---.##oo###__|d  @#..",
        "...---%#@@ b|B_t|   @o..",
        "...---%o@@ D|B_S|D  ¤#..",
        "...---%#¤  d|8_8|||+|#..",
        "...---%#   d||+||y  T#..",
        "...---%#|+|||y    // o..",
        "...---%oƏ         //ho..",
        "...---##||||||||   rr#..",
        "..#o*o#ffh|xxx     ||#..",
        "..#Ə L|ff |/// l   +U#..",
        "..#  &|h  |/// E   +q#..",
        "..o      4|HHH   |+||#^.",
        "..oy     7|sssT  |  y#..",
        "..#F JJA         |  Ə#..",
        "..#J         yRRR|  Əo..",
        "..#5JO126  RR#####o¶##..",
        "..###oo##oo###$$$`````..",
        ".............-````````..",
        "..,,.........-``₸`K`₸`..",
        ".,[,.........-````₸```..",
        ".,......................"
      ],
      "terrain": {
        "#": "t_adobe_brick_wall",
        "|": "t_wall",
        "~": "t_door_glass_c",
        "_": "t_linoleum_gray",
        "`": "t_floor_noroof",
        "₸": "t_floor_noroof",
        "$": "t_floor_noroof",
        "K": "t_floor_noroof",
        "W": "t_linoleum_gray",
        "Z": "t_linoleum_gray",
        ")": "t_shrub_lilac",
        ",": "t_dirt",
        "/": "t_carpet_yellow"
      },
      "furniture": { "$": "f_rack", "&": "f_rack" },
      "items": {
        "&": { "item": "clothing_outdoor_shoes", "chance": 40, "repeat": [ 1, 2 ] },
        "$": [ { "item": "sports", "chance": 30 }, { "item": "camping", "chance": 30 } ]
      },
      "place_loot": [ { "item": "television", "x": 12, "y": 11 } ],
      "place_nested": [ { "chunks": [ "NC_res_frontlawn_3X3" ], "x": 0, "y": 1 }, { "chunks": [ "NC_res_backyard_3X3" ], "x": 8, "y": 20 } ]
    }
  },
  {
    "type": "mapgen",
    "om_terrain": "bungalow05_roof",
    "method": "json",
    "object": {
      "palettes": [ "roof_palette" ],
      "fill_ter": "t_shingle_flat_roof",
      "rows": [
        ",,,,,,,,,,,,,,,,,,,,,,,,",
        ",,,,,,,,,,,,,---------,,",
        ",,,,,,,,,,,,,-.......-,,",
        ",,,,,,,-------.......-,,",
        ",,,,,,,-.............-,,",
        ",,,,,,,-.............-,,",
        ",,,,,,,-.............-,,",
        ",,,,,,,-.............-,,",
        ",,,,,,,-.............-,,",
        ",,,,,,,-.............-,,",
        ",,,,,,--....=........-,,",
        ",,-----..............-,,",
        ",,-..................-,,",
        ",,-..................-,,",
        ",,-...............X..5,,",
        ",,-...N..............-,,",
        ",,-..................-,,",
        ",,-..................-,,",
        ",,-..........---------,,",
        ",,------------,,,,,,,,,,",
        ",,,,,,,,,,,,,,,,,,,,,,,,",
        ",,,,,,,,,,,,,,,,,,,,,,,,",
        ",,,,,,,,,,,,,,,,,,,,,,,,",
        ",,,,,,,,,,,,,,,,,,,,,,,,"
      ],
      "terrain": { ".": "t_shingle_flat_roof", ",": "t_open_air" },
      "place_nested": [
        { "chunks": [ "NC_res_roof_solar_4X4" ], "x": 14, "y": 6 },
        { "chunks": [ "NC_res_roof_chunk_3X3" ], "x": 8, "y": 5 }
      ]
    }
  }
]
