[
  {
    "type": "mapgen",
    "om_terrain": "bungalow17",
    "method": "json",
    "object": {
      "palettes": [
        "standard_domestic_palette",
        "parameterized_linoleum_color_kitchen",
        "parameterized_linoleum_color_bathroom",
        "standard_domestic_landscaping_palette"
      ],
      "fill_ter": "t_floor_waxed",
      "rows": [
        "...........--...........",
        "..,,,......--......,,,..",
        "..,&,......--......,&,..",
        "..,,,......--......,,,..",
        "...........--...........",
        ".?????.....--.....?????.",
        ".##o#######o*#####o#o##.",
        ".#t¨|QQ|qU|L iii|R   R#.",
        ".#S¨|++|q +     +  h  o.",
        ".#8¨+  ||||b   y|PrrrP#.",
        "^#BB|y         |||||||#.",
        ".#||||||||++|  +     D#.",
        ".:y h   V|WZ|  |++|  @o.",
        ".:  ff  V||||  |dd|ɸ¤@o.",
        ".: hffh yRRRR  |||||||#-",
        ".:  ff                *-",
        ".:y h          RR||+||#-",
        ".#||| ||||  l H|||   ¤#.",
        ".#723˙JJJ|a l H|d|  @@o.",
        ".o6˙˙˙˙˙˙|    H| +  @@o.",
        ".#641F5OJ|sHHHs|d|D  ¤#.",
        ".###o##o##:::::####oo##.",
        "....../..........^......",
        "........................"
      ],
      "terrain": {
        ",": "t_dirtmound",
        "?": "t_shrub_lilac",
        "/": "t_region_groundcover_urban",
        "&": "t_region_groundcover_urban",
        "Q": "t_floor_waxed"
      },
      "furniture": { "&": "f_boulder_large", "/": [ [ "f_null", 4 ], "f_ladder" ] },
      "place_nested": [ { "chunks": [ "NC_res_frontlawn_3X3" ], "x": 6, "y": 1 } ]
    }
  },
  {
    "type": "mapgen",
    "om_terrain": "bungalow17_roof",
    "method": "json",
    "object": {
      "palettes": [ "roof_palette" ],
      "fill_ter": "t_shingle_flat_roof",
      "rows": [
        "                        ",
        "                        ",
        "                        ",
        "                        ",
        "                        ",
        "                        ",
        " ---------------------- ",
        " -....................- ",
        " -....................- ",
        " -....................- ",
        " 5....................- ",
        " -....................- ",
        " -....................- ",
        " -....................- ",
        " -.........oooo.......- ",
        " -.........oooo.......- ",
        " -.........oooo.......- ",
        " -.........oooo.......- ",
        " -........~oooo.......- ",
        " -....................- ",
        " -....................- ",
        " ----------------5----- ",
        "                        ",
        "                        "
      ],
      "terrain": { ".": "t_shingle_flat_roof" },
      "place_nested": [
        { "chunks": [ "NC_res_roof_solar_4X4" ], "x": 3, "y": 14 },
        { "chunks": [ "NC_res_roof_chunk_3X3" ], "x": [ 5, 17 ], "y": [ 9, 11 ] }
      ]
    }
  }
]
