[
  {
    "type": "mapgen",
    "om_terrain": "bungalow21",
    "method": "json",
    "object": {
      "palettes": [ "standard_domestic_palette", "standard_domestic_lino_bathroom", "standard_domestic_landscaping_palette" ],
      "fill_ter": "t_floor",
      "rows": [
        ".[...........p._______..",
        "............---_______..",
        "............---_______/.",
        "............--#]]]]]]]#.",
        "...%###oo###o*#,,,,,,,#.",
        "...%#@@  dd|L |,,,,,,,#.",
        "...%o      |Ə |,,,,,,,#.",
        "....o      +  +,,,,,,,o.",
        ".[.%#@@  dd|  |U,,,,,,#.",
        "...%#|||||||  |q,,,,,,#.",
        "....#@@   b|  |N,,,,zz#.",
        "....o@@    +  |||||||##.",
        "....#¤  ɸdd|  +00000B#^.",
        "....#|+|||||  |88St0Bo%.",
        "....#D |Z W|  |||||||#%.",
        ".---##|||+||  431JO5F#%.",
        ".-===#y    T         o..",
        ".-===*               o..",
        ".`===o lll    |6   h #..",
        ".`==G#     E R|6  ff #%.",
        ".`==K#sHHHsy R|y hffh#%.",
        ".`==G#####oo#####oo###%.",
        ".`````^..%%%%...%%%%....",
        "........................"
      ],
      "terrain": {
        "0": "t_linoleum_gray",
        "=": "t_floor_noroof",
        "`": "t_railing_v",
        "]": "t_door_metal_locked",
        "/": "t_gates_mech_control_lab",
        ",": "t_thconc_floor",
        "K": "t_floor_noroof",
        "G": "t_floor_noroof",
        "z": "t_thconc_floor",
        "N": "t_thconc_floor",
        "q": "t_thconc_floor",
        "U": "t_thconc_floor"
      },
      "place_loot": [
        { "group": "toy_store", "x": [ 5, 10 ], "y": [ 6, 7 ], "chance": 50, "repeat": [ 4, 6 ] },
        { "item": "backpack", "x": 7, "y": 5, "chance": 60 },
        { "item": "talking_doll", "x": 5, "y": 8, "chance": 60 }
      ],
      "place_vehicles": [ { "vehicle": "car", "x": 19, "y": 7, "chance": 30, "rotation": 90 } ],
      "place_nested": [ { "chunks": [ "NC_res_frontlawn_3X3" ], "x": 4, "y": 1 }, { "chunks": [ "NC_res_backyard_3X3" ], "x": 1, "y": 12 } ]
    }
  },
  {
    "type": "mapgen",
    "om_terrain": "bungalow21_roof",
    "method": "json",
    "object": {
      "palettes": [ "roof_palette" ],
      "fill_ter": "t_shingle_flat_roof",
      "rows": [
        "                        ",
        "                        ",
        "                        ",
        "              --------- ",
        "    -----------.......- ",
        "    -.................- ",
        "    -.................- ",
        "    -.................- ",
        "    -.................- ",
        "    -.................- ",
        "    -.................- ",
        "    -................-- ",
        "    -................5  ",
        "    -................-  ",
        "    -................-  ",
        "    --..N............-  ",
        "     -...............-  ",
        "     -...............-  ",
        "     -...............-  ",
        "     -...............-  ",
        "     -...............-  ",
        "     -5---------------  ",
        "                        ",
        "                        "
      ],
      "terrain": { ".": "t_shingle_flat_roof" },
      "place_nested": [
        { "chunks": [ "NC_res_roof_solar_4X4" ], "x": 7, "y": 17 },
        { "chunks": [ "NC_res_roof_chunk_3X3" ], "x": [ 6, 18 ], "y": [ 5, 11 ] }
      ]
    }
  }
]
