[
  {
    "type": "mapgen",
    "om_terrain": "bungalow06",
    "method": "json",
    "object": {
      "palettes": [
        "standard_domestic_palette",
        "standard_domestic_lino_kitchen",
        "standard_domestic_lino_bathroom",
        "standard_domestic_landscaping_palette"
      ],
      "fill_ter": "t_floor_waxed",
      "rows": [
        "..........---p..........",
        "....,,,,,,,,,####oo###..",
        ".%%%,iiiii,,,#ɸ+ II b#..",
        ".%####oo###o*#v+    ¤#..",
        ".## h h  y|L |||   @@o..",
        ".:y fff  V|Ə |D+   @@o..",
        ".: hfffh V|  |D+    ¤#..",
        ".:  h h      |||+||||#..",
        ".:               |t_S#..",
        ".##1J5J32__      +__8o..",
        ".%#________ |+|++|BB8#..",
        ".%#7FOJ466| |z|ZW||||#^.",
        "..##||||||| ||||||$ D#..",
        "..##sHHHsT  yRR|     o..",
        "..%#~~~~~E     +    ¤o..",
        "..%#~lll~     y|dd @@#..",
        "..%#~~~~~    ||||||||#..",
        "...#yxxxy    +  yRRRR#..",
        "...#####oo*oo#U     yo..",
        "...)₸K₸,,,,,,#q  h  Po..",
        "...),,,,,,,,,#q Trr P#..",
        ".X.),,,,,,,,,####oo###..",
        "...))))))...))%%%%%%%%.[",
        "........................"
      ],
      "terrain": {
        "#": "t_rock_wall",
        "_": "t_linoleum_gray",
        ",": "t_floor_noroof",
        ")": "t_railing_v",
        "~": "t_carpet_green",
        "i": "t_floor_noroof",
        "l": "t_carpet_green",
        "W": "t_linoleum_gray",
        "Z": "t_linoleum_gray",
        "K": "t_floor_noroof",
        "₸": "t_floor_noroof"
      },
      "furniture": { "$": "f_exercise" },
      "place_loot": [ { "item": "television", "x": 6, "y": 17 } ]
    }
  },
  {
    "type": "mapgen",
    "om_terrain": "bungalow06_roof",
    "method": "json",
    "object": {
      "palettes": [ "roof_palette" ],
      "fill_ter": "t_shingle_flat_roof",
      "rows": [
        ",,,,,,,,,,,,,,,,,,,,,,,,",
        ",,,,,,,,,,,,,---------,,",
        ",,,,,,,,,,,,,-.......-,,",
        ",,------------.......-,,",
        ",--..................-,,",
        ",-...................-,,",
        ",-...................-,,",
        ",-...................-,,",
        ",-...................-,,",
        ",--...=..............-,,",
        ",,-..................-,,",
        ",,-..................5,,",
        ",,-..................-,,",
        ",,--...X.......A.....-,,",
        ",,,-.................-,,",
        ",,,-.................-,,",
        ",,,-.................-,,",
        ",,,-.................-,,",
        ",,,-----------.......-,,",
        ",,,,,,,,,,,,,-.......-,,",
        ",,,,,,,,,,,,,-.......-,,",
        ",,,,,,,,,,,,,---------,,",
        ",,,,,,,,,,,,,,,,,,,,,,,,",
        ",,,,,,,,,,,,,,,,,,,,,,,,"
      ],
      "terrain": { ",": "t_open_air", ".": "t_shingle_flat_roof" },
      "place_nested": [
        { "chunks": [ "NC_res_roof_solar_4X4" ], "x": 15, "y": 15 },
        { "chunks": [ "NC_res_roof_chunk_3X3" ], "x": [ 8, 14 ], "y": [ 5, 8 ] }
      ]
    }
  }
]
