[
  {
    "type": "mapgen",
    "om_terrain": "bungalow11",
    "method": "json",
    "object": {
      "palettes": [
        "standard_domestic_palette",
        "parameterized_linoleum_color_kitchen",
        "parameterized_linoleum_color_bathroom",
        "standard_domestic_landscaping_palette"
      ],
      "fill_ter": "t_floor",
      "rows": [
        ".........p--............",
        "..........--]]]]]]]]]]].",
        "........%%--??????????].",
        "........%#o*###ooo##??].",
        ".......%%#Ə |H    s#??].",
        ".###oo####L |H ll x#??].",
        ".#@¤II|b//  |H ll s#??].",
        ".o@   +            #?G].",
        ".o    |y      aa   ¶?K].",
        ".#|+|||||   ||||y  o?K].",
        ".#d  |  +   | q|   #?G].",
        ".#d D|UU|R  + q|RRR#]]].",
        ".#|||||||R  |||||||#^...",
        ".oS¨t|ZW|R   ,,h,h=#....",
        ".#9¨8|  +    ,hfff,o....",
        ".#|+|||||    ,,fffho..[.",
        "^#d DD  +    ,,h,h,#....",
        ".od     ||+||,,,,,=#....",
        ".o  @@  |B¨8|˙˙||||#....",
        ".#T¤@@¤T|B¨8|1˙66JJo....",
        ".###oo###¨¨¨|3˙˙˙˙˙o....",
        "........#tSY|47F5O2#..[.",
        "..[.....###o####oo##....",
        "........................"
      ],
      "terrain": {
        "#": "t_adobe_brick_wall",
        "?": "t_floor_noroof",
        "]": "t_railing_v",
        "G": "t_floor_noroof",
        "K": "t_floor_noroof",
        "Y": { "param": "linoleum_color_bathroom", "fallback": "t_linoleum_white" },
        ",": "t_carpet_red",
        "f": "t_carpet_red",
        "=": "t_carpet_red",
        "h": "t_carpet_red"
      },
      "furniture": { "=": [ "f_indoor_plant", "f_indoor_plant_y" ], "/": "f_rack" },
      "items": { "/": { "item": "clothing_outdoor_shoes", "chance": 40, "repeat": [ 1, 2 ] } },
      "place_loot": [
        { "item": "television", "x": 18, "y": 5 },
        { "group": "child_items", "x": [ 2, 6 ], "y": [ 7, 8 ], "chance": 60, "repeat": [ 3, 4 ] }
      ],
      "place_nested": [ { "chunks": [ "NC_res_frontlawn_3X3" ], "x": 2, "y": 1 } ]
    }
  },
  {
    "type": "mapgen",
    "om_terrain": "bungalow11_roof",
    "method": "json",
    "object": {
      "palettes": [ "roof_palette" ],
      "fill_ter": "t_shingle_flat_roof",
      "rows": [
        "........................",
        "........................",
        "........................",
        ".........-----------....",
        ".........-,,,,,,,,,-....",
        ".---------,,,,,,,,,-....",
        ".-,,,,,,,,,,,,,,,,,-....",
        ".-,,,,,,,,,,,,,,,,,-....",
        ".-,,,,,,,,,,,,~~,,,-....",
        ".-,,N,,,,,,,,,,,,,,-....",
        ".-,,,,,,,,,,,,,,,,,-....",
        ".-,,,,,,,,,,,,,,,,,-....",
        ".-,,,,,,,,,,,,,,,,,5....",
        ".-,,,,,,,,,,,,,,,,,-....",
        ".-,,,,,,,,,,,,,,,,,-....",
        ".-,,,,,,,,,,,,,,,,,-....",
        ".5,,,,,,,,,,,,,,,,,-....",
        ".-,,,,,,,,=,,,,,,,,-....",
        ".-,,,,,,,,,,,,,,,,,-....",
        ".-,,,,,,,,,,,,,,,,,-....",
        ".--------,,,,,,,,,,-....",
        "........-,,,,,,,,,,-....",
        "........------------....",
        "........................"
      ],
      "terrain": {
        ".": "t_open_air",
        "=": "t_shingle_flat_roof",
        "N": "t_shingle_flat_roof",
        "~": "t_shingle_flat_roof",
        ",": "t_shingle_flat_roof"
      },
      "place_nested": [
        { "chunks": [ "NC_res_roof_solar_4X4" ], "x": 13, "y": 13 },
        { "chunks": [ "NC_res_roof_chunk_3X3" ], "x": [ 6, 10 ], "y": [ 7, 10 ] }
      ]
    }
  }
]
