[
  {
    "type": "mapgen",
    "om_terrain": "bungalow09",
    "method": "json",
    "object": {
      "palettes": [
        "standard_domestic_palette",
        "standard_domestic_lino_kitchen",
        "standard_domestic_lino_bathroom",
        "standard_domestic_landscaping_palette"
      ],
      "fill_ter": "t_floor",
      "rows": [
        "..........-----p........",
        "...[....???```???.[...[.",
        "..!!!!!!?```````?!!!!!..",
        "..###o###````₸K₸##o###..",
        "..#Db  ¤####*oo##r  R#..",
        "..o   @@|Ly))HHH|rh R#..",
        "..#d  @@|x ))))H|P  R#..",
        "..#ɸ    |x ))l)H|||¶|#..",
        "..#||||+|V ))l)HT   y#..",
        "..#8BB|    ))))s   h o..",
        "..#8((+           ffh#..",
        "..oS(Q|     h    hff #..",
        "..#t(w|b   rrrRR   h o..",
        "..#|||||+|+||||||(JJJ#..",
        ".^#IIID  | ddD|Z+(((3#^.",
        "..#      |    |W+(((O#..",
        "..o     d|  @@|||F((1o..",
        "..# @@  d|  @@|6+(((5#..",
        "..#¤@@¤ y|y  ¤|6+((42#..",
        "..##o##o###o######*o##..",
        "...............`````₸?..",
        "................?``₸K?..",
        "................??????..",
        "........................"
      ],
      "terrain": {
        "?": "t_railing_v",
        "K": "t_concrete",
        "₸": "t_concrete",
        "(": "t_linoleum_gray",
        "W": "t_linoleum_gray",
        "Z": "t_linoleum_gray",
        ")": "t_carpet_yellow",
        "H": "t_carpet_yellow",
        "l": "t_carpet_yellow",
        "s": "t_carpet_yellow"
      },
      "place_loot": [ { "item": "laptop", "x": 17, "y": 5, "chance": 100 }, { "item": "television", "x": 9, "y": 7, "chance": 100 } ],
      "place_nested": [ { "chunks": [ "NC_res_backyard_3X3" ], "x": 8, "y": 20 } ]
    }
  },
  {
    "type": "mapgen",
    "om_terrain": "bungalow09_roof",
    "method": "json",
    "object": {
      "palettes": [ "roof_palette" ],
      "fill_ter": "t_shingle_flat_roof",
      "rows": [
        "````````````````````````",
        "````````````````````````",
        "````````````````````````",
        "``-------```````------``",
        "``-.....---------....-``",
        "``-..................-``",
        "``-..................-``",
        "``-..................-``",
        "``-...N..............-``",
        "``-..................-``",
        "``-..................-``",
        "``-..................-``",
        "``-..................-``",
        "``-..................-``",
        "``5..................5``",
        "``-..................-``",
        "``-..................-``",
        "``-..................-``",
        "``-..................-``",
        "``--------------------``",
        "````````````````````````",
        "````````````````````````",
        "````````````````````````",
        "````````````````````````"
      ],
      "terrain": { "`": "t_open_air", ".": "t_shingle_flat_roof" },
      "place_nested": [
        { "chunks": [ "NC_res_roof_solar_4X4" ], "x": [ 7, 16 ], "y": [ 10, 14 ] },
        { "chunks": [ "NC_res_roof_chunk_3X3" ], "x": [ 3, 16 ], "y": 5 }
      ]
    }
  }
]
