[
  {
    "type": "mapgen",
    "om_terrain": "house_fence08_basement",
    "method": "json",
    "object": {
      "palettes": [ "standard_domestic_palette", "standard_domestic_basement_palette" ],
      "fill_ter": "t_thconc_floor",
      "rows": [
        "^^^^^^^^^^^^^^^^^^^^^^^^",
        "^^^^^^^^^^^^^^^^^^^^^^^^",
        "^^^^^^^^^^^^^^^^^^^^^^^^",
        "^^^^^^^^^^^^^^^^^^^^^^^^",
        "^^###############^^^^^^^",
        "^^#    NN       #^^^^^^^",
        "^^#             #^^^^^^^",
        "^^#           zz#^^^^^^^",
        "^^#          zzz#^^^^^^^",
        "^^#  #       ####^^^^^^^",
        "^^#          #  #^^^^^^^",
        "^^#          # !#^^^^^^^",
        "^^#          +  #^^^^^^^",
        "^^#U        q# g#^^^^^^^",
        "^^#U        q#  #^^^^^^^",
        "^^#         q#  #^^^^^^^",
        "^^#  #T      ####^^^^^^^",
        "^^#             #^^^^^^^",
        "^^#             #^^^^^^^",
        "^^#%#+#         #^^^^^^^",
        "^^#$#<#S W Z    #^^^^^^^",
        "^^###############^^^^^^^",
        "^^^^^^^^^^^^^^^^^^^^^^^^",
        "^^^^^^^^^^^^^^^^^^^^^^^^"
      ],
      "furniture": { "!": "f_home_furnace", "$": "f_glass_cabinet", "%": "f_armchair" }
    }
  },
  {
    "type": "mapgen",
    "om_terrain": "house_fence08_1",
    "method": "json",
    "object": {
      "palettes": [
        "standard_domestic_palette",
        "standard_domestic_lino_kitchen",
        "standard_domestic_lino_bathroom",
        "standard_domestic_landscaping_palette"
      ],
      "fill_ter": "t_floor",
      "rows": [
        "{{{{{{{{{{{{{{{{{______{",
        "{.............[.{______{",
        "{...!!!(((((-0..p______{",
        "{...!!!(    -.0..______{",
        "{.##o###o*###o##.______{",
        "{.#sHHHl``|II d#-______{",
        "{.#E``````|h  d#<______{",
        "{.#l```T``+   y##______{",
        "{.#$`x````|    @#______{",
        "{.o$$`````|Dɸ ¤@#______{",
        "{.#|||||  ||||||#______{",
        "{^#Qw|q+  3766FJ#______{",
        "{.#++|||  ,,,,,1o______{",
        "{.#  RRR  ,YJJ,O#______{",
        "{.o       ,,,A,5#______{",
        "{.#||+||+||,,,,,#______{",
        "{.#S,,|¤ d|z,/ff#______{",
        "{.o8,B|@  |z,,ffo....!!{",
        "{.#t,B|@ D|Ə,,,/#....![{",
        "{.######o##o*o###....!!{",
        "{.^0#>*-0.0---.........{",
        "{.00###-0..............{",
        "{......................{",
        "{{{{{{{{{{{{{{{{{{{{{{{{"
      ],
      "terrain": {
        "{": "t_privacy_fence",
        ",": "t_linoleum_gray",
        "0": "t_dirt",
        "!": "t_dirtmound",
        "K": "t_region_groundcover_urban",
        "G": "t_region_groundcover_urban",
        "A": "t_linoleum_gray",
        "Y": "t_linoleum_gray",
        "z": "t_linoleum_gray",
        "/": "t_linoleum_gray",
        "f": "t_linoleum_gray",
        "`": "t_carpet_red",
        "T": "t_carpet_red",
        "l": "t_carpet_red",
        "H": "t_carpet_red",
        "x": "t_carpet_red",
        "$": "t_carpet_red",
        "E": "t_carpet_red",
        "s": "t_carpet_red",
        "(": "t_railing"
      },
      "furniture": { "/": "f_chair", "$": [ "f_indoor_plant", "f_indoor_plant_y" ] },
      "place_loot": [ { "item": "television", "x": 5, "y": 8, "chance": 100 } ],
      "place_vehicles": [
        { "vehicle": "car_hatch", "x": 20, "y": 14, "chance": 15, "fuel": 80, "rotation": 90 },
        { "vehicle": "pickup", "x": 21, "y": 7, "chance": 15, "fuel": 80, "rotation": 90 }
      ],
      "place_nested": [ { "chunks": [ "NC_res_backyard_3X3" ], "x": 20, "y": 20 } ]
    }
  },
  {
    "type": "mapgen",
    "om_terrain": "house_fence08_2",
    "method": "json",
    "object": {
      "palettes": [ "standard_domestic_palette", "standard_domestic_lino_kitchen", "standard_domestic_lino_bathroom" ],
      "fill_ter": "t_floor",
      "rows": [
        "........................",
        "........................",
        ".......!!!!!............",
        ".......!!!!!............",
        "..##o###oo###o##........",
        "..#¤@@|yllE JJJ#........",
        "..o @@|H    ,,O#>.......",
        "..#   |H    ,,5#*#......",
        "..odd +     321| #......",
        "..#||||  h     * o......",
        ".^#S,,+  ff   y| #......",
        "..#t,9| hffh RR| #......",
        "..#||||||||||||| #......",
        "..#S,9#RRhfh   * o......",
        "..#t,,+   f  bL| #......",
        "..#|||||z   321| #......",
        "..od rr|lll ,,5|z#......",
        "..#@   +    ,,J|zo......",
        "..#@¤TD|HHHTFJO|U#......",
        "..###o#####o######......",
        "...^!!!.................",
        "....!!!.................",
        "........................",
        "........................"
      ],
      "terrain": { ",": "t_linoleum_gray", "!": "t_shingle_flat_roof", ".": "t_open_air" },
      "place_loot": [ { "item": "laptop", "x": 6, "y": 16, "chance": 50 } ]
    }
  },
  {
    "type": "mapgen",
    "om_terrain": "house_fence08_roof",
    "method": "json",
    "object": {
      "palettes": [ "roof_palette" ],
      "fill_ter": "t_shingle_flat_roof",
      "rows": [
        "                        ",
        "                        ",
        "                        ",
        "                        ",
        "  --------------        ",
        "  -............-        ",
        "  -............-        ",
        "  -............---      ",
        "  -....=.........-      ",
        "  -..............-      ",
        "  5..............-      ",
        "  -..............-      ",
        "  -..............-      ",
        "  -..............-      ",
        "  -..............-      ",
        "  -..X........N..-      ",
        "  -..............-      ",
        "  -..............-      ",
        "  -..............-      ",
        "  -5--------------      ",
        "                        ",
        "                        ",
        "                        ",
        "                        "
      ],
      "terrain": { ".": "t_shingle_flat_roof" },
      "place_nested": [
        { "chunks": [ "NC_res_roof_solar_4X4" ], "x": 11, "y": 9 },
        { "chunks": [ "NC_res_roof_chunk_3X3" ], "x": [ 3, 9 ], "y": 5 }
      ]
    }
  }
]
