[
  {
    "method": "json",
    "om_terrain": "house_22ab",
    "type": "mapgen",
    "weight": 20,
    "object": {
      "fill_ter": "t_floor",
      "rows": [
        "_________________d______",
        "_d______________________",
        "____dd___d________d_____",
        "_||ww||__7____||----||__",
        "_|....|___d___|......|_d",
        "_|....|_______|......|__",
        "_|....|_______|......|__",
        "_|....||www|+||%.%%%%|__",
        "_|....%...........%..|__",
        "_|....%..............|__",
        "_|................%..|__",
        "_|..............%%%%%|__",
        "_|....%.........%....|__",
        "_|....%.........%....w_d",
        "_|%%%%%%........%....w__",
        "d|.....%.............|__",
        "_|..............#####|__",
        "_w.....%.............|__",
        "_w.....%%.%%%...#....w__",
        "_|.....%....#...#....w__",
        "_|.....%....#...#....|__",
        "_||www||||||||||||||||__",
        "__d___d________d________",
        "________________d__d____"
      ],
      "terrain": {
        "#": "t_wall_half_domestic",
        "+": "t_door_metal_c_peep",
        "-": "t_wall_glass",
        ".": "t_floor",
        "7": "t_tree",
        "_": "t_grass",
        "d": "t_dirt",
        "w": "t_window",
        "|": "t_brick_wall",
        "%": "t_wall_w"
      },
      "place_items": [
        { "chance": 20, "item": "tools_construction", "x": 8, "y": 17 },
        { "chance": 20, "item": "tools_construction", "x": 15, "y": 14 },
        { "chance": 15, "item": "hardware", "x": 5, "y": 13 },
        { "chance": 15, "item": "hardware", "x": 3, "y": 13 },
        { "chance": 15, "item": "hardware", "x": 2, "y": 11 },
        { "chance": 15, "item": "hardware", "x": 19, "y": 10 },
        { "chance": 25, "item": "hardware_trash", "x": 17, "y": 10 }
      ],
      "place_vehicles": [ { "vehicle": "os_work_vehicles", "chance": 40, "x": [ 9, 13 ], "y": [ 10, 15 ] } ]
    }
  },
  {
    "method": "json",
    "om_terrain": "house_22ab",
    "type": "mapgen",
    "weight": 40,
    "object": {
      "fill_ter": "t_floor",
      "rows": [
        "__________P_s____d______",
        "_d__________s___________",
        "____dd___d__s_____d_____",
        "_||ww||__7_#s#||----||__",
        "_|....|___d#s#|......|_d",
        "_|....|____#s#|......|__",
        "_|....|____#s#|......|__",
        "_|c...||www|+||%D%%%%|__",
        "_|c...%...........%.&|__",
        "_|c...%...........D..|__",
        "_|c...............%S.|__",
        "_|..............%%%%%|__",
        "_|....%.........%....|__",
        "_|....%.........%....w_d",
        "_|%%%%%%........%....w__",
        "d|.....%........D....|__",
        "_|.....D........%%%%%|__",
        "_w.....%........D....|__",
        "_w.....%%D%%%...%....w__",
        "_|.....%S...%...%....w__",
        "_|.....%...&%...%....|__",
        "_||www||||||||||||||||__",
        "__d___d________d________",
        "________________d__d____"
      ],
      "terrain": {
        "#": "t_shrub",
        "&": "t_floor",
        "+": "t_door_metal_c_peep",
        "-": "t_wall_glass",
        ".": "t_floor",
        "7": "t_tree",
        "D": "t_door_o",
        "P": "t_grass",
        "S": "t_floor",
        "_": "t_grass",
        "c": "t_floor",
        "d": "t_dirt",
        "s": "t_sidewalk",
        "w": "t_window_domestic",
        "|": "t_brick_wall",
        "%": "t_wall_w"
      },
      "furniture": { "&": "f_toilet", "P": "f_mailbox", "S": "f_sink", "c": "f_counter" },
      "place_items": [
        { "chance": 20, "item": "hardware_bulk", "x": 10, "y": 17 },
        { "chance": 20, "item": "hardware_bulk", "x": 11, "y": 17 },
        { "chance": 20, "item": "hardware_bulk", "x": 15, "y": 13 },
        { "chance": 20, "item": "hardware_bulk", "x": 15, "y": 14 },
        { "chance": 20, "item": "hardware_bulk", "x": 15, "y": 5 },
        { "chance": 20, "item": "hardware_bulk", "x": 15, "y": 6 },
        { "chance": 40, "item": "paint", "x": 19, "y": 17 },
        { "chance": 40, "item": "paint", "x": 20, "y": 17 },
        { "chance": 40, "item": "paint", "x": 19, "y": 15 },
        { "chance": 40, "item": "paint", "x": 2, "y": 15 },
        { "chance": 40, "item": "paint", "x": 3, "y": 15 },
        { "chance": 40, "item": "paint", "x": 4, "y": 15 },
        { "chance": 15, "item": "hand_tools", "x": 17, "y": 19 },
        { "chance": 25, "item": "hand_tools", "x": 6, "y": 18 },
        { "chance": 25, "item": "hardware_trash", "x": 14, "y": 20 },
        { "chance": 25, "item": "hardware_trash", "x": 16, "y": 10 }
      ],
      "place_vehicles": [ { "vehicle": "os_work_vehicles", "chance": 40, "x": [ 9, 13 ], "y": [ 10, 15 ] } ]
    }
  }
]
