[
  {
    "method": "json",
    "om_terrain": "house_22",
    "//": "normal variant",
    "type": "mapgen",
    "weight": 100,
    "object": {
      "fill_ter": "t_floor",
      "rows": [
        "..........p.`...........",
        "............`...........",
        "..%%%%......`...%%%%....",
        ".##oo##..[.%`%##]]]]##..",
        ".#hffy#....%`%#R yy r#..",
        ".#  h #....%`%#R   hr#..",
        ".#    #!jj!%`%#y P  T#..",
        ".#J   ##ooo#*##|+||||#..",
        ".#J  6|HHHHs  L  y|8t#..",
        ".#J  6|H l        +--#..",
        ".#2              M|S9#..",
        ".#1     EsE     |||||#..",
        ".#O  4|        y|DETR#..",
        ".#357F|   hfh  r|   Eo..",
        ".#||||||  hfh  r|d   o..",
        "^# dMdy|  hfh   +  @@#^.",
        ".#s    +        |||||#..",
        ".o@@   |   y    +   Y#..",
        ".o@@   ||+|||T  |d   o..",
        ".#s  E |S--B||| |d  Io..",
        ".#T IIy|8btB|vU>|y @@#..",
        ".##ooo################..",
        "........................",
        "........................"
      ],
      "palettes": [ "standard_domestic_palette" ],
      "terrain": {
        "%": [ "t_region_shrub", "t_region_shrub_fruit", "t_region_shrub_decorative" ],
        "[": [ [ "t_region_tree_fruit", 2 ], [ "t_region_tree_nut", 2 ], "t_region_tree_shade" ],
        "!": "t_region_groundcover_urban",
        "`": "t_concrete",
        "]": "t_wall_glass",
        "-": "t_linoleum_white",
        "Q": "t_linoleum_white",
        "8": "t_linoleum_white",
        "B": "t_linoleum_white",
        "S": "t_linoleum_white",
        "9": "t_linoleum_white",
        "b": "t_linoleum_white",
        "t": "t_linoleum_white"
      },
      "furniture": { "!": "f_region_flower" }
    }
  },
  {
    "type": "mapgen",
    "method": "json",
    "om_terrain": "house_22_roof",
    "object": {
      "fill_ter": "t_shingle_flat_roof",
      "rows": [
        "                        ",
        "                        ",
        "                        ",
        " ------       --------  ",
        " -....-       -......-  ",
        " -....-       -......-  ",
        " -....-       -......-  ",
        " -....---------...N..-  ",
        " -...................-  ",
        " -...................-  ",
        " -...................-  ",
        " -......=......&.....-  ",
        " -...................-  ",
        " -...................-  ",
        " -...................-  ",
        " 5...................5  ",
        " -...................-  ",
        " -...................-  ",
        " -...................-  ",
        " -...................-  ",
        " -...................-  ",
        " ---------------------  ",
        "                        ",
        "                        "
      ],
      "palettes": [ "roof_palette" ],
      "terrain": { ".": "t_shingle_flat_roof" }
    }
  },
  {
    "type": "mapgen",
    "method": "json",
    "om_terrain": "house_22_basement",
    "object": {
      "fill_ter": "t_thconc_floor",
      "rows": [
        "                        ",
        "                        ",
        "                        ",
        " ||||||       ||||||||  ",
        " |.U..|       |2.....|  ",
        " |F..g|       |......|  ",
        " |....|       |......|  ",
        " |%%+%|||||||||......|  ",
        " |...................|  ",
        " |1..................|  ",
        " |...................|  ",
        " |...................|  ",
        " |...................|  ",
        " |...................|  ",
        " |...................|  ",
        " |...................|  ",
        " |...................|  ",
        " |...................|  ",
        " |............%.....U|  ",
        " |............%.....Z|  ",
        " |............%<..WJJ|  ",
        " |||||||||||||||||||||  ",
        "                        ",
        "                        "
      ],
      "palettes": [ "basement_empty" ],
      "nested": {
        "1": { "chunks": [ [ "null", 25 ], [ "recroom_12x12", 25 ], [ "tvroom_12x12", 25 ], [ "workoutroom_12x12", 25 ] ] },
        "2": {
          "chunks": [
            [ "null", 40 ],
            [ "room_6x6_woodworker", 20 ],
            [ "room_6x6_bike", 20 ],
            [ "livingroom_5x5_S_1", 10 ],
            [ "livingroom_5x5_E_1", 10 ],
            [ "livingroom_5x5_N_1", 10 ],
            [ "livingroom_5x5_W_1", 10 ],
            [ "livingroom_5x5_S_2", 10 ],
            [ "livingroom_5x5_E_2", 10 ],
            [ "livingroom_5x5_N_2", 10 ],
            [ "livingroom_5x5_W_2", 10 ],
            [ "home_office_4x4_N", 10 ],
            [ "home_office_4x4_S", 10 ]
          ]
        }
      }
    }
  }
]
