[
  {
    "method": "json",
    "om_terrain": "house_duplex6",
    "type": "mapgen",
    "weight": 200,
    "object": {
      "fill_ter": "t_floor",
      "rows": [
        "....`..............`....",
        ".[..````````````````....",
        "...p`!!!`jj``jj`!!!`p...",
        "..##*###oo###oo####*##..",
        "..#˙˙1235O4|d  D|U| L#..",
        "..o˙˙˙˙˙˙˙F|@@ y|+|  o%.",
        ".%#6˙˙YJJJ7|@@  |    #%.",
        "..#6˙˙˙AA||||||+|   y#..",
        ".%o  hh  +¨t|c      Ro..",
        "..#  ffh |S9|       R#..",
        ".##  h   ||||  s     ##.",
        ".oi       y|a  E     io.",
        ".oi    H  x|R  E     io.",
        ".oi    Hl a|Rc s     io.",
        ".##    H  x||||  hh  ##.",
        ".^# ee s   |9t|  ffh #^.",
        ".%o ee   yR|S¨+  h   o%.",
        "..# ee |+||||||˙˙˙˙˙6#..",
        "..#    |   D|12˙˙JA˙6#%.",
        "..oL |+| @@ |F˙˙˙JA˙˙o..",
        "..#y |U|s@@d|3O547˙˙Y#..",
        "..##*####oo###oo###*##..",
        "...```[.....u.....```...",
        "..[............[........"
      ],
      "palettes": [
        "standard_domestic_palette",
        "parameterized_linoleum_color_kitchen",
        "parameterized_linoleum_color_bathroom",
        "standard_domestic_landscaping_palette"
      ],
      "terrain": {
        "Y": { "param": "linoleum_color_kitchen", "fallback": "t_linoleum_white" },
        "A": { "param": "linoleum_color_kitchen", "fallback": "t_linoleum_white" },
        "j": "t_concrete",
        "#": "t_adobe_brick_wall"
      },
      "place_items": [ { "chance": 40, "item": "bags_trip", "x": 6, "y": 20 } ],
      "place_item": [
        { "item": "television", "x": 10, "y": 12 },
        { "item": "pillow", "chance": 30, "repeat": 3, "x": 2, "y": [ 11, 13 ] },
        { "item": "pillow", "chance": 30, "repeat": 3, "x": 21, "y": [ 11, 13 ] }
      ]
    }
  },
  {
    "type": "mapgen",
    "method": "json",
    "om_terrain": "house_duplex6_roof",
    "object": {
      "fill_ter": "t_shingle_flat_roof",
      "rows": [
        "                        ",
        "                        ",
        "                        ",
        "  --------------------  ",
        "  -..................-  ",
        "  -..................-  ",
        "  -.........N........-  ",
        "  -..................-  ",
        "  -..................-  ",
        "  -....=.............-  ",
        " --..................-- ",
        " -.......X..~.........- ",
        " -....................- ",
        " -........~...........- ",
        " -5.....&......&.....5- ",
        "  -..................-  ",
        "  -..................-  ",
        "  -.............=....-  ",
        "  -..................-  ",
        "  -..................-  ",
        "  -..................-  ",
        "  --------------------  ",
        "                        ",
        "                        "
      ],
      "palettes": [ "roof_palette" ],
      "terrain": { ".": "t_shingle_flat_roof" }
    }
  }
]
