[
  {
    "method": "json",
    "om_terrain": "duplex",
    "type": "mapgen",
    "weight": 200,
    "object": {
      "fill_ter": "t_floor",
      "rows": [
        ".......``%!!!!%``.......",
        "...[...``%!X!!%``.......",
        "`````````%!!!!%`````````",
        "`.%!!!%``p....p``%!!!%.`",
        "`.#####``######``#####.`",
        "`^#@@D#``#U|U #``#@dD#^`",
        "`%# hI#o*#+||+#*o#@  #%`",
        "`%#d I|L x |y H L|  Io.`",
        "`.oy  +    |x H  + hI#!`",
        "`.#||||| HH|    |||||#.`",
        "`!#Q8St|  h|h  y|S8tQ#.`",
        "`!o¨¨¨¨+  f|fh  +¨¨¨¨o!`",
        "`!#9||||  h||Y 4||||9#.`",
        "`.#||Dd|   6|6 7|dD||#.`",
        "`.#    +   2|3  +   E#!`",
        "`.o@@  |J  1|1 J|  @@o!`",
        "`.#@@sT|JA F|F J|bs@@#.`",
        "`.##o####Y O|O ####o##.`",
        "````````+  5|5 +````````",
        "......``##o###o#``......",
        "...........^........[...",
        "......[.....[...........",
        ".[......................",
        "........................"
      ],
      "palettes": [ "standard_domestic_palette", "parameterized_linoleum_color_bathroom", "standard_domestic_landscaping_palette" ],
      "place_item": [ { "item": "television", "x": 9, "y": 7 }, { "item": "stereo", "x": 12, "y": 8 } ],
      "place_items": [
        { "chance": 40, "item": "nightstand", "x": 18, "y": 16 },
        { "chance": 40, "item": "nightstand", "x": 5, "y": 16 },
        { "chance": 20, "item": "sports", "x": 13, "y": 5 },
        { "chance": 40, "item": "camping", "x": 12, "y": 5 },
        { "chance": 30, "item": "child_items", "x": 17, "y": 10 },
        { "chance": 30, "item": "child_items", "x": 5, "y": 10 },
        { "chance": 30, "item": "child_items", "x": 6, "y": 10 }
      ]
    }
  },
  {
    "type": "mapgen",
    "method": "json",
    "om_terrain": "duplex_roof",
    "object": {
      "fill_ter": "t_shingle_flat_roof",
      "rows": [
        "                        ",
        "                        ",
        "                        ",
        "                        ",
        "  -----  ------  -----  ",
        "  5...-  -....-  -...5  ",
        "  -...----....----...-  ",
        "  -..................-  ",
        "  -..................-  ",
        "  -..................-  ",
        "  -..................-  ",
        "  -..................-  ",
        "  -..................-  ",
        "  -..................-  ",
        "  -..................-  ",
        "  -..................-  ",
        "  -..................-  ",
        "  -------......-------  ",
        "        -......-        ",
        "        ---5----        ",
        "                        ",
        "                        ",
        "                        ",
        "                        "
      ],
      "palettes": [ "roof_palette" ],
      "terrain": { ".": "t_shingle_flat_roof" }
    }
  }
]
