[
  {
    "//": "Bsmt - 1: unfinished ",
    "type": "mapgen",
    "om_terrain": "house_coop01_basement",
    "weight": 50,
    "method": "json",
    "object": {
      "palettes": [ "standard_domestic_palette", "standard_domestic_basement_palette" ],
      "fill_ter": "t_thconc_floor",
      "rows": [
        "^^^^^^^^^^^^^^^^^^^^^^^^",
        "^^^^^^^^^^^^^^^^^^^^^^^^",
        "^^^^^^^^^^^^^^^^^^^^^^^^",
        "^^^^^^^^^^^^^^^^^^^^^^^^",
        "^^####################^^",
        "^^#zzzz     g  !    b#^^",
        "^^#zzz               #^^",
        "^^#zz  #        #    #^^",
        "^^#                UU#^^",
        "^^#                 N#^^",
        "^^#<                N#^^",
        "^^#              T  q#^^",
        "^^#W   #        #   q#^^",
        "^^#                  #^^",
        "^^#Z S               #^^",
        "^^####################^^",
        "^^^^^^^^^^^^^^^^^^^^^^^^",
        "^^^^^^^^^^^^^^^^^^^^^^^^",
        "^^^^^^^^^^^^^^^^^^^^^^^^",
        "^^^^^^^^^^^^^^^^^^^^^^^^",
        "^^^^^^^^^^^^^^^^^^^^^^^^",
        "^^^^^^^^^^^^^^^^^^^^^^^^",
        "^^^^^^^^^^^^^^^^^^^^^^^^",
        "^^^^^^^^^^^^^^^^^^^^^^^^"
      ],
      "furniture": { "!": "f_home_furnace" }
    }
  },
  {
    "//": "Bsmt - 2: finished ",
    "type": "mapgen",
    "om_terrain": "house_coop01_basement",
    "weight": 50,
    "method": "json",
    "object": {
      "palettes": [ "standard_domestic_palette", "standard_domestic_basement_palette" ],
      "fill_ter": "t_floor",
      "rows": [
        "^^^^^^^^^^^^^^^^^^^^^^^^",
        "^^^^^^^^^^^^^^^^^^^^^^^^",
        "^^^^^^^^^^^^^^^^^^^^^^^^",
        "^^^^^^^^^^^^^^^^^^^^^^^^",
        "^^||||||||||||||######^^",
        "^^|sHHH  iii   |zzNNN#^^",
        "^^|H           |z__A_#^^",
        "^^|H     eee   +_____#^^",
        "^^|H xx  eee  V|qqqUU#^^",
        "^^|           V|||||||^^",
        "^^|<          V|L   D|^^",
        "^^|||+||0,,    +     |^^",
        "^^#g__S|r,,    |d   T|^^",
        "^^#___Z|rh,    |d   ¤|^^",
        "^^#!__W|r,,RRRR|b  @@|^^",
        "^^#####|||||||||||||||^^",
        "^^^^^^^^^^^^^^^^^^^^^^^^",
        "^^^^^^^^^^^^^^^^^^^^^^^^",
        "^^^^^^^^^^^^^^^^^^^^^^^^",
        "^^^^^^^^^^^^^^^^^^^^^^^^",
        "^^^^^^^^^^^^^^^^^^^^^^^^",
        "^^^^^^^^^^^^^^^^^^^^^^^^",
        "^^^^^^^^^^^^^^^^^^^^^^^^",
        "^^^^^^^^^^^^^^^^^^^^^^^^"
      ],
      "furniture": { "!": "f_home_furnace", "0": "f_floor_lamp" },
      "terrain": {
        "_": "t_thconc_floor",
        "h": "t_carpet_yellow",
        "r": "t_carpet_yellow",
        "0": "t_carpet_yellow",
        "W": "t_thconc_floor",
        "Z": "t_thconc_floor",
        "S": "t_thconc_floor",
        "!": "t_thconc_floor",
        "g": "t_thconc_floor",
        ",": "t_carpet_yellow",
        "N": "t_thconc_floor",
        "U": "t_thconc_floor",
        "q": "t_thconc_floor",
        "A": "t_thconc_floor",
        "z": "t_thconc_floor"
      },
      "place_loot": [
        { "group": "clutter_bedroom", "x": [ 16, 20 ], "y": [ 10, 14 ], "chance": 50, "repeat": [ 2, 3 ] },
        { "item": "television", "x": 5, "y": 8 },
        { "item": "laptop", "x": 8, "y": 13 }
      ]
    }
  },
  {
    "type": "mapgen",
    "om_terrain": "house_coop01_1",
    "method": "json",
    "object": {
      "palettes": [
        "standard_domestic_palette",
        "standard_domestic_lino_kitchen",
        "standard_domestic_lino_bathroom",
        "standard_domestic_landscaping_palette"
      ],
      "fill_ter": "t_floor",
      "rows": [
        "........p!----!.........",
        ".[.......!----!.........",
        ".........!----!.........",
        "......jjj------.........",
        "..##oo####o*o#####oo##..",
        "..#@@¤ D|L  l H|  yɸ #..",
        "..o@@   |Ə  l H|@   do..",
        "..o     |V    H|@   do..",
        "..#ddy  |y HHHs|¤   D#..",
        "..#||||+|| ||||||+|||#..",
        ".^#>+        ƏƏ __Y66#^.",
        "..#|||+|R       _____#..",
        "..#888_|R   h   3____#..",
        "..#____|R   ff  2___Oo..",
        "..#tSBB|y  hffh 1F5JJ#..",
        "..##o#####*#oo####oo##..",
        ".........---............",
        ".........---............",
        "..............{{{{{)))).",
        "............../````)?,).",
        "..[...........{````~,,).",
        "..............{````),?).",
        ".........[....{{{{{)))).",
        "........................"
      ],
      "terrain": {
        "#": "t_wall_r",
        "_": "t_linoleum_gray",
        "/": "t_chickenwire_gate_c",
        "{": "t_chickenwire_fence",
        ")": "t_wall_wood",
        ",": "t_dirt",
        "`": [ [ "t_dirt", 2 ], "t_region_groundcover_urban" ],
        "~": "t_door_makeshift_o",
        "?": "t_dirt",
        "Y": "t_linoleum_gray",
        "!": "t_dirtmound"
      },
      "monster": { "?": { "monster": "mon_chicken" } },
      "place_loot": [
        { "item": "straw_pile", "x": [ 20, 21 ], "y": [ 19, 21 ], "chance": 75, "repeat": [ 3, 5 ] },
        { "item": "birdfood", "x": [ 15, 18 ], "y": [ 19, 21 ], "chance": 50, "repeat": [ 2, 3 ] }
      ],
      "place_nested": [ { "chunks": [ "NC_res_frontlawn_3X3" ], "x": 19, "y": 1 }, { "chunks": [ "NC_res_backyard_3X3" ], "x": 5, "y": 17 } ]
    }
  },
  {
    "type": "mapgen",
    "om_terrain": "house_coop01_roof",
    "weight": 250,
    "method": "json",
    "object": {
      "palettes": [ "roof_palette" ],
      "fill_ter": "t_shingle_flat_roof",
      "rows": [
        "                        ",
        "                        ",
        "                        ",
        "                        ",
        "  --------------------  ",
        "  -..................-  ",
        "  -..................-  ",
        "  -..................-  ",
        "  -..................-  ",
        "  -..................-  ",
        "  5..................5  ",
        "  -..................-  ",
        "  -...............=..-  ",
        "  -....N.............-  ",
        "  -..................-  ",
        "  --------------------  ",
        "                        ",
        "                        ",
        "                   .... ",
        "                   .... ",
        "                   .... ",
        "                   .... ",
        "                   .... ",
        "                        "
      ],
      "terrain": { ".": "t_shingle_flat_roof" },
      "place_nested": [
        { "chunks": [ "NC_res_roof_solar_4X4" ], "x": 16, "y": 7 },
        { "chunks": [ "NC_res_roof_chunk_3X3" ], "x": [ 3, 12 ], "y": [ 5, 8 ] }
      ]
    }
  }
]
