[
  {
    "type": "mapgen",
    "om_terrain": "house_fence06_basement",
    "weight": 50,
    "method": "json",
    "object": {
      "palettes": [ "standard_domestic_palette", "standard_domestic_basement_palette" ],
      "fill_ter": "t_thconc_floor",
      "rows": [
        "^^^^^^^^^^^^^^^^^^^^^^^^",
        "^^^^^^^^^^^^^^^^^^^^^^^^",
        "^^^^^^^^^^^^^^^^^^^^^^^^",
        "^^^^^^^^^^^^^^^^^^^^^^^^",
        "^^^^^^^^^^^^^^^^^^^^^^^^",
        "^^^^^^^^^^^^^^^^^^^^^^^^",
        "^^^^^^^^^^^^^^^^^^^^^^^^",
        "^^^^^^^^^^^^^^^^^^^^^^^^",
        "^^^^^^^^########^^^^^^^^",
        "^^^^^^^^#<   zz#^^^^^^^^",
        "^^^^^^^^#    zz#^^^^^^^^",
        "^^^^#####      #####^^^^",
        "^^^^#NUU          W#^^^^",
        "^^^^#N  #      #  Z#^^^^",
        "^^^^#N             #^^^^",
        "^^^^#             S#^^^^",
        "^^^^#   b     zz   #^^^^",
        "^^^^#   #     z#   #^^^^",
        "^^^^#zz            #^^^^",
        "^^^^#&z   !  qq  g #^^^^",
        "^^^^################^^^^",
        "^^^^^^^^^^^^^^^^^^^^^^^^",
        "^^^^^^^^^^^^^^^^^^^^^^^^",
        "^^^^^^^^^^^^^^^^^^^^^^^^"
      ],
      "furniture": { "!": "f_home_furnace", "&": "f_mannequin" },
      "place_loot": [ { "item": "blanket", "x": 5, "y": 19, "chance": 100 } ]
    }
  },
  {
    "type": "mapgen",
    "om_terrain": "house_fence06_basement",
    "weight": 50,
    "method": "json",
    "object": {
      "palettes": [ "standard_domestic_palette", "standard_domestic_basement_palette" ],
      "fill_ter": "t_thconc_floor",
      "rows": [
        "^^^^^^^^^^^^^^^^^^^^^^^^",
        "^^^^^^^^^^^^^^^^^^^^^^^^",
        "^^^^^^^^^^^^^^^^^^^^^^^^",
        "^^^^^^^^^^^^^^^^^^^^^^^^",
        "^^^^^^^^^^^^^^^^^^^^^^^^",
        "^^^^^^^^^^^^^^^^^^^^^^^^",
        "^^^^^^^^^^^^^^^^^^^^^^^^",
        "^^^^^^^^^^^^^^^^^^^^^^^^",
        "^^^^^^^^########^^^^^^^^",
        "^^^^^^^^#<   ZW#^^^^^^^^",
        "^^^^^^^^#      #^^^^^^^^",
        "^^^^#####     S#####^^^^",
        "^^^^#zzzz       HHH#^^^^",
        "^^^^#zzz#      #%%?#^^^^",
        "^^^^#           bh?#^^^^",
        "^^^^#             h#^^^^",
        "^^^^#!   ====T=    #^^^^",
        "^^^^#   #======#   #^^^^",
        "^^^^#   q==A===U   #^^^^",
        "^^^^#g  q=NNNN=U zz#^^^^",
        "^^^^################^^^^",
        "^^^^^^^^^^^^^^^^^^^^^^^^",
        "^^^^^^^^^^^^^^^^^^^^^^^^",
        "^^^^^^^^^^^^^^^^^^^^^^^^"
      ],
      "terrain": { "=": "t_carpet_red", "A": "t_carpet_red", "N": "t_carpet_red", "T": "t_carpet_red" },
      "furniture": { "!": "f_home_furnace", "?": "f_coffee_table", "%": "f_dresser" }
    }
  },
  {
    "type": "mapgen",
    "om_terrain": "house_fence06_1",
    "method": "json",
    "object": {
      "palettes": [ "standard_domestic_palette", "standard_domestic_landscaping_palette" ],
      "fill_ter": "t_floor",
      "rows": [
        "{{{{{{{{{{{}}{{{{{{{{{{{",
        "{..........--....[.....{",
        "{........[.--..........{",
        "{[.........--..........{",
        "{..........--..........{",
        "{..........--..........{",
        "{....((((((==(((.......{",
        "{....(=========(.......{",
        "{....(==###o*###..[....{",
        "{....(==#>+  +<#.......{",
        "{....(==#||  ||#^......{",
        "{..^##oo#|L &|B#####...{",
        "{...#rrrP|$ y|B88 t#...{",
        "{...o h  +   +    So...{",
        "{...#||||||  ||||||#.[.{",
        "{...#H l xR       2#...{",
        "{...#H l xR   h|6 1#...{",
        "{...oH l xR  ff|6 5o...{",
        "{...os      hff|  Oo...{",
        "{.[.#yE k     h|FJJ#...{",
        "{...##o####o*o###o##...{",
        "{..........---.........{",
        "{......................{",
        "{{{{{{{{{{{{{{{{{{{{{{{{"
      ],
      "terrain": {
        "{": "t_privacy_fence",
        ",": "t_water_sh",
        "#": "t_rock_wall",
        "}": "t_privacy_fencegate_c",
        "=": "t_floor_noroof",
        "(": "t_railing_v"
      },
      "items": {
        "$": { "item": "clothing_outdoor_shoes", "chance": 40, "repeat": [ 1, 2 ] },
        "&": { "item": "table_foyer", "chance": 50 }
      },
      "place_loot": [ { "item": "laptop", "x": 6, "y": 12 }, { "item": "television", "x": 9, "y": 16 } ]
    }
  },
  {
    "type": "mapgen",
    "om_terrain": "house_fence06_2",
    "method": "json",
    "object": {
      "palettes": [ "standard_domestic_palette", "standard_domestic_lino_bathroom" ],
      "fill_ter": "t_floor",
      "rows": [
        "........................",
        "........................",
        "........................",
        "........................",
        "........................",
        "........................",
        "........................",
        "........................",
        "........###oo###........",
        "........#z+   >#^.......",
        "........#v+    o........",
        "....?^###||+||+###--....",
        "....-,#dd|b |r  b#,-....",
        "....-,#++|T |rh D#,-....",
        "....-,o     |r   o,-....",
        "....-,#    R||| ¤#,-....",
        "....-,#@@  R|d+ @#,-....",
        "....-,#@@¤ D|d+ @#,-....",
        "....-,##o######o##,-....",
        "....-,,,,,,,,,,,,,,-....",
        "....----------------....",
        "........................",
        "........................",
        "........................"
      ],
      "terrain": { "#": "t_rock_wall", ",": "t_shingle_flat_roof", ".": "t_open_air", "-": "t_gutter_south", "?": "t_gutter_drop" }
    }
  },
  {
    "type": "mapgen",
    "om_terrain": "house_fence06_roof",
    "method": "json",
    "object": {
      "palettes": [ "roof_palette" ],
      "fill_ter": "t_shingle_flat_roof",
      "rows": [
        "                        ",
        "                        ",
        "                        ",
        "                        ",
        "                        ",
        "                        ",
        "                        ",
        "                        ",
        "        --------        ",
        "        -......5        ",
        "        -......-        ",
        "      ---......---      ",
        "      -..........-      ",
        "      -..........-      ",
        "      -..........-      ",
        "      -..........-      ",
        "      -..........-      ",
        "      -..........-      ",
        "      ------------      ",
        "                        ",
        "                        ",
        "                        ",
        "                        ",
        "                        "
      ],
      "terrain": { ".": "t_shingle_flat_roof" }
    }
  }
]
