[
  {
    "method": "json",
    "om_terrain": "house_duplex2",
    "type": "mapgen",
    "weight": 200,
    "object": {
      "fill_ter": "t_floor",
      "rows": [
        "........`%%%%%%`........",
        ".````````%.[..%````````.",
        ".`..%%%p`%%%%%%`p.%%%.`.",
        ".`.##o##*##oo##*#####.`.",
        ".`.#15O2 |d@@D| L|St#.`.",
        ".`^#F    | @@ |  +¨¨#^`.",
        ".`.#3JJ 6|y   +  |89#.`.",
        ".`!# A  6||||||  |||#.`.",
        ".`!ofh  R|d@s|   xxx#.`.",
        ".`!oh   R| @ +      #.`.",
        ".`!#xxx  |IA |y  HHH#!`.",
        ".`.#     ||||||    ho!`.",
        ".`.#HHHs  +¨¨t|Y  hfo!`.",
        ".`.#|||| y|S89|6   4#!`.",
        ".`%#Ih + ||||||6   1#.`.",
        ".`%o @ | +   D|    F#.`.",
        ".`%#d@s| | @@ | 3O52#.`.",
        ".`.##o## |s@@d| ##o##.`.",
        ".`.%jj%#*##oo##*#%jj%.`.",
        ".`......`....^.`......`.",
        ".``````````````````````.",
        "...[....................",
        ".........[.......[......",
        "........................"
      ],
      "palettes": [ "standard_domestic_palette", "parameterized_linoleum_color_bathroom", "standard_domestic_landscaping_palette" ],
      "place_item": [
        { "item": "television", "repeat": 1, "x": 5, "y": 10 },
        { "item": "stereo", "repeat": 1, "x": 19, "y": 8 },
        { "item": "television", "repeat": 1, "x": 18, "y": 8 }
      ]
    }
  },
  {
    "type": "mapgen",
    "method": "json",
    "om_terrain": "house_duplex2_roof",
    "object": {
      "fill_ter": "t_shingle_flat_roof",
      "rows": [
        "                        ",
        "                        ",
        "                        ",
        "   ------------------   ",
        "   -................-   ",
        "   5................5   ",
        "   -..X........N....-   ",
        "   -................-   ",
        "   -................-   ",
        "   -................-   ",
        "   -................-   ",
        "   -..&..........&..-   ",
        "   -................-   ",
        "   -................-   ",
        "   -................-   ",
        "   -..=..........=..-   ",
        "   -................-   ",
        "   -----........-----   ",
        "       ------5---       ",
        "                        ",
        "                        ",
        "                        ",
        "                        ",
        "                        "
      ],
      "palettes": [ "roof_palette" ],
      "terrain": { ".": "t_shingle_flat_roof" }
    }
  }
]
