[
  {
    "type": "mapgen",
    "om_terrain": "house_fence05_basement",
    "method": "json",
    "object": {
      "palettes": [ "standard_domestic_palette", "standard_domestic_basement_palette" ],
      "fill_ter": "t_thconc_floor",
      "rows": [
        "^^^^^^^^^^^^^^^^^^^^^^^^",
        "^^^^^^^^^^^^^^^^^^^^^^^^",
        "^^^^^^^^^^^^^^^^^^^^^^^^",
        "^^^^^^^^^^^^^^^^^^^^^^^^",
        "^^^^^^^^^^^^^^^^^^^^^^^^",
        "^^^^^^^^^^^^^^^^^^^^^^^^",
        "^^^^^^#############^^^^^",
        "^^^^^^#   hhhh g !#^^^^^",
        "^^^^^^#           #^^^^^",
        "^^^^^^#           #^^^^^",
        "^^^^^^#z #   UU# Y#^^^^^",
        "^^^^^^#z         q#^^^^^",
        "^^^^^^#z         q#^^^^^",
        "^^^^^^#z        AN#^^^^^",
        "^^^^^^#b         N#^^^^^",
        "^^^^^^#  &&   z  T#^^^^^",
        "^^^^^^#  #&    #  #^^^^^",
        "^^^^^^#           #^^^^^",
        "^^^^^^#           #^^^^^",
        "^^^^^^#%  $ ZW   <#^^^^^",
        "^^^^^^#############^^^^^",
        "^^^^^^^^^^^^^^^^^^^^^^^^",
        "^^^^^^^^^^^^^^^^^^^^^^^^",
        "^^^^^^^^^^^^^^^^^^^^^^^^"
      ],
      "furniture": { "!": "f_home_furnace", "$": "f_sink", "%": "f_treadmill", "&": "f_clothing_rail" }
    }
  },
  {
    "type": "mapgen",
    "om_terrain": "house_fence05_1",
    "method": "json",
    "object": {
      "palettes": [
        "standard_domestic_palette",
        "standard_domestic_lino_kitchen",
        "standard_domestic_lino_bathroom",
        "standard_domestic_landscaping_palette"
      ],
      "fill_ter": "t_floor",
      "rows": [
        "{_____{{{{{{{{{{{{{{{{{{",
        "{_____{..jjj...........{",
        "{_____{.[..............{",
        "{_____{.........₸.K.₸[.{",
        "{_____(------..........{",
        "{_____{&&&&&-&&&.0000..{",
        "{_____##o#?o*?$$o$o$$..{",
        "{_____#JJ2|y=|sE   y$..{",
        "{_____o5/1|L |H  l yo..{",
        "{_____#O/F|Ə |H  l x$0.{",
        "{_____#6/4|  |H  l  $0.{",
        "{_____#y     |s    a$0.{",
        "{_____$  h   ||  |||$0.{",
        "{_____o  ff  |Ə  +//o..{",
        "{...p-o hffh    V|St$^.{",
        "{...$`$  h      V|||$..{",
        "{[..o *=   yb|  yRRR$..{",
        "{...$o$|||+|||      o..{",
        "{.-...$R  h P|++||+|$..{",
        "{$*$$.$RRrrrP|qQ|> <$..{",
        "{$,U$.$$$oo$$$$$$$o$$..{",
        "{$,Uo.......^..........{",
        "{$$$$..................{",
        "{{{{{{{{{{{{{{{{{{{{{{{{"
      ],
      "terrain": {
        "$": "t_wall_wood",
        "?": "t_wall_r",
        "#": "t_concrete_wall",
        "{": "t_privacy_fence",
        "(": "t_privacy_fencegate_c",
        "/": "t_linoleum_gray",
        ",": "t_concrete",
        "U": "t_concrete",
        "&": "t_dirtmound",
        "0": "t_shrub_lilac",
        "=": "t_carpet_yellow",
        "₸": "t_region_groundcover_urban",
        "K": "t_region_groundcover_urban",
        "Q": "t_null",
        "`": "t_screen_door_c"
      },
      "furniture": { "&": "f_region_flower" },
      "place_loot": [ { "item": "television", "x": 19, "y": 9 } ],
      "place_vehicles": [ { "vehicle": "pickup", "x": 3, "y": 9, "chance": 15, "rotation": 90 } ]
    }
  },
  {
    "type": "mapgen",
    "om_terrain": "house_fence05_2",
    "method": "json",
    "object": {
      "palettes": [ "standard_domestic_palette", "standard_domestic_lino_bathroom" ],
      "fill_ter": "t_floor",
      "rows": [
        "........................",
        "........................",
        "........................",
        "........................",
        "........................",
        "........................",
        "......,,,,,,,,,,,,,,,...",
        "......,,,,,,,,,,,,,,,...",
        "......,,,,,,,,,,,,,,,...",
        "......]]oo]]]]]]]oo]]...",
        "......]¤ y|dd|!|sETy]...",
        "......o@@ |++|+|H  #]...",
        "......o@@    + |H  x]...",
        "......]¤   Db| |H  so...",
        "......]||||||| |||+|]...",
        "....,,]ɸ    +      Ə]^..",
        "....,,]¤  Db|RR     ]...",
        "....,,o@@ |||||+||| o...",
        "......o@@ +d|____B| o...",
        ".,,,,.]¤  +d|tS88B|>]...",
        ".,,,,.]]oo]]]]]]]]]]]...",
        ".,,,,........^..........",
        ".,,,,...................",
        "........................"
      ],
      "terrain": { "_": "t_linoleum_gray", "]": "t_wall_wood", ",": "t_shingle_flat_roof", ".": "t_open_air" },
      "furniture": { "!": "f_clothing_rail" },
      "items": {
        "!": [ { "item": "dress_shop", "chance": 50, "repeat": [ 1, 2 ] }, { "item": "jackets", "chance": 30, "repeat": [ 1, 2 ] } ]
      },
      "place_loot": [ { "item": "television", "x": 19, "y": 12 } ]
    }
  },
  {
    "type": "mapgen",
    "om_terrain": "house_fence05_roof",
    "method": "json",
    "object": {
      "palettes": [ "roof_palette" ],
      "fill_ter": "t_shingle_flat_roof",
      "rows": [
        "                        ",
        "                        ",
        "                        ",
        "                        ",
        "                        ",
        "                        ",
        "                        ",
        "                        ",
        "                        ",
        "      ---------------   ",
        "      -.............-   ",
        "      -............~-   ",
        "      -.............-   ",
        "      -.............-   ",
        "      -...X.........-   ",
        "      -.............5   ",
        "      -.............-   ",
        "      -.............-   ",
        "      -...N......=..-   ",
        "      -.............-   ",
        "      ------5--------   ",
        "                        ",
        "                        ",
        "                        "
      ],
      "terrain": { ".": "t_shingle_flat_roof" },
      "place_nested": [
        { "chunks": [ "NC_res_roof_solar_4X4" ], "x": 8, "y": 10 },
        { "chunks": [ "NC_res_roof_chunk_3X3" ], "x": [ 13, 15 ], "y": [ 10, 15 ] }
      ]
    }
  }
]
