[
  {
    "//": "Basement - Variant 1",
    "type": "mapgen",
    "om_terrain": "house_fence10_basement",
    "weight": 10,
    "method": "json",
    "object": {
      "palettes": [ "standard_domestic_palette", "standard_domestic_basement_palette" ],
      "fill_ter": "t_floor_waxed",
      "rows": [
        "^^^^^^^^^^^^^^^^^^^^^^^^",
        "^^^^^^^^^^^^^^^^^^^^^^^^",
        "^^^^^^^^^^^^^^^^^^^^^^^^",
        "^^^^^^^^^^^^^^^^^^^^^^^^",
        "^^^^|||||||||||^^^^^^^^^",
        "^^^^|    A%xx%|^^^^^^^^^",
        "^^^^| ee      |^^^^^^^^^",
        "^^^^| ee A    |^^^^^^^^^",
        "^^^^| ee  HHHs|^^^^^^^^^",
        "^^^^|         |^^^^^^^^^",
        "^^^^||||||   R|^^^^^^^^^",
        "^^^^|RR T|   R|^^^^^^^^^",
        "^^^^|    +   R|^^^^^^^^^",
        "^^^^|  h |    |^^^^^^^^^",
        "^^^^|Prrr|b |<|^^^^^^^^^",
        "^^^^|||||||+|||^^^^^^^^^",
        "^^^^#g_qq____Z#^^^^^^^^^",
        "^^^^#U________#^^^^^^^^^",
        "^^^^#U_NNY_!_W#^^^^^^^^^",
        "^^^^###########^^^^^^^^^",
        "^^^^^^^^^^^^^^^^^^^^^^^^",
        "^^^^^^^^^^^^^^^^^^^^^^^^",
        "^^^^^^^^^^^^^^^^^^^^^^^^",
        "^^^^^^^^^^^^^^^^^^^^^^^^"
      ],
      "terrain": {
        "W": "t_thconc_floor",
        "Z": "t_thconc_floor",
        "g": "t_thconc_floor",
        "_": "t_thconc_floor",
        "!": "t_thconc_floor",
        "Y": "t_thconc_floor",
        "N": "t_thconc_floor",
        "U": "t_thconc_floor",
        "q": "t_thconc_floor"
      },
      "furniture": { "%": "f_speaker_cabinet", "!": "f_sink" },
      "place_loot": [ { "item": "television", "x": 11, "y": 5 } ]
    }
  },
  {
    "//": "Basement - Variant 2",
    "type": "mapgen",
    "om_terrain": "house_fence10_basement",
    "weight": 10,
    "method": "json",
    "object": {
      "palettes": [ "standard_domestic_palette", "standard_domestic_basement_palette" ],
      "fill_ter": "t_floor_waxed",
      "rows": [
        "^^^^^^^^^^^^^^^^^^^^^^^^",
        "^^^^^^^^^^^^^^^^^^^^^^^^",
        "^^^^^^^^^^^^^^^^^^^^^^^^",
        "^^^^^^^^^^^^^^^^^^^^^^^^",
        "^^^^###########^^^^^^^^^",
        "^^^^#X_c___Z_W#^^^^^^^^^",
        "^^^^#_________#^^^^^^^^^",
        "^^^^#_______zz#^^^^^^^^^",
        "^^^^#_b__qUzzg#^^^^^^^^^",
        "^^^^||||+||||||^^^^^^^^^",
        "^^^^|&&   Trrr|^^^^^^^^^",
        "^^^^|&&h    h |^^^^^^^^^",
        "^^^^|h        |^^^^^^^^^",
        "^^^^|      ||||^^^^^^^^^",
        "^^^^|      + <|^^^^^^^^^",
        "^^^^|sHHH  ||||^^^^^^^^^",
        "^^^^|        R|^^^^^^^^^",
        "^^^^|        R|^^^^^^^^^",
        "^^^^| xxx    R|^^^^^^^^^",
        "^^^^|||||||||||^^^^^^^^^",
        "^^^^^^^^^^^^^^^^^^^^^^^^",
        "^^^^^^^^^^^^^^^^^^^^^^^^",
        "^^^^^^^^^^^^^^^^^^^^^^^^",
        "^^^^^^^^^^^^^^^^^^^^^^^^"
      ],
      "terrain": {
        "_": "t_thconc_floor",
        "z": "t_thconc_floor",
        "g": "t_thconc_floor",
        "W": "t_thconc_floor",
        "q": "t_thconc_floor",
        "Z": "t_thconc_floor",
        "b": "t_thconc_floor",
        "U": "t_thconc_floor"
      },
      "furniture": { "&": "f_table", "!": "f_entertainment_center", "$": "f_armchair", "%": "f_desk" },
      "items": { "&": { "item": "child_items", "chance": 50 } },
      "place_loot": [
        { "item": "television", "x": 7, "y": 18, "chance": 100 },
        { "group": "child_items", "x": [ 5, 10 ], "y": [ 11, 18 ], "chance": 75, "repeat": [ 5, 7 ] },
        { "item": "laptop", "x": 12, "y": 10, "chance": 100 }
      ]
    }
  },
  {
    "type": "mapgen",
    "om_terrain": "house_fence10_1",
    "method": "json",
    "object": {
      "palettes": [ "standard_domestic_palette", "standard_domestic_lino_bathroom", "standard_domestic_landscaping_palette" ],
      "fill_ter": "t_floor_waxed",
      "rows": [
        "/....[........p._______/",
        "/.........%%%%%._______/",
        "/...##::::##----_______/",
        "/...#syyy  *----_______/",
        "/...#H    L####._______/",
        "/...oH l  Ə|tS#._______/",
        "/...oH l   |00o._______/",
        "/...#s    T|+|#._______/",
        "/...# a E    R#._______/",
        "/...#|||||   R#._______/",
        "/...#J7246    #._______/",
        "/..^#O        o._______/",
        "/[..#J Jn  V|<#._______/",
        "/...o5 J1  V||#._______/",
        "/...#F     V|>#._______/",
        "/...#6        #._______/",
        "/...#  h h    #._______/",
        "/...o  fff   yo......../",
        "/...# hfffh  Ə#^......./",
        "/...##:::::#¶:#..-----./",
        "/................-₸K₸-./",
        "/..[.............-----./",
        "/................-₸K₸-./",
        "////////////////////////"
      ],
      "terrain": { "/": "t_privacy_fence", "0": "t_linoleum_gray", "K": "t_sidewalk", "₸": "t_sidewalk" },
      "place_vehicles": [
        { "vehicle": "suv_electric", "x": 20, "y": 14, "chance": 15, "status": 1, "fuel": 0, "rotation": 90 },
        { "vehicle": "car", "x": 19, "y": 5, "chance": 15, "status": 1, "fuel": 0, "rotation": 90 }
      ]
    }
  },
  {
    "type": "mapgen",
    "om_terrain": "house_fence10_2",
    "method": "json",
    "object": {
      "palettes": [ "standard_domestic_palette", "standard_domestic_lino_bathroom" ],
      "fill_ter": "t_floor",
      "rows": [
        "........................",
        "........................",
        "....##o##o##............",
        "....#r T@@¤#............",
        "....#rh @@ ####.........",
        "....#       +ɸ#.........",
        "....#+|||||+||#.........",
        "....#d|@@d| +U#.........",
        "....#||¤  + ||#.........",
        "....o¤   r| +w#.........",
        "...^#@@dhr| +Q#.........",
        "....#|||||| ||#.........",
        "....#t8S8|T |>o.........",
        "....o____+    #.........",
        "....#BB||||+||#.........",
        "....#|||IIT  ¤#.........",
        "....#v|b    @@#.........",
        "....# +     @@o.........",
        "....#D|yydd  ¤#.........",
        "....###o###o###^........",
        "........................",
        "........................",
        "........................",
        "........................"
      ],
      "terrain": { ".": "t_open_air", "_": "t_linoleum_gray" }
    }
  },
  {
    "type": "mapgen",
    "om_terrain": "house_fence10_roof",
    "method": "json",
    "object": {
      "palettes": [ "roof_palette" ],
      "fill_ter": "t_shingle_flat_roof",
      "rows": [
        "                        ",
        "                        ",
        "    --------            ",
        "    -......-            ",
        "    -......----         ",
        "    -.........-         ",
        "    -.........-         ",
        "    -.........-         ",
        "    -.~.......-         ",
        "    -.........-         ",
        "    -.........-         ",
        "    -.........-         ",
        "    -.........-         ",
        "    -.........-         ",
        "    -.........-         ",
        "    -.........-         ",
        "    -.........-         ",
        "    -.........-         ",
        "    -.........-         ",
        "    -----------         ",
        "                        ",
        "                        ",
        "                        ",
        "                        "
      ],
      "terrain": { ".": "t_shingle_flat_roof" },
      "place_nested": [
        { "chunks": [ "NC_res_roof_solar_4X4" ], "x": 6, "y": 13 },
        { "chunks": [ "NC_res_roof_chunk_3X3" ], "x": [ 7, 11 ], "y": [ 7, 11 ] }
      ]
    }
  }
]
