[
  {
    "method": "json",
    "om_terrain": [ [ "urban_2_1", "urban_2_2" ] ],
    "type": "mapgen",
    "weight": 250,
    "object": {
      "fill_ter": "t_floor",
      "rows": [
        "...p______!______...............................",
        "....______!______...........................[...",
        "....______.______............[..................",
        "....______!______`````..........................",
        "....______!______`````..........................",
        "....______.______...``....%%%%....%%%%..........",
        "..##======#======##````####oo######oo####.......",
        "..#&'''''''''''''&#````#TE             R#^......",
        "..#'''''''''''''''#o**o#E     hhhh     R#.......",
        "..o'''''''''''''''#L  y|     ffffff    a#.......",
        "..#N''''''''''''''#           hhhh     R#.......",
        "..#N''''''''''''''+    |y              R#.......",
        "..#'''''''''''''''#  |<|||||||||  ||||+|#.......",
        "..o'''''''''''''''#  |||8S8|RR      |6,6#.......",
        "..#q''''''''''''''#  +D|,,,|        ||||#.......",
        "..#q'''''''''''''A#  +>|t,||        |UUU#..[....",
        "..###oo####+#######,,||||+|   HHHH  |'''#.......",
        "........^#q'q|JJJJY,,,0|y   E      E##+##.......",
        ".........#||||J00,,,,,,,    s  ll   o```........",
        ".........#6+,,,,,,,,,,n|    E       *`````......",
        "....[....#6|JJJF1O7S432|L     xxxxT o`````......",
        ".........####o####ooo####*#o#########`````...u..",
        ".........................```````````````........",
        "................................................"
      ],
      "palettes": [ "standard_domestic_palette" ],
      "terrain": {
        "%": [ "t_region_shrub", "t_region_shrub_fruit", "t_region_shrub_decorative" ],
        "[": [ [ "t_region_tree_fruit", 2 ], [ "t_region_tree_nut", 2 ], "t_region_tree_shade" ],
        "!": "t_region_groundcover_urban",
        "=": "t_door_metal_locked",
        "_": "t_pavement",
        "&": "t_gates_control_brick",
        "'": "t_thconc_floor",
        "q": "t_thconc_floor",
        "A": "t_thconc_floor",
        "N": "t_thconc_floor",
        "U": "t_thconc_floor",
        "`": "t_concrete",
        ",": "t_linoleum_white",
        "O": "t_linoleum_white",
        "F": "t_linoleum_white",
        "1": "t_linoleum_white",
        "2": "t_linoleum_white",
        "3": "t_linoleum_white",
        "4": "t_linoleum_white",
        "5": "t_linoleum_white",
        "6": "t_linoleum_white",
        "7": "t_linoleum_white",
        "8": "t_linoleum_white",
        "n": "t_linoleum_white",
        "J": "t_linoleum_white",
        "Y": "t_linoleum_white",
        "S": "t_linoleum_white",
        "t": "t_linoleum_white",
        "0": "t_linoleum_white"
      },
      "furniture": { "!": "f_region_flower", "0": "f_stool" },
      "place_loot": [
        { "item": "television", "x": 32, "y": 20, "chance": 100 },
        { "item": "stereo", "x": 31, "y": 20, "chance": 100 },
        { "item": "lawnmower", "x": 39, "y": 16, "chance": 100 },
        { "item": "stepladder", "x": 37, "y": 16, "chance": 100 }
      ],
      "place_vehicles": [
        { "vehicle": "suburban_home", "x": 7, "y": 12, "chance": 30, "rotation": 90 },
        { "vehicle": "suburban_home", "x": 14, "y": 12, "chance": 30, "rotation": 90 }
      ]
    }
  },
  {
    "method": "json",
    "om_terrain": [ [ "urban_2_3", "urban_2_4" ] ],
    "type": "mapgen",
    "weight": 250,
    "object": {
      "fill_ter": "t_floor",
      "rows": [
        "~~~~~~~~~~~~~~~~~~~~~~~~~~~~~~~~~~~~~~~~~~~~~~~~",
        "~~~~~~~~~~~~~~~~~~~~~~~~~~~~~~~~~~~~~~~~~~~~~~~~",
        "~~~~~~~~~~~~~~~~~~~~~~~~~~~~~~~~~~~~~~~~~~~~~~~~",
        "~~~~~~~~~~~~~~~~~~~~~~~~~~~~~~~~~~~~~~~~~~~~~~~~",
        "~~~~~~~~~~~~~~~~~~~~~~~~~~~~~~~~~~~~~~~~~~~~~~~~",
        "~~~~~~~~~~~~~~~~~~~~~~~~~~~~~~~~~~~~~~~~~~~~~~~~",
        "~~0_______________###ooo########o#####o##~~~~~~~",
        "~~0===============#IIIT  R|Q|D|d II    T#~~~~~~~",
        "~~0===============oIh     + | +  h  E  R#^~~~~~~",
        "~~0===============#I    ER|v|D|@@   l  a#~~~~~~~",
        "~~0===============#|||+||||||||@@   E  R#~~~~~~~",
        "~~0===============#           +         #~~~~~~~",
        "~~0===============oy |>|||||+||||||||||+#~~~~~~~",
        "~~0===============oy |||BB|y  Tdbd  +D|v#~~~~~~~",
        "~~0===============oy +,,,,|         #####~~~~~~~",
        "~~0===============#  |8S8t|I       E#====~~~~~~~",
        "~~)))))))%========#|+||||||Ih      lo====~~~~~~~",
        "~~~~~~~~~0========#Y  Dbdy|I       E#====~~~~~~~",
        "~~~~~~~~~0========#I      |         #~~~~~~~~~~~",
        "~~~~~~~~~0========oIh   @ |   @  @  o~~~~~~~~~~~",
        "~~~~~~~~~0=======^#y   T@I|T I@ I@  #~~~~~~~~~~~",
        "~~~~~~~~~)))))))))##oo######o#####o##~~~~~~~~~~~",
        "~~~~~~~~~~~~~~~~~~~~~~~~~~~~~~~~~~~~~~~~~~~~~~~~",
        "~~~~~~~~~~~~~~~~~~~~~~~~~~~~~~~~~~~~~~~~~~~~~~~~"
      ],
      "palettes": [ "standard_domestic_palette" ],
      "terrain": {
        "~": "t_open_air",
        "=": "t_shingle_flat_roof",
        "&": "t_shingle_flat_roof",
        "%": "t_gutter_drop",
        "0": "t_gutter_east",
        "_": "t_gutter_south",
        ")": "t_gutter_north",
        "B": "t_linoleum_white",
        "S": "t_linoleum_white",
        "t": "t_linoleum_white",
        "8": "t_linoleum_white",
        ",": "t_linoleum_white"
      },
      "furniture": { "&": "f_chimney" }
    }
  },
  {
    "method": "json",
    "om_terrain": [ [ "urban_2_5", "urban_2_6" ] ],
    "type": "mapgen",
    "weight": 250,
    "object": {
      "fill_ter": "t_shingle_flat_roof",
      "rows": [
        "                                                ",
        "                                                ",
        "                                                ",
        "                                                ",
        "                                                ",
        "                                                ",
        "                  -----------------------       ",
        "                  -.....................-       ",
        "                  -.....................5       ",
        "                  -.........X..........~-       ",
        "                  -.....................-       ",
        "                  -.....................-       ",
        "                  -.....................-       ",
        "                  -.....................-       ",
        "                  -.................-----       ",
        "                  -.......N.........-           ",
        "                  -.................-           ",
        "                  -............&....-           ",
        "                  -.................-           ",
        "                  -.................-           ",
        "                  5.................-           ",
        "                  -------------------           ",
        "                                                ",
        "                                                "
      ],
      "palettes": [ "roof_palette" ],
      "terrain": { ".": "t_shingle_flat_roof" }
    }
  },
  {
    "method": "json",
    "om_terrain": [ [ "urban_2_1_basement", "urban_2_2_basement" ] ],
    "type": "mapgen",
    "object": {
      "fill_ter": "t_thconc_floor",
      "rows": [
        "                                                ",
        "                                                ",
        "                                                ",
        "                                                ",
        "                                                ",
        "                                                ",
        "  |||||||||||||||||    ||||||||||||||||||       ",
        "  |1..............|    |......2.........|       ",
        "  |...............||||||................|       ",
        "  |.................g.F...zz............|       ",
        "  |.....................................|       ",
        "  |.....................................|       ",
        "  |............z........................|       ",
        "  |.........z.z.........................|       ",
        "  |..................|+|Z...............|       ",
        "  |.................U|<|J...............|       ",
        "  ||||||||..........U|||W...............|       ",
        "         |..........................|||||       ",
        "         |..........................|           ",
        "         |..........................|           ",
        "         |..........................|           ",
        "         ||||||||||||||||||||||||||||           ",
        "                                                ",
        "                                                "
      ],
      "palettes": [ "basement_empty" ],
      "nested": {
        "1": { "chunks": [ [ "null", 80 ], [ "room_9x9_cellar_E", 20 ], [ "room_9x9_weed_E", 5 ], [ "room_9x9_recroom_E", 20 ] ] },
        "2": {
          "chunks": [
            [ "null", 70 ],
            [ "room_10x10_woodworker_W", 20 ],
            [ "room_10x10_guns_W", 7 ],
            [ "room_10x10_junk_W", 30 ],
            [ "room_10x10_recording_studio_W", 20 ]
          ]
        }
      }
    }
  }
]
