[
  {
    "method": "json",
    "om_terrain": [ [ "urban_5_1", "urban_5_2" ] ],
    "type": "mapgen",
    "weight": 250,
    "object": {
      "fill_ter": "t_floor",
      "rows": [
        ".....p________...............``.................",
        ".....!________!..............``........[........",
        ".....!________`````````````````............[....",
        "..[..!________!..............``.................",
        ".....!________!.....%%%%....````.....%%%%.......",
        ".....!________....###oo#####o**o######oo###.....",
        "....##========##!!#T  sE        L|TE  rr R#.....",
        "....#'''''''''&####y      H      |R   h  R#.....",
        "....#''''''''''#qq|x   l  H               o.....",
        "....o''''''''''+''|x   l  H      |y EsE RR#.....",
        "....#''''''''''#UU|x      H      |||||||||#.....",
        "....#''''''''''#|||y    E         <|B,,|zv#.....",
        "....o''''''''''#ZW|||JJJ|| ||  |||||B,S|zQ#.....",
        "....#''''''''''+  +,,,,,,,,,|  |S,t|t,,| D#.....",
        "....#''''''''''#L>|,,000,,,,|  +,,,|||+|+|#.....",
        "....###*########|||,,JJJ,,,Y||+|||||R     #.....",
        "....``````````^#66|,,J5J,,,7|             #.....",
        "....```````````#  +,,,,,,,,O|            d#.....",
        "....```````````#66|FF35n21,4|T      ii    o.....",
        "...%```````````######ooo##*##Ih     @@   d#.....",
        "...%````````````````````````#IIIy   @@    #..[..",
        "...%%%...%%%.........%%%....####oo#########.....",
        "...............u......%.........................",
        "................................................"
      ],
      "palettes": [ "standard_domestic_palette" ],
      "terrain": {
        "%": [ "t_region_shrub", "t_region_shrub_fruit", "t_region_shrub_decorative" ],
        "[": [ [ "t_region_tree_fruit", 2 ], [ "t_region_tree_nut", 2 ], "t_region_tree_shade" ],
        "!": "t_region_groundcover_urban",
        "#": "t_adobe_brick_wall",
        "=": "t_door_metal_locked",
        "_": "t_pavement",
        "&": "t_gates_control_brick",
        "'": "t_thconc_floor",
        "q": "t_thconc_floor",
        "Q": "t_thconc_floor",
        "N": "t_thconc_floor",
        "U": "t_thconc_floor",
        "`": "t_concrete",
        "}": "t_linoleum_white",
        ",": "t_linoleum_white",
        "O": "t_linoleum_white",
        "F": "t_linoleum_white",
        "B": "t_linoleum_white",
        "1": "t_linoleum_white",
        "2": "t_linoleum_white",
        "3": "t_linoleum_white",
        "4": "t_linoleum_white",
        "5": "t_linoleum_white",
        "6": "t_linoleum_white",
        "7": "t_linoleum_white",
        "8": "t_linoleum_white",
        "n": "t_linoleum_white",
        "J": "t_linoleum_white",
        "Y": "t_linoleum_white",
        "S": "t_linoleum_white",
        "t": "t_linoleum_white",
        "f": "t_linoleum_white",
        "0": "t_linoleum_white",
        "]": "t_linoleum_white"
      },
      "furniture": { "!": "f_region_flower", "0": "f_stool", "]": "f_sofa", "}": "f_table" },
      "place_loot": [ { "item": "television", "x": 19, "y": 9, "chance": 100 }, { "item": "stereo", "x": 19, "y": 8, "chance": 100 } ],
      "place_vehicles": [ { "vehicle": "suburban_home", "x": 10, "y": 11, "chance": 30, "rotation": 90 } ]
    }
  },
  {
    "method": "json",
    "om_terrain": [ [ "urban_5_3", "urban_5_4" ] ],
    "type": "mapgen",
    "weight": 250,
    "object": {
      "fill_ter": "t_floor",
      "rows": [
        "~~~~~~~~~~~~~~~~~~~~~~~~~~~~~~~~~~~~~~~~~~~~~~~~",
        "~~~~~~~~~~~~~~~~~~~~~~~~~~~~~~~~~~~~~~~~~~~~~~~~",
        "~~~~~~~~~~~~~~~~~~~~~~~~~~~~~~~~~~~~~~~~~~~~~~~~",
        "~~~~~~~~~~~~~~~~~~~~~~~~~~~~~~~~~~~~~~~~~~~~~~~~",
        "~~~~~~~~~~~~~~~~~~~~~~~~~~~~~~~~~~~~~~~~~~~~~~~~",
        "~~~~~~~~~~~~~~~~~~_________________________~~~~~",
        "~~~~0______________======#ooo#============0~~~~~",
        "~~~~0==========#####o#####TII##############~~~~~",
        "~~~~0==========#D   IIT R|R h  sd|D|8SS8,B#~~~~~",
        "~~~~0==========o    h    |||     + |,,,,,Bo~~~~~",
        "~~~~0==========#b        + |   @@|||,,,t,,#~~~~~",
        "~~~~0==========#d     @@|| |+|||||>|,|||||#~~~~~",
        "~~~~0==========#|||||||||          +,|RRRR#~~~~~",
        "~~~~0==========#Q |y s@@||||+||||+||||   T#~~~~~",
        "~~~~0=========^#D +   @@      d|    b    Io~~~~~",
        "~~~~0)))))))))%#D |           d|s       hIo~~~~~",
        "~~~~~~~~~~~~~~~#vQ|y  h   Es   |E  l     I#~~~~~",
        "~~~~~~~~~~~~~~~######III##########HHH######~~~~~",
        "~~~~~~~~~~~~~~~0====#ooo#========#ooo#====0~~~~~",
        "~~~~~~~~~~~~~~~0))))))))))))0=============0~~~~~",
        "~~~~~~~~~~~~~~~~~~~~~~~~~~~~0=============0~~~~~",
        "~~~~~~~~~~~~~~~~~~~~~~~~~~~~0))))))))))))))~~~~~",
        "~~~~~~~~~~~~~~~~~~~~~~~~~~~~~~~~~~~~~~~~~~~~~~~~",
        "~~~~~~~~~~~~~~~~~~~~~~~~~~~~~~~~~~~~~~~~~~~~~~~~"
      ],
      "palettes": [ "standard_domestic_palette" ],
      "terrain": {
        "~": "t_open_air",
        "#": "t_adobe_brick_wall",
        "=": "t_shingle_flat_roof",
        "&": "t_shingle_flat_roof",
        "%": "t_gutter_drop",
        "0": "t_gutter_east",
        "_": "t_gutter_south",
        ")": "t_gutter_north",
        "B": "t_linoleum_white",
        "S": "t_linoleum_white",
        "t": "t_linoleum_white",
        "8": "t_linoleum_white",
        ",": "t_linoleum_white"
      }
    }
  },
  {
    "method": "json",
    "om_terrain": [ [ "urban_5_5", "urban_5_6" ] ],
    "type": "mapgen",
    "weight": 250,
    "object": {
      "fill_ter": "t_shingle_flat_roof",
      "rows": [
        "                                                ",
        "                                                ",
        "                                                ",
        "                                                ",
        "                                                ",
        "                                                ",
        "                         -----                  ",
        "               -----------...--------------     ",
        "               -..........................-     ",
        "               -..........................-     ",
        "               -.........&......N.........-     ",
        "               -..........................-     ",
        "               -..........................-     ",
        "               -..........................-     ",
        "               5...........X...=..........-     ",
        "               -..........................-     ",
        "               -..........................-     ",
        "               ------...----------...------     ",
        "                    -----        -----          ",
        "                                                ",
        "                                                ",
        "                                                ",
        "                                                ",
        "                                                "
      ],
      "palettes": [ "roof_palette" ],
      "terrain": { ".": "t_shingle_flat_roof" }
    }
  },
  {
    "method": "json",
    "om_terrain": [ [ "urban_5_1_basement", "urban_5_2_basement" ] ],
    "type": "mapgen",
    "object": {
      "fill_ter": "t_thconc_floor",
      "rows": [
        "                                                ",
        "                                                ",
        "                                                ",
        "                                                ",
        "                                                ",
        "                  |||||||||||||||||||||||||     ",
        "    ||||||||||||  |.......................|     ",
        "    |..........||||.......................|     ",
        "    |..........%..........................|     ",
        "    |..........%..........................|     ",
        "    |..........%..........................|     ",
        "    |..........%..........................|     ",
        "    |..........%%%%.......................|     ",
        "    |..........+zz+.......................|     ",
        "    |..........%.<%.......................|     ",
        "    ||||||||||||%%%.......................|     ",
        "               |.z........................|     ",
        "               |z.........................|     ",
        "               |UUJ.gF....................|     ",
        "               ||||||||||||||.............|     ",
        "                            |.............|     ",
        "                            |||||||||||||||     ",
        "                                                ",
        "                                                "
      ],
      "palettes": [ "basement_empty" ]
    }
  }
]
