[
  {
    "method": "json",
    "om_terrain": [ [ "urban_3_1", "urban_3_2" ] ],
    "type": "mapgen",
    "weight": 250,
    "object": {
      "fill_ter": "t_floor",
      "rows": [
        ".....p.________.................................",
        ".......________.................................",
        ".......________``````````........[..............",
        ".......________........``...................[...",
        ".......________..%%%..````......................",
        ".......________.%%%%%.````......................",
        ".....##========###o###o**o#####o#######o###.....",
        ".....#'''''''''&#rrr|y    L|RR    TEsE   y#^....",
        "....!#''''''''''# h        }0             #.....",
        ".....#''''''''''#          }0    H l     x#.....",
        "....!#''''''''''#RRR|            H l     x#.....",
        ".....#A'''''''''#||||            H       x#.....",
        ".....#N'''''''''+>|<             HHHHy y  #.....",
        "....!#N'''''''''#||||  ##o#a#o#########o###.....",
        "....!#''''''''''#t,,+  #``###``%......!!!^......",
        "....!#q'''''''''#88S|  o```````%................",
        ".....#########+##||||  *````````..........[.....",
        ".....#)W|6657n,JJJ,,,,,*````````....!!!.........",
        ".....#) +,,,,,,,,,,fff]o```````%....!X!.........",
        ".....#)Z|4O3521F,,,]]]]#```````%....!!!.........",
        ".....######ooo#####oo###```````%............[...",
        "..........!!!!!........%%%``%%%%...[............",
        "................................................",
        "................................................"
      ],
      "palettes": [ "standard_domestic_palette" ],
      "terrain": {
        "%": [ "t_region_shrub", "t_region_shrub_fruit", "t_region_shrub_decorative" ],
        "[": [ [ "t_region_tree_fruit", 2 ], [ "t_region_tree_nut", 2 ], "t_region_tree_shade" ],
        "!": "t_region_groundcover_urban",
        "=": "t_door_metal_locked",
        "_": "t_pavement",
        "&": "t_gates_control_brick",
        "'": "t_thconc_floor",
        "q": "t_thconc_floor",
        "A": "t_thconc_floor",
        "N": "t_thconc_floor",
        "U": "t_thconc_floor",
        "`": "t_concrete",
        "}": "t_ponywall",
        ",": "t_linoleum_white",
        "O": "t_linoleum_white",
        "F": "t_linoleum_white",
        "1": "t_linoleum_white",
        "2": "t_linoleum_white",
        "3": "t_linoleum_white",
        "4": "t_linoleum_white",
        "5": "t_linoleum_white",
        "6": "t_linoleum_white",
        "7": "t_linoleum_white",
        "8": "t_linoleum_white",
        "n": "t_linoleum_white",
        "J": "t_linoleum_white",
        "Y": "t_linoleum_white",
        "S": "t_linoleum_white",
        "t": "t_linoleum_white",
        "f": "t_linoleum_white",
        "]": "t_linoleum_white"
      },
      "furniture": { "!": "f_region_flower", "0": "f_stool", "]": "f_sofa", ")": "f_counter" },
      "place_loot": [
        { "item": "television", "x": 41, "y": 10, "chance": 100 },
        { "item": "stereo", "x": 41, "y": 9, "chance": 100 },
        { "item": "lawnmower", "x": 6, "y": 9, "chance": 100 },
        { "item": "stepladder", "x": 6, "y": 8, "chance": 100 }
      ],
      "place_vehicles": [ { "vehicle": "suburban_home", "x": 11, "y": 12, "chance": 30, "rotation": 90 } ]
    }
  },
  {
    "method": "json",
    "om_terrain": [ [ "urban_3_3", "urban_3_4" ] ],
    "type": "mapgen",
    "weight": 250,
    "object": {
      "fill_ter": "t_floor",
      "rows": [
        "~~~~~~~~~~~~~~~~~~~~~~~~~~~~~~~~~~~~~~~~~~~~~~~~",
        "~~~~~~~~~~~~~~~~~~~~~~~~~~~~~~~~~~~~~~~~~~~~~~~~",
        "~~~~~~~~~~~~~~~~~~~~~~~~~~~~~~~~~~~~~~~~~~~~~~~~",
        "~~~~~~~~~~~~~~~~~~~~~~~~~~~~~~~~~~~~~~~~~~~~~~~~",
        "~~~~~~~~~~~~~~~~~~~~~~~~~~~~~~~~~~~~~~~~~~~~~~~~",
        "~~~~~~~~~~~~~~~~~~~~~~~~~~~~~~~~~~~~~~~~~~~~~~~~",
        "~~~~~#########o##################__________~~~~~",
        "~~~~~#t,,,,8|8S8|E     IIIT     #^========%~~~~~",
        "~~~~~#,,,,,S|,,,|d      h      s#=========0~~~~~",
        "~~~~~o,,,,,S|t,,+             @@o=========0~~~~~",
        "~~~~~#BB,,,8|BB,|d  yb        @@o=========0~~~~~",
        "~~~~~#||||+|||||||+|||||  HHH  s#=========0~~~~~",
        "~~~~~#Q +          >|D +       T#=========0~~~~~",
        "~~~~~#|||||+|||||+|||||####a#####))))))))%0~~~~~",
        "~~~~~# dbd   |D|D    @@#~~###~~~~~~~~~~~~~~~~~~~",
        "~~~~~#       + |Ih     #~~~~~~~~~~~~~~~~~~~~~~~~",
        "~~~~~o       |||I    hIo~~~~~~~~~~~~~~~~~~~~~~~~",
        "~~~~~#      I|d|T     Io~~~~~~~~~~~~~~~~~~~~~~~~",
        "~~~~~#@@   hI| +       #~~~~~~~~~~~~~~~~~~~~~~~~",
        "~~~~~#@@s   I|d|D    @@#~~~~~~~~~~~~~~~~~~~~~~~~",
        "~~~~~####o#######o######~~~~~~~~~~~~~~~~~~~~~~~~",
        "~~~~~~~~~~~~~~~~~~~~~~~~~~~~~~~~~~~~~~~~~~~~~~~~",
        "~~~~~~~~~~~~~~~~~~~~~~~~~~~~~~~~~~~~~~~~~~~~~~~~",
        "~~~~~~~~~~~~~~~~~~~~~~~~~~~~~~~~~~~~~~~~~~~~~~~~"
      ],
      "palettes": [ "standard_domestic_palette" ],
      "terrain": {
        "~": "t_open_air",
        "=": "t_shingle_flat_roof",
        "&": "t_shingle_flat_roof",
        "%": "t_gutter_drop",
        "0": "t_gutter_west",
        "_": "t_gutter_south",
        ")": "t_gutter_north",
        "B": "t_linoleum_white",
        "S": "t_linoleum_white",
        "t": "t_linoleum_white",
        "8": "t_linoleum_white",
        ",": "t_linoleum_white"
      }
    }
  },
  {
    "method": "json",
    "om_terrain": [ [ "urban_3_5", "urban_3_6" ] ],
    "type": "mapgen",
    "weight": 250,
    "object": {
      "fill_ter": "t_shingle_flat_roof",
      "rows": [
        "                                                ",
        "                                                ",
        "                                                ",
        "                                                ",
        "                                                ",
        "                                                ",
        "     ----------------------------               ",
        "     -..........................5               ",
        "     -..............:...........-               ",
        "     -...X......................-               ",
        "     -..........................-               ",
        "     -..........................-               ",
        "     -..........................-               ",
        "     -.................----~-----               ",
        "     -....N............-  ---                   ",
        "     -.................-                        ",
        "     -...........=.....-                        ",
        "     -.................-                        ",
        "     -.................-                        ",
        "     -.................-                        ",
        "     -------------------                        ",
        "                                                ",
        "                                                ",
        "                                                "
      ],
      "palettes": [ "roof_palette" ],
      "terrain": { ".": "t_shingle_flat_roof" }
    }
  },
  {
    "method": "json",
    "om_terrain": [ [ "urban_3_1_basement", "urban_3_2_basement" ] ],
    "type": "mapgen",
    "object": {
      "fill_ter": "t_thconc_floor",
      "rows": [
        "                                                ",
        "                                                ",
        "                                                ",
        "                                                ",
        "                                                ",
        "                                                ",
        "     ||||||||||||||||||||||||||||||||||||||     ",
        "     |2..................3..........1.....|     ",
        "     |....................................|     ",
        "     |....................................|     ",
        "     |....................................|     ",
        "     |....................................|     ",
        "     |...........<........................|     ",
        "     |.................||||a|||||||||||||||     ",
        "     |................g|  |||                   ",
        "     |................W|                        ",
        "     |................Z|                        ",
        "     |..z.z...........J|                        ",
        "     |F......z.....A..J|                        ",
        "     |..z.............J|                        ",
        "     |||||||||||||||||||                        ",
        "                                                ",
        "                                                ",
        "                                                "
      ],
      "palettes": [ "basement_empty" ],
      "nested": {
        "1": {
          "chunks": [
            [ "null", 70 ],
            [ "room_6x6_guns_W", 2 ],
            [ "room_6x6_junk_W", 30 ],
            [ "room_6x6_office_W", 30 ],
            [ "room_6x6_brewer_W", 10 ]
          ]
        },
        "2": {
          "chunks": [
            [ "null", 70 ],
            [ "room_10x10_woodworker_E", 20 ],
            [ "room_10x10_guns_E", 7 ],
            [ "room_10x10_junk_E", 30 ],
            [ "room_10x10_recording_studio_E", 20 ]
          ]
        },
        "3": {
          "chunks": [
            [ "null", 10 ],
            [ "livingroom_5x5_N_1", 30 ],
            [ "livingroom_5x5_E_1", 30 ],
            [ "livingroom_5x5_S_1", 30 ],
            [ "livingroom_5x5_N_2", 30 ],
            [ "livingroom_5x5_E_2", 30 ],
            [ "livingroom_5x5_S_2", 30 ],
            [ "livingroom_5x5_W_2", 30 ],
            [ "home_office_4x4_N", 20 ],
            [ "home_office_4x4_S", 20 ]
          ]
        }
      }
    }
  }
]
