[
  {
    "method": "json",
    "om_terrain": [ [ "urban_4_1", "urban_4_2" ] ],
    "type": "mapgen",
    "weight": 250,
    "object": {
      "fill_ter": "t_thconc_floor",
      "rows": [
        "                                                ",
        "                                                ",
        "                                                ",
        "                                                ",
        "                                                ",
        "                                                ",
        "                      |||||        |||||        ",
        "                 ||||||...||||||||||...||||||   ",
        "                 |1..............2..........|   ",
        "                 |..........................|   ",
        "                 |..........................|   ",
        "                 |..........................|   ",
        "                 |.............%%%..........|   ",
        "                 |.............%<+..........|   ",
        "                 |.............+.%..........|   ",
        "      ||||||||||||.............%%%..........|   ",
        "      |z....A...............................|   ",
        "      |zz...................................|   ",
        "      |gF..ZJJJW............................|   ",
        "      |||||||||||||||||||....||||||||||||||||   ",
        "                        ||||||                  ",
        "                                                ",
        "                                                ",
        "                                                "
      ],
      "palettes": [ "basement_empty" ],
      "nested": {
        "2": {
          "chunks": [ [ "null", 50 ], [ "11x11_gym_open_1", 10 ], [ "11x11_recroom_open", 30 ], [ "room_11x11_apartment_W", 10 ] ]
        },
        "1": {
          "chunks": [
            [ "null", 70 ],
            [ "room_6x6_brewer_E", 5 ],
            [ "room_6x6_guns_E", 5 ],
            [ "room_6x6_junk_E", 30 ],
            [ "room_6x6_office_E", 30 ]
          ]
        }
      }
    }
  },
  {
    "method": "json",
    "om_terrain": [ [ "urban_4_3", "urban_4_4" ] ],
    "type": "mapgen",
    "weight": 250,
    "object": {
      "fill_ter": "t_floor",
      "rows": [
        "......p.________..............``................",
        "........________..............``................",
        "........________..........[...``................",
        "........________..............``................",
        "........________..............``........[.......",
        "........________...........````````.............",
        "........________......#ooo#````````#ooo#........",
        "......#''''''''''######ycy###o**o###rrr######...",
        "......'''''''''''#y         |y  L|yT h  TE R#...",
        "......'''''''''''#     h                   R#...",
        "......'''''''''''#r   hffh  |    |         R#...",
        "......'''''''''''#r   hffh  |  |<|R        R#...",
        "......'''''''''''#r   hffh  |  |||R         #...",
        "......'''''''''''#      h   |  |>|   HHHHH  #...",
        "......'''''''''''#y AA      |  + |       H  #...",
        "......##*######*##|JJ| |JJJ||  |||E   ll    #...",
        "......#U''U|S,|,74,,,,,,,00,,,,|6|          #...",
        "......#U''Q|,,+,,,,,,,,,,,,,,,,+,|         R#...",
        ".....^#'NNQ|t,|3O2551F,,,]}}],,|6|   xxxx  R#...",
        "......##o#########oo##*##]]]]################...",
        ".....................```#oooo#..................",
        ".....................```...........[............",
        "................................................",
        "................................................"
      ],
      "palettes": [ "standard_domestic_palette" ],
      "terrain": {
        "%": [ "t_region_shrub", "t_region_shrub_fruit", "t_region_shrub_decorative" ],
        "[": [ [ "t_region_tree_fruit", 2 ], [ "t_region_tree_nut", 2 ], "t_region_tree_shade" ],
        "!": "t_region_groundcover_urban",
        "#": "t_adobe_brick_wall",
        "=": "t_door_metal_locked",
        "_": "t_pavement",
        "&": "t_gates_control_brick",
        "'": "t_thconc_floor",
        "q": "t_thconc_floor",
        "Q": "t_thconc_floor",
        "N": "t_thconc_floor",
        "U": "t_thconc_floor",
        "`": "t_concrete",
        "}": "t_linoleum_white",
        ",": "t_linoleum_white",
        "O": "t_linoleum_white",
        "F": "t_linoleum_white",
        "1": "t_linoleum_white",
        "2": "t_linoleum_white",
        "3": "t_linoleum_white",
        "4": "t_linoleum_white",
        "5": "t_linoleum_white",
        "6": "t_linoleum_white",
        "7": "t_linoleum_white",
        "8": "t_linoleum_white",
        "n": "t_linoleum_white",
        "J": "t_linoleum_white",
        "Y": "t_linoleum_white",
        "S": "t_linoleum_white",
        "t": "t_linoleum_white",
        "f": "t_linoleum_white",
        "0": "t_linoleum_white",
        "]": "t_linoleum_white"
      },
      "furniture": { "!": "f_region_flower", "0": "f_stool", "]": "f_sofa", "}": "f_table" },
      "place_loot": [ { "item": "television", "x": 39, "y": 18, "chance": 100 }, { "item": "stereo", "x": 38, "y": 18, "chance": 100 } ],
      "place_vehicles": [ { "vehicle": "suburban_home", "x": 12, "y": 11, "chance": 30, "rotation": 90 } ]
    }
  },
  {
    "method": "json",
    "om_terrain": [ [ "urban_4_5", "urban_4_6" ] ],
    "type": "mapgen",
    "weight": 250,
    "object": {
      "fill_ter": "t_floor",
      "rows": [
        "~~~~~~~~~~~~~~~~~~~~~~~~~~~~~~~~~~~~~~~~~~~~~~~~",
        "~~~~~~~~~~~~~~~~~~~~~~~~~~~~~~~~~~~~~~~~~~~~~~~~",
        "~~~~~~~~~~~~~~~~~~~~~~~~~~~~~~~~~~~~~~~~~~~~~~~~",
        "~~~~~~~~~~~~~~~~~~~~~~~~~~~~~~~~~~~~~~~~~~~~~~~~",
        "~~~~~~~~~~~~~~~~~~~~~~~~~~~~~~~~~~~~~~~~~~~~~~~~",
        "~~~~~~~~~~~~~~~~~~~~~~~~~~~~~~~~~~~~~~~~~~~~~~~~",
        "~~~~~~~~~~~~~~~~~~~~~~=====~~~~~~~~=====~~~~~~~~",
        "~~~~~~0__________####oo################oo####~~~",
        "~~~~~~0==========#@@   TE R|8,B|QsE|t8CSS8,B#~~~",
        "~~~~~~0==========o        R|S,B|D  |,,,,,,,B#~~~",
        "~~~~~~0==========o    h    |S,||||+||||+||||#~~~",
        "~~~~~~0==========#   III   |8,t|>|       R  #~~~",
        "~~~~~~0==========#|+||||||+||+|| |d         o~~~",
        "~~~~~~0==========#vD|Dz|U+       |d        s#~~~",
        "~~~~~~0==========#|||+|||||+|||  +       @@@#~~~",
        "~~~~~~0==========#d    Ryb   D|  |T      @@@#~~~",
        "~~~~~~0==========#D          d|+||I      @@@#~~~",
        "~~~~~~0=========^#@     h    @| Q|Ih       s#~~~",
        "~~~~~~%==========#@    III   @| Q|III  b    #~~~",
        "~~~~~~)))))))))))##################o#####o###~~~",
        "~~~~~~~~~~~~~~~~~~~~~~~~======~~~~~~~~~~~~~~~~~~",
        "~~~~~~~~~~~~~~~~~~~~~~~~~~~~~~~~~~~~~~~~~~~~~~~~",
        "~~~~~~~~~~~~~~~~~~~~~~~~~~~~~~~~~~~~~~~~~~~~~~~~",
        "~~~~~~~~~~~~~~~~~~~~~~~~~~~~~~~~~~~~~~~~~~~~~~~~"
      ],
      "palettes": [ "standard_domestic_palette" ],
      "terrain": {
        "~": "t_open_air",
        "#": "t_adobe_brick_wall",
        "=": "t_shingle_flat_roof",
        "&": "t_shingle_flat_roof",
        "%": "t_gutter_drop",
        "0": "t_gutter_east",
        "_": "t_gutter_south",
        ")": "t_gutter_north",
        "B": "t_linoleum_white",
        "S": "t_linoleum_white",
        "t": "t_linoleum_white",
        "8": "t_linoleum_white",
        ",": "t_linoleum_white"
      }
    }
  },
  {
    "method": "json",
    "om_terrain": [ [ "urban_4_7", "urban_4_8" ] ],
    "type": "mapgen",
    "weight": 250,
    "object": {
      "fill_ter": "t_shingle_flat_roof",
      "rows": [
        "                                                ",
        "                                                ",
        "                                                ",
        "                                                ",
        "                                                ",
        "                                                ",
        "                                                ",
        "                 ----------------------------   ",
        "                 -..........................-   ",
        "                 -..........................-   ",
        "                 -..........................-   ",
        "                 -....N.....................-   ",
        "                 -..........................-   ",
        "                 -..........................-   ",
        "                 -.......&.=................-   ",
        "                 -..........................-   ",
        "                 -..........................-   ",
        "                 5..........................-   ",
        "                 -..........................-   ",
        "                 ----------------------------   ",
        "                                                ",
        "                                                ",
        "                                                ",
        "                                                "
      ],
      "palettes": [ "roof_palette" ],
      "terrain": { ".": "t_shingle_flat_roof" }
    }
  }
]
