[
  {
    "method": "json",
    "om_terrain": [ [ "urban_1_1", "urban_1_2" ] ],
    "type": "mapgen",
    "weight": 250,
    "object": {
      "fill_ter": "t_floor",
      "rows": [
        "...pp________...................................",
        ".....________.%%%.%%%.%%%.%%%.%%%.%%%.%%%....[..",
        ".....________`````````````````````````````......",
        "..[..________.!!!!!```````````````````````......",
        ".....________.!%%%######o#*#o#######ooo####.....",
        ".....________&##o##RRR|L     y|y   hhhhh c#!....",
        "...##========##rrrT   |           hfffff  o!....",
        "...#~~~~~~~~~&# h                  hhhhh  o!....",
        "...#~~~~~~~~~~# RRRyET|       |Ey        y#^....",
        "...o~~~~~~~~~~#+|||||||       ||||||++||||#%....",
        "...#~~~~~~~~~q#U|<  +>|           |Y,,,$$$#%....",
        "...#~~~~~~~~~q#||  ||||           +,,,,))$o!....",
        "...o~~~~~~~~~~#y    rr            |6,,,,,,o!....",
        "...#~~~~~~~~~~#c        E    H   x|6,,,000#%....",
        "...#~~~~~~~~~A#y        s    Hl  x|F,,JJJJ#%....",
        "...#|+||||||+|||+||     E    H   x|n,,,,,O#%....",
        "...#~~qq|S|Y,iii,Q|yL            y|2743521#%....",
        "...#A~~~|,+,,,,,,Q###*#o##RaR##o#####ooo###.....",
        "...#NNqq|t|WZJJ,,Q#^`````#####`````%%!X!%%......",
        "...###########o#*##````````````````%%!!!%%......",
        "..............`````````````````````%%%%%%%......",
        "..........[...`````````````````````.%%%%%.......",
        "...u............................................",
        "................................................"
      ],
      "palettes": [ "standard_domestic_palette" ],
      "terrain": {
        "%": [ "t_region_shrub", "t_region_shrub_fruit", "t_region_shrub_decorative" ],
        "[": [ [ "t_region_tree_fruit", 2 ], [ "t_region_tree_nut", 2 ], "t_region_tree_shade" ],
        "!": "t_region_groundcover_urban",
        "=": "t_door_metal_locked",
        "_": "t_pavement",
        "&": "t_gates_control_brick",
        "~": "t_thconc_floor",
        "q": "t_thconc_floor",
        "A": "t_thconc_floor",
        "N": "t_thconc_floor",
        "`": "t_concrete",
        ",": "t_linoleum_white",
        "O": "t_linoleum_white",
        "F": "t_linoleum_white",
        "1": "t_linoleum_white",
        "2": "t_linoleum_white",
        "3": "t_linoleum_white",
        "4": "t_linoleum_white",
        "5": "t_linoleum_white",
        "6": "t_linoleum_white",
        "7": "t_linoleum_white",
        ")": "t_linoleum_white",
        "n": "t_linoleum_white",
        "Q": "t_linoleum_white",
        "J": "t_linoleum_white",
        "Z": "t_linoleum_white",
        "W": "t_linoleum_white",
        "i": "t_linoleum_white",
        "Y": "t_linoleum_white",
        "B": "t_linoleum_white",
        "S": "t_linoleum_white",
        "t": "t_linoleum_white",
        "$": "t_linoleum_white",
        "0": "t_linoleum_white"
      },
      "furniture": { "!": "f_region_flower", "$": "f_sofa", "0": "f_stool", ")": "f_table" },
      "place_loot": [ { "item": "television", "x": 33, "y": 14, "chance": 100 }, { "item": "stereo", "x": 33, "y": 13, "chance": 60 } ],
      "place_vehicles": [ { "vehicle": "suburban_home", "x": 9, "y": 11, "chance": 30, "rotation": 90 } ]
    }
  },
  {
    "method": "json",
    "om_terrain": [ [ "urban_1_3", "urban_1_4" ] ],
    "type": "mapgen",
    "object": {
      "fill_ter": "t_floor",
      "rows": [
        "~~~~~~~~~~~~~~~~~~~~~~~~~~~~~~~~~~~~~~~~~~~~~~~~",
        "~~~~~~~~~~~~~~~~~~~~~~~~~~~~~~~~~~~~~~~~~~~~~~~~",
        "~~~~~~~~~~~~~~~~~~~~~~~~~~~~~~~~~~~~~~~~~~~~~~~~",
        "~~~~~~~~~~~~~~~~~~~~~~~~~~~~~~~~~~~~~~~~~~~~~~~~",
        "~~~###oo######oo###_______________________0~~~~~",
        "~~~#@I  ET| +   I@#=======================%~~~~~",
        "~~~#@    R|D|    @#=======================0~~~~~",
        "~~~#d     |||Ih   #=======================0~~~~~",
        "~~~o  yb  +D|I  yd#^======================0~~~~~",
        "~~~#|||||+||||+|||#=======================0~~~~~",
        "~~~#D|Q+         >o=======================0~~~~~",
        "~~~#+||||||+|||+||#=======================0~~~~~",
        "~~~#  ydbdT y|8,Yt#=======================0~~~~~",
        "~~~#E        |S,,,#=======================0~~~~~",
        "~~~os      hI|8BB,#=======================0~~~~~",
        "~~~#E       I|||||#=======================0~~~~~",
        "~~~#   @@@   |8S8,#=======================0~~~~~",
        "~~~#   @@@   +,,,B#%))))))=&=)))))))))))))0~~~~~",
        "~~~#  I@@@I y|tY,B#~~~~~~)))))~~~~~~~~~~~~~~~~~~",
        "~~~########o###o###~~~~~~~~~~~~~~~~~~~~~~~~~~~~~",
        "~~~~~~~~~~~~~~~~~~~~~~~~~~~~~~~~~~~~~~~~~~~~~~~~",
        "~~~~~~~~~~~~~~~~~~~~~~~~~~~~~~~~~~~~~~~~~~~~~~~~",
        "~~~~~~~~~~~~~~~~~~~~~~~~~~~~~~~~~~~~~~~~~~~~~~~~",
        "~~~~~~~~~~~~~~~~~~~~~~~~~~~~~~~~~~~~~~~~~~~~~~~~"
      ],
      "palettes": [ "standard_domestic_palette" ],
      "terrain": {
        "~": "t_open_air",
        "=": "t_shingle_flat_roof",
        "&": "t_shingle_flat_roof",
        "%": "t_gutter_drop",
        "0": "t_gutter_west",
        "_": "t_gutter_south",
        ")": "t_gutter_north",
        "Y": "t_linoleum_white",
        "B": "t_linoleum_white",
        "S": "t_linoleum_white",
        "t": "t_linoleum_white",
        "8": "t_linoleum_white",
        ",": "t_linoleum_white"
      },
      "furniture": { "&": "f_chimney" }
    }
  },
  {
    "method": "json",
    "om_terrain": [ [ "urban_1_1_basement", "urban_1_2_basement" ] ],
    "type": "mapgen",
    "object": {
      "fill_ter": "t_thconc_floor",
      "rows": [
        "                                                ",
        "                                                ",
        "                                                ",
        "                                                ",
        "                  |||||||||||||||||||||||||     ",
        "              |||||...........1...........|     ",
        "   ||||||||||||Z.W........................|     ",
        "   |........JJ............................|     ",
        "   |......................................|     ",
        "   |......................................|     ",
        "   |.................<....................|     ",
        "   |......................................|     ",
        "   |......................................|     ",
        "   |......................................|     ",
        "   |......................................|     ",
        "   |......................................|     ",
        "   |..................UU..................|     ",
        "   |..............||||||||g.F||||||||||||||     ",
        "   |..............|      |||||                  ",
        "   ||||||||||||||||                             ",
        "                                                ",
        "                                                ",
        "                                                ",
        "                                                "
      ],
      "palettes": [ "basement_empty" ],
      "nested": { "1": { "chunks": [ [ "recroom_12x12", 33 ], [ "tvroom_12x12", 33 ], [ "workoutroom_12x12", 33 ] ] } }
    }
  },
  {
    "method": "json",
    "om_terrain": "urban_1_6",
    "type": "mapgen",
    "object": {
      "fill_ter": "t_shingle_flat_roof",
      "rows": [
        "                        ",
        "                        ",
        "                        ",
        "                        ",
        "   ----------------     ",
        "   -..............-     ",
        "   -...X..........-     ",
        "   -..............-     ",
        "   -..............5     ",
        "   -........&.....-     ",
        "   -..............-     ",
        "   -..............-     ",
        "   -..............-     ",
        "   -...N.....=....-     ",
        "   -..............-     ",
        "   -..............-     ",
        "   -..............-     ",
        "   -..............-     ",
        "   -..............-     ",
        "   ----------------     ",
        "                        ",
        "                        ",
        "                        ",
        "                        "
      ],
      "palettes": [ "roof_palette" ],
      "terrain": { ".": "t_shingle_flat_roof" }
    }
  }
]
