[
  {
    "method": "json",
    "om_terrain": [ [ "urban_6_1", "urban_6_2" ] ],
    "type": "mapgen",
    "object": {
      "fill_ter": "t_floor",
      "rows": [
        "......._______________.p.....%``%...............",
        "......._______________.......!``!...............",
        "......._______________.......!``!.........[.....",
        "......._______________.......!``!...............",
        "......._______________.......!``!...............",
        "......._______________.......%``%...............",
        "......._______________..^#oo#````#oo#...........",
        "......#'''''''#''''''''###rr##**##rr###.[.......",
        "......''''''''''''''''Y#            Ty#.......[.",
        "......''''''''''''''''Y#x    H        #.........",
        "......'''''''''''''''''#x  l H   hffh o.........",
        "......#'''''''#'''''''q#x    H   hffh o.........",
        "......''''''''''''''''q#y ET          #.........",
        "......'''''''''''''''''#|+||<|| |JJJ||#....[....",
        "......'''''''NNN'''''''#t~8|||,,,0,,n1#.........",
        "......###*##########*###~~S|>|,,0JJ,,Oo%........",
        "..[...#U''''''UU'U|S ZW||+||+|,,0JJ,,5o%........",
        "......#U'''''''''U|           ,,,,,,,2o%........",
        "......#U''''UU''''|Q}}}|y  L  ,,,75F43#......[..",
        "......##########*########oo#*##JJ######.........",
        ".............`````````````````#oo#^.............",
        "....[........`````````````````..................",
        "........u....`````````````````........[.........",
        "................................................"
      ],
      "palettes": [ "standard_domestic_palette" ],
      "terrain": {
        "%": [ "t_region_shrub", "t_region_shrub_fruit", "t_region_shrub_decorative" ],
        "[": [ [ "t_region_tree_fruit", 2 ], [ "t_region_tree_nut", 2 ], "t_region_tree_shade" ],
        "!": "t_region_groundcover_urban",
        "#": "t_adobe_brick_wall",
        "_": "t_pavement",
        "'": "t_thconc_floor",
        "q": "t_thconc_floor",
        "N": "t_thconc_floor",
        "U": "t_thconc_floor",
        "Y": "t_thconc_floor",
        "`": "t_concrete",
        ",": "t_linoleum_white",
        "O": "t_linoleum_white",
        "F": "t_linoleum_white",
        "1": "t_linoleum_white",
        "2": "t_linoleum_white",
        "3": "t_linoleum_white",
        "4": "t_linoleum_white",
        "5": "t_linoleum_white",
        "6": "t_linoleum_white",
        "7": "t_linoleum_white",
        "0": "t_linoleum_white",
        "n": "t_linoleum_white",
        "J": "t_linoleum_white",
        "~": "t_linoleum_gray",
        "B": "t_linoleum_gray",
        "8": "t_linoleum_gray",
        "S": "t_linoleum_gray",
        "9": "t_linoleum_gray",
        "t": "t_linoleum_gray"
      },
      "furniture": { "!": "f_region_flower", "0": "f_stool", "}": "f_counter" },
      "place_loot": [
        { "item": "television", "x": 24, "y": 10, "chance": 100 },
        { "item": "stereo", "x": 24, "y": 9, "chance": 100 },
        { "item": "hose", "x": 11, "y": 20, "chance": 100 },
        { "item": "lawnmower", "x": 11, "y": 18, "chance": 100 }
      ],
      "place_vehicles": [
        { "vehicle": "suburban_home", "x": 18, "y": 11, "chance": 30, "rotation": 90 },
        { "vehicle": "suburban_home", "x": 11, "y": 11, "chance": 30, "rotation": 90 }
      ]
    }
  },
  {
    "method": "json",
    "om_terrain": [ [ "urban_6_3", "urban_6_4" ] ],
    "type": "mapgen",
    "object": {
      "fill_ter": "t_floor",
      "rows": [
        "~~~~~~~~~~~~~~~~~~~~~~~~~~~~~~~~~~~~~~~~~~~~~~~~",
        "~~~~~~~~~~~~~~~~~~~~~~~~~~~~~~~~~~~~~~~~~~~~~~~~",
        "~~~~~~~~~~~~~~~~~~~~~~~~~~~~~~~~~~~~~~~~~~~~~~~~",
        "~~~~~~~~~~~~~~~~~~~~~~~~~~~~~~~~~~~~~~~~~~~~~~~~",
        "~~~~~~~~~~~~~~~~~~~~~~~~~~~~~~~~~~~~~~~~~~~~~~~~",
        "~~~~~~~~~~~~~~~~~~~~~~~~~~~~~~~~~~~~~~~~~~~~~~~~",
        "~~~~~~~~~~~~~~~~~~~~~~~~~____~~~~____~~~~~~~~~~~",
        "~~~~~~0__________________&==______==__0~~~~~~~~~",
        "~~~~~~0==#oo#=======#ooo#=======#oo#==0~~~~~~~~~",
        "~~~~~~####yE#########Esy#########MM####~~~~~~~~~",
        "~~~~~~#RRR    |D|III    @|BtS|R      T#~~~~~~~~~",
        "~~~~~~#       + |Ih     @|B,,+       Io~~~~~~~~~",
        "~~~~~~#      I|||T     |||||||y    @@@#~~~~~~~~~",
        "~~~~~~#@@   hI| +     d|StB|>|D    @@@#~~~~~~~~~",
        "~~~~~~#@@    I|D|RR   b|,,B| |b    @@@#~~~~~~~~~",
        "~~~~~~#I     T||||||+||||+|| |d      Io~~~~~~~~~",
        "~~~~~~#d      +              +        #~~~~~~~~~",
        "~~~~~~####HH#########EsE#########TE####~~~~~~~~~",
        "~~~~~~0==#oo#=======#ooo#=======#oo#==0~~~~~~~~~",
        "~~~~~~0)))))))))))))))))))))))&==)))))0~~~~~~~~~",
        "~~~~~~~~~~~~~~~~~~~~~~~~~~~~~~))))~~~~~~~~~~~~~~",
        "~~~~~~~~~~~~~~~~~~~~~~~~~~~~~~~~~~~~~~~~~~~~~~~~",
        "~~~~~~~~~~~~~~~~~~~~~~~~~~~~~~~~~~~~~~~~~~~~~~~~",
        "~~~~~~~~~~~~~~~~~~~~~~~~~~~~~~~~~~~~~~~~~~~~~~~~"
      ],
      "palettes": [ "standard_domestic_palette" ],
      "terrain": {
        "~": "t_open_air",
        "#": "t_adobe_brick_wall",
        "=": "t_shingle_flat_roof",
        "&": "t_shingle_flat_roof",
        "%": "t_gutter_drop",
        "0": "t_gutter_east",
        "_": "t_gutter_south",
        ")": "t_gutter_north",
        "B": "t_linoleum_gray",
        "S": "t_linoleum_gray",
        "t": "t_linoleum_gray",
        "8": "t_linoleum_gray",
        ",": "t_linoleum_gray"
      }
    }
  },
  {
    "method": "json",
    "om_terrain": [ [ "urban_6_5", "urban_6_6" ] ],
    "type": "mapgen",
    "object": {
      "fill_ter": "t_shingle_flat_roof",
      "rows": [
        "                                                ",
        "                                                ",
        "                                                ",
        "                                                ",
        "                                                ",
        "                                                ",
        "                                                ",
        "                                                ",
        "         ----       -----       ----            ",
        "      ----..---------...---------..----         ",
        "      -...............................-         ",
        "      -..............=................-         ",
        "      -.........................&.....-         ",
        "      -...............................-         ",
        "      -...............................-         ",
        "      -....N.............X............-         ",
        "      -...............................-         ",
        "      ----..---------...---------..----         ",
        "         ----       -----       ----            ",
        "                                                ",
        "                                                ",
        "                                                ",
        "                                                ",
        "                                                "
      ],
      "palettes": [ "roof_palette" ],
      "terrain": { ".": "t_shingle_flat_roof" }
    }
  },
  {
    "method": "json",
    "om_terrain": [ [ "urban_6_1_basement", "urban_6_2_basement" ] ],
    "type": "mapgen",
    "object": {
      "fill_ter": "t_thconc_floor",
      "rows": [
        "                                                ",
        "                                                ",
        "                                                ",
        "                                                ",
        "                                                ",
        "                                                ",
        "                         ||||    ||||           ",
        "                       |||..||||||gF|||         ",
        "                       |2..........z..|         ",
        "                       |..........z.z.|         ",
        "                       |............z.|         ",
        "                       |......1.......|         ",
        "                       |..............|         ",
        "                       |||||..........|         ",
        "                       |8S8|..........|         ",
        "      ||||||||||||||||||9.t|<.........|         ",
        "      |~~~~~~~~~~~~~~~~||+||..........|         ",
        "      |~~~v|~~~|~~~|~~~...............|         ",
        "      |~~~~~~~~~~~~~~~~|AzzUU.........|         ",
        "      |||||||||||||||||||||||||..||||||         ",
        "                              ||||              ",
        "                                                ",
        "                                                ",
        "                                                "
      ],
      "palettes": [ "basement_empty" ],
      "terrain": { "v": "t_dirtfloor", "~": "t_dirtfloor" },
      "nested": {
        "1": { "chunks": [ [ "null", 60 ], [ "8x8_gym_W", 20 ], [ "room_8x8_hobby_W", 20 ], [ "room_8x8_junk_W", 40 ] ] },
        "2": {
          "chunks": [
            [ "null", 10 ],
            [ "livingroom_5x5_N_1", 30 ],
            [ "livingroom_5x5_S_1", 30 ],
            [ "livingroom_5x5_W_1", 30 ],
            [ "livingroom_5x5_N_2", 30 ],
            [ "livingroom_5x5_E_2", 30 ],
            [ "livingroom_5x5_S_2", 30 ],
            [ "livingroom_5x5_W_2", 30 ],
            [ "home_office_4x4_N", 20 ],
            [ "home_office_4x4_S", 20 ]
          ]
        }
      }
    }
  }
]
