[
  {
    "type": "mapgen",
    "method": "json",
    "om_terrain": [ [ "mine_entrance", "mine_entrance_loading_zone" ] ],
    "object": {
      "rows": [
        "fffffffffffФФfffffffffffffffФФФФФffffffФФФФФff  ",
        "f  v  ,,,,,,,,,,,,    !  f  ;;;;;;;;;;;;;;;; f  ",
        "f/    ,,,,,,,,,,,,,,,,,  f  ;;;;;;;;;;;;;;;; f  ",
        "|-000--000-0+0|00--00|,  f  ;;;;;;;;;;;;;;;; f  ",
        "|dddrFFddcW..2|2..Fdd|,  f  ;°°°;;;;;;;;;°;; f  ",
        "0dC.....Cc....?....dC|,  f  ;°°°;;;;;;;;°°°; f  ",
        "0............a|b...d.|,  f  ;°°°;;;;;;;°°°°° f  ",
        "0..C...|*-|-*-|b.....|,  f  °°°°°;;;;;;;°°°; f  ",
        "|rddd1p|.l|&_s|a36561|,  f  ;°°°;;;;;;;;°°°; f  ",
        "|-000--|--|---|------|,  f  ;;°;;;;;;;;;°°°; f  ",
        "f     ,,,,,,,,,,,,,,,,,,,,,,;;;;;;;;;;;;;;;; f  ",
        "|----|+|----|  ,,,,,,,,,,,,,;;;;;;;;;;;;;;;; f  ",
        "|I.hĎ|.|дh.I|  ,|---%-------;;;;;;;;;;;;;;;; f  ",
        "0BB..+.+..BB0  ,|eEE~~~eEE®®;;;;;;Ø;;;;;;;;; f  ",
        "|----|.|----|  ,|~EE~~~~EE==;;;;;;;;;;;;;;;; f  ",
        "|I.hĎ|.|дh.I|  ,|------|EE=~;;;;;;;;;;;;;;;; f  ",
        "0BB..+.+..BB0  ,|TTogTr|~~=~;;;;;;;;;;;;;;;; f  ",
        "|----|.|----|  ,0S....Ć|8~=~8|   |````|      f  ",
        "|I.hD|.|Дh.I|  ,|a....Ĉ|8~=~8|   |$``@|      f  ",
        "0BB..+.+..BB0  ,|----+-|8~=~8|   |````|      f  ",
        "|----|.|----|  ,|hth..h|8~=~8|   |````|      f  ",
        "|&___+.+____|  ,+.....t|8~~~8|   |````|      f  ",
        "|R__s|.|Й__7|/ /|hth..h|88888|/ /|9999|      f  ",
        "|----|0|----|fff|-0--0-|-----|fff|----|fffffff  "
      ],
      "fill_ter": "t_floor",
      "terrain": {
        " ": [ [ "t_region_groundcover", 4 ], [ "t_region_shrub", 2 ], [ "t_region_tree", 1 ] ],
        "!": "t_manhole_cover",
        "/": "t_gutter_downspout",
        "|": "t_wall",
        "-": "t_wall",
        "_": "t_linoleum_white",
        "&": "t_linoleum_white",
        "*": "t_door_c",
        "?": "t_door_locked_alarm",
        "+": "t_door_locked",
        "%": "t_door_metal_c",
        ",": "t_sidewalk",
        ";": "t_pavement",
        "°": "t_pavement_y",
        "Ø": "t_pavement",
        "®": "t_machinery_heavy",
        ".": "t_floor",
        "~": "t_thconc_floor",
        "`": "t_thconc_floor",
        "=": "t_conveyor",
        "0": "t_metal_grate_window_with_curtain",
        "4": "t_thconc_floor",
        "5": "t_console",
        "6": "t_console_broken",
        "8": "t_thconc_floor",
        "9": "t_thconc_floor",
        "E": "t_elevator",
        "e": "t_elevator_control_off",
        "f": "t_chainfence",
        "L": "t_door_metal_locked",
        "R": "t_linoleum_white",
        "s": "t_linoleum_white",
        "v": "t_dirt",
        "w": "t_window_alarm",
        "Й": "t_linoleum_white",
        "Ф": "t_chaingate_l"
      },
      "furniture": {
        "1": "f_shredder",
        "2": "f_rack_coat",
        "3": "f_server",
        "4": "f_metal_bench",
        "7": "f_shower",
        "8": "f_utility_shelf",
        "9": "f_utility_shelf",
        "a": "f_air_conditioner",
        "B": "f_bed",
        "b": "f_bookcase",
        "c": "f_counter",
        "Ć": "f_cupboard",
        "Ĉ": "f_cupboard",
        "C": "f_chair",
        "d": "f_desk",
        "D": "f_desk",
        "Ď": "f_desk",
        "F": "f_filing_cabinet",
        "g": "f_fridge",
        "h": "f_chair",
        "I": "f_dresser",
        "l": "f_locker",
        "o": "f_oven",
        "p": [ "f_indoor_plant", "f_indoor_plant_y" ],
        "R": "f_trashcan",
        "r": "f_trashcan",
        "S": "f_sink",
        "s": "f_sink",
        "T": "f_counter",
        "t": "f_table",
        "v": "f_vent_pipe",
        "W": "f_water_dispenser",
        "Д": "f_desk",
        "д": "f_desk",
        "Й": "f_rack_coat"
      },
      "toilets": { "&": {  } },
      "liquids": { "W": { "liquid": "water_clean", "amount": [ 0, 75 ] } },
      "items": {
        "2": { "item": "coat_rack", "chance": 60, "repeat": 2 },
        "8": { "item": "mine_materials", "chance": 50, "repeat": 4 },
        "9": { "item": "car_kit", "chance": 60, "repeat": 2 },
        "B": { "item": "bed", "chance": 50 },
        "b": { "item": "lab_bookshelves", "chance": 60, "repeat": 2 },
        "c": { "item": "office_supplies", "chance": 60 },
        "Ć": [
          { "item": "SUS_silverware", "chance": 80 },
          { "item": "SUS_utensils", "chance": 80 },
          { "item": "SUS_knife_drawer", "chance": 80 },
          { "item": "SUS_dishes", "chance": 80 },
          { "item": "SUS_cookware", "chance": 80 }
        ],
        "Ĉ": { "item": "SUS_pantry", "chance": 80 },
        "D": { "item": "SUS_junk_drawer", "chance": 90 },
        "Ď": { "item": "SUS_junk_drawer", "chance": 90 },
        "d": { "item": "SUS_office_desk", "chance": 90 },
        "F": { "item": "SUS_office_filing_cabinet", "chance": 90 },
        "g": { "item": "SUS_fridge", "chance": 80 },
        "I": { "item": "SUS_dresser_mens", "chance": 60 },
        "l": { "item": "SUS_janitors_closet", "chance": 85 },
        "o": { "item": "SUS_oven", "chance": 70 },
        "R": { "item": "trash_cart", "chance": 50 },
        "r": { "item": "trash_cart", "chance": 50 },
        "S": { "item": "SUS_kitchen_sink", "chance": 90 },
        "s": { "item": "SUS_bathroom_sink", "chance": 70 },
        "T": { "item": "SUS_appliances_cupboard", "chance": 10 },
        "t": { "item": "dining", "chance": 45 },
        "Д": { "item": "SUS_junk_drawer", "chance": 90 },
        "д": { "item": "SUS_junk_drawer", "chance": 90 }
      },
      "monster": {
        ",": { "monster": "mon_zombie_miner", "chance": 5 },
        ".": { "monster": "mon_zombie_miner", "chance": 5 },
        "`": { "monster": "mon_zombie_miner", "chance": 5 },
        " ": { "monster": "mon_zombie_miner", "chance": 5 },
        "~": { "monster": "mon_zombie_miner", "chance": 5 }
      },
      "computers": {
        "5": {
          "name": "NEPowerOS",
          "security": 2,
          "options": [ { "name": "Divert power to elevator", "action": "elevator_on" } ],
          "failures": [ { "action": "alarm" } ]
        }
      },
      "gaspumps": { "@": { "fuel": "gasoline", "amount": [ 10000, 50000 ] }, "$": { "fuel": "diesel", "amount": [ 10000, 50000 ] } },
      "vehicles": { "Ø": { "vehicle": "tatra_truck", "chance": 50, "fuel": 40 } },
      "nested": { "`": { "chunks": [ [ "gasoline_diesel_motor_oil", 80 ], [ "null", 80 ] ] } }
    }
  },
  {
    "type": "mapgen",
    "method": "json",
    "om_terrain": "mine_entrance_parking",
    "weight": 500,
    "object": {
      "fill_ter": "t_region_groundcover_urban",
      "rows": [
        "  ;;;;;;;;;;;;;;;;;;;;  ",
        " Y;;;;;;;;;;;;;;;;;;;;Y ",
        " ;;;;;;;;;;;;;;;;;;;;;; ",
        " ;;;;;;;;;;;;;;;;;;;;;; ",
        " ;;;;;;;;;;;;;;;;;;;;;; ",
        " °°°°°°°;;;;;;;;°°°°°°° ",
        " ;;;;;;;;;;;;;;;;;;;;;; ",
        " ;;;;;;;;;;;;;;;;;;;;;; ",
        " ;;;;;;;;;;;;;;;;;;;;;; ",
        " ;;;;;;;;;;;;;;;;;;;;;; ",
        " ;;;;;;;;;;;;;;;;;;;;;; ",
        " °°°°°°°;;;;;;;;°°°°°°° ",
        " ;;;;;;;;;;;;;;;;;;;;;; ",
        " ;;;;;;;;;;;;;;;;;;;;;; ",
        " ;;;;;;;;;;;;;;;;;;;;;; ",
        " ;;;;;;;;;;;;;;;;;;;;;; ",
        " ;;;;;;;;;;;;;;;;;;;;;; ",
        " °°°°°°°;;;;;;;;°°°°°°° ",
        " ;;;;;;;;;;;;;;;;;;;;;; ",
        " ;;;;;;;;;;;;;;;;;;;;;; ",
        " ;;;;;;;;;;;;;;;;;;;;;; ",
        " ;;;;;;;;;;;;;;;;;;;;;; ",
        " ;;;;;;;;;;;;;;;;;;;;;; ",
        "                        "
      ],
      "terrain": {
        " ": [ [ "t_region_groundcover", 4 ], [ "t_region_shrub", 2 ], [ "t_region_tree", 1 ] ],
        ";": "t_pavement",
        "°": "t_pavement_y",
        "Y": "t_pavement"
      },
      "furniture": { "Y": "f_street_light" },
      "place_vehicles": [
        { "vehicle": "parkinglotbasic", "x": 3, "y": 9, "chance": 25, "rotation": 180 },
        { "vehicle": "parkinglotbasic", "x": 3, "y": 15, "chance": 25, "rotation": 180 },
        { "vehicle": "parkinglotbasic", "x": 3, "y": 21, "chance": 25, "rotation": 180 },
        { "vehicle": "parkinglotbasic", "x": 20, "y": 7, "chance": 25 },
        { "vehicle": "parkinglotbasic", "x": 20, "y": 13, "chance": 25 },
        { "vehicle": "parkinglotbasic", "x": 20, "y": 19, "chance": 25 }
      ]
    }
  },
  {
    "type": "mapgen",
    "method": "json",
    "om_terrain": [ [ "mine_entrance_roof", "mine_entrance_loading_zone_roof" ] ],
    "object": {
      "rows": [
        "                                                ",
        "                                                ",
        "                                                ",
        "Ю--------------------|                          ",
        "|....................|                          ",
        "|....................|                          ",
        "|....................|                          ",
        "|....................|                          ",
        "|....................|                          ",
        "|--------------------|                          ",
        "                                                ",
        "|-----------|                                   ",
        "|...........|   |------------|                  ",
        "|...........|   |............|                  ",
        "|...........|   |............|                  ",
        "|...........|   |............|                  ",
        "|...........|   |............|                  ",
        "|...........|   |............|   |----|         ",
        "|...........|   |............|   |....|         ",
        "|...........|   |............|   |....|         ",
        "|...........|   |............|   |....|         ",
        "|...........|   |............|   |....|         ",
        "|...........|   |............|   |....|         ",
        "|-----------Ю   Ю------------Ю   Ю----|         "
      ],
      "terrain": { " ": "t_open_air", "|": "t_gutter_north", "-": "t_gutter_west", "Ю": "t_gutter_drop", ".": "t_flat_roof" }
    }
  },
  {
    "type": "mapgen",
    "method": "json",
    "nested_mapgen_id": "gasoline_diesel_motor_oil",
    "object": {
      "mapgensize": [ 1, 1 ],
      "place_liquids": [
        { "liquid": "gasoline", "x": 0, "y": 0, "chance": 20 },
        { "liquid": "diesel", "x": 0, "y": 0, "chance": 20 },
        { "liquid": "motor_oil", "x": 0, "y": 0, "chance": 20 }
      ]
    }
  }
]
