[
  {
    "type": "mapgen",
    "method": "json",
    "om_terrain": [ [ "mine_shaft_middle", "mine_shaft_middle_east" ] ],
    "object": {
      "fill_ter": "t_rock",
      "rows": [
        "                                                ",
        "                      <#                        ",
        "                       #                        ",
        "                       #                        ",
        "                       #                        ",
        "                       #                        ",
        "                       #                        ",
        "                       #                        ",
        "                       #                        ",
        "                       #                        ",
        "                       #                        ",
        "                       #                        ",
        "                     #>#                        ",
        "                 ....###..                      ",
        "                 ....   ..                      ",
        "                        ..                      ",
        "                                                ",
        "                                                ",
        "                                                ",
        "                                                ",
        "                                                ",
        "                                                ",
        "                                                ",
        "                                                "
      ],
      "terrain": { "<": "t_ladder_up", ">": "t_ladder_down", "#": "t_grate", ".": "t_hole" }
    }
  },
  {
    "type": "mapgen",
    "method": "json",
    "om_terrain": [ [ "mine_shaft_lower", "mine_shaft_lower_east" ] ],
    "object": {
      "fill_ter": "t_rock_floor",
      "rows": [
        "######       ##    ####################  #######",
        "######       ##    ###################  ########",
        "######№      ##   №############# ####  #########",
        "#######          ############### ###  ##########",
        "########         ############### ##  ###########",
        "########           ##############   ############",
        "  ######          ################    ##########",
        "     ##№         #################   ###########",
        "#                  №##### №######    ###########",
        "  ####                ##                        ",
        "######                    ###      #### ####    ",
        "######               |-|             #### ##### ",
        "######          |----|<|--|                     ",
        "#####           |!@@...!@@|       ####     #####",
        "###№            |.@@....@@|   #########   ######",
        "                +.......@@|   ##########  ######",
        "*****************=========|   # ########    ####",
        "                +.......®®|     №#######    ####",
        "                |.........|      #########  ####",
        "#               |.........|      #########     #",
        "##              |LLLL|SSSS|        №#########  #",
        "####№           |----|----|          ########  #",
        "######                               #########  ",
        "#######        ##  №#######           ########  "
      ],
      "terrain": {
        " ": [ [ "t_water_sh_underground", 1 ], [ "t_rock_floor", 9 ] ],
        "<": "t_ladder_up",
        "-": "t_wall",
        "|": "t_wall",
        ".": "t_thconc_floor",
        "+": "t_door_metal_c",
        "!": "t_elevator_control",
        "@": "t_elevator",
        "®": "t_machinery_heavy",
        "#": [ [ "t_rock", 4 ], [ "t_rock_floor", 1 ] ],
        "=": "t_conveyor",
        "*": "t_railroad_track_small",
        "№": "t_pillar",
        "L": "t_thconc_floor",
        "S": "t_thconc_floor"
      },
      "furniture": { "L": "f_locker", "S": "f_utility_shelf" },
      "items": {
        "L": [ { "item": "clothing_work_set", "chance": 50 }, { "item": "hardware_clothing", "chance": 50 } ],
        "S": { "item": "mine_equipment", "chance": 80 }
      },
      "place_vehicles": [ { "vehicle": "trolley", "x": 10, "y": 16, "chance": 100, "status": 0 } ],
      "monsters": { " ": { "monster": "GROUP_MINER", "chance": 1, "density": 0.0005 } },
      "nested": { " ": { "chunks": [ [ "null", 9 ], [ "place_cave_moss", 1 ] ] } }
    }
  },
  {
    "type": "mapgen",
    "method": "json",
    "om_terrain": [ "mine_shaft_lower_sub_station" ],
    "weight": 1000,
    "object": {
      "rows": [
        "#######        ##   ####",
        "######         ##   ####",
        "####                 ###",
        "###p                p###",
        "###                  ###",
        "###                  ###",
        "###p                p###",
        "###                  ###",
        "##                    ##",
        "##                    ##",
        "## gbgggbg    gbgggbg ##",
        "#  g|ggg|g    g|ggg|g  #",
        "#  g|ggg|g    g|ggg|g  #",
        "#  -+---+-    -+---+-  #",
        "   g|ggg|g    g|ggg|g   ",
        "   g|ggg|g    g|ggg|g   ",
        "   -+---+-    -+---+-   ",
        "   g|ggg|g    g|ggg|g   ",
        "   g|ggg|g    g|ggg|g   ",
        "   -+---+-    -+---+-   ",
        "   g|ggg|g    g|ggg|g   ",
        "   g|ggg|g    g|ggg|g   ",
        "   -+---+-    -+---+-   ",
        "   g|ggg|g    g|ggg|g   "
      ],
      "terrain": {
        " ": "t_rock_floor",
        "#": "t_rock",
        "|": "t_railroad_track",
        "-": "t_railroad_tie",
        "+": "t_railroad_track_on_tie",
        "b": "t_buffer_stop",
        "g": "t_railroad_rubble",
        "p": "t_pillar"
      },
      "place_vehicles": [
        { "vehicle": "trains_mine_shaft", "x": 7, "y": [ 16, 20 ], "chance": 25, "rotation": 90 },
        { "vehicle": "trains_mine_shaft", "x": 16, "y": [ 12, 18 ], "chance": 25, "rotation": 270 }
      ],
      "nested": { " ": { "chunks": [ [ "null", 9 ], [ "place_cave_moss", 1 ] ] } }
    }
  }
]
