[
  {
    "type": "mapgen",
    "method": "json",
    "om_terrain": [ "triffid_grove_z2" ],
    "weight": 100,
    "object": {
      "fill_ter": "t_barkfloor",
      "rows": [
        ">>>>>>>>>>>>>>>>>>>>>>>>",
        ">>>>>>>>>>>>>>>>>>>>>>>>",
        ">>>>>>>>>>>>>>>>>>>>>>>>",
        ">>>>>>>>>>>>>>>#####>>>>",
        ">>>#######>#####~~~##>>>",
        ">>>#~~~~~###~~~~~~~~#>>>",
        ">>>#~~~~~~~~~~~~~~~##>>>",
        ">>>#~~~~~~~~~~~~~~~#>>>>",
        ">>>#~~~~~~~~~~~~~~~#>>>>",
        ">>>#~~~~~~~~~~.~~~~##>>>",
        ">>>##~~~~~~~~~...~~~#>>>",
        ">>>>#~~~~~~~~....V~~##>>",
        ">>>##~~~~~~~~~~..~~##>>>",
        ">>>>#~~~~~~~~~~~~~~#>>>>",
        ">>>##~~~~~~~~~~~~~~#>>>>",
        ">>>#~~~~~~~~~~~~~~~##>>>",
        ">>>#~~~~~~~~~~~~~~~##>>>",
        ">>>#~~~~~~~~~~~~~~~#>>>>",
        ">>>######~~~~~~~~~~#>>>>",
        ">>>>>#>>############>>>>",
        ">>>>>>>>>>>>##>>>##>>>>>",
        ">>>>>>>>>>>>>>>>>>>>>>>>",
        ">>>>>>>>>>>>>>>>>>>>>>>>",
        ">>>>>>>>>>>>>>>>>>>>>>>>"
      ],
      "palettes": [ "triffid" ],
      "terrain": { "V": "t_triffid_slope_down", ">": "t_open_air" }
    }
  }
]
