[
  {
    "type": "mapgen",
    "om_terrain": "FEMA_entrance",
    "//": "entrance. bottom edge",
    "weight": 250,
    "method": "json",
    "object": {
      "fill_ter": "t_floor",
      "rows": [
        "........................",
        "ff!!!!!!!!!!!!!!!!!!!!ff",
        ".f!!!NNNNNNNNNNNNNN!!!f.",
        ".f!!!N!!!!!!!!!!!!N!!!f.",
        ".f!!!!!!!!!!!!!!!!!!!!f.",
        ".f!!!!!!!!!!!!!!!!!!!!f.",
        ".fFFf---gg-++------fFFf.",
        ".f...|~DDD~~~~~~~l|...f.",
        ".f...|~~c~~~~TT~~l|...f.",
        ".f...|~~~~~~~TT~~l|...f.",
        ".f...|~~~~~~~~c~~l|...f.",
        ".f...g~~~~TT~~~~~~g...f.",
        ".f...g~~~~TTc~~~~~g...f.",
        ".f...g~~~cTT~~~~~~g...f.",
        ".f...g~~~~~~~~~~~~g...f.",
        ".f...|------------|...f.",
        ".f...|~6~~~|~~~~c~|...f.",
        ".f...|cD~~~+~~~DD6|...f.",
        ".f...|~~~~~|~~~~~~|...f.",
        ".fFFf-------++-gg--fFFf.",
        ".......iii..............",
        ".......iIi..............",
        ".......iii..............",
        "........................"
      ],
      "rotation": 2,
      "palettes": [ "FEMA_camp" ],
      "terrain": { "N": "t_dirt", "z": "t_dirt" }
    }
  }
]
