[
  {
    "type": "mapgen",
    "om_terrain": "FEMA_entrance",
    "//": "entrance. bottom edge",
    "weight": 250,
    "method": "json",
    "object": {
      "fill_ter": "t_floor",
      "rows": [
        "........................",
        "ff!!!!!!!fffffffffffffff",
        ".f!!!!!!!f..............",
        ".f!!!!!!!f..............",
        ".f!!!!!!!--gg-----gg---.",
        ".f!!!!!!!|~~~~TT~~~DDD|.",
        ".f!!!!!!!gD~~~TT~~~~c~|.",
        ".f!!!!!!!gDc~~~~~~~~~~|.",
        ".f!!!!!!!|~~~~~~~~~~~6|.",
        ".fffFFfff|-----++-----|.",
        ".f!!!!iii|D~~~~~~~~~XX|.",
        ".f!!!!iIigDc~~~~~~~~XX|.",
        ".f!!!!iii|D~~~~~~~~~~~|.",
        ".f!!!!!!!+~~~~~~~~AAAA|.",
        ".fffFFfff|-----++-----|.",
        ".........|s~&|~~~~|s~&|.",
        ".........|~~~|llll|~~~|.",
        ".........--+--------+-|.",
        "........................",
        "........................",
        "........................",
        "........................",
        "........................",
        "........................"
      ],
      "rotation": 2,
      "palettes": [ "FEMA_camp" ],
      "terrain": { "N": "t_dirt" },
      "items": { "X": { "item": "mil_surplus", "chance": 50, "repeat": 2 } },
      "monsters": { "~": [ { "monster": "GROUP_MIL_WEAK", "chance": 1, "density": 0.002 } ] }
    }
  }
]
