[
  {
    "type": "mapgen",
    "om_terrain": "FEMA_mid",
    "//": "middle area",
    "weight": 250,
    "method": "json",
    "object": {
      "fill_ter": "t_floor",
      "rows": [
        "........................",
        "........................",
        "..-----g-g-++-g-g-----..",
        "..|s&|            |&s|..",
        "..+ S| nnn    nnn |S +..",
        "..|---            ---|..",
        "..|        c         |..",
        "..+       TTTT       +..",
        "..|       TTTT       |..",
        "..|---b      c    ---|..",
        "..+ &|b           |  |..",
        "..|sS|b  nnnnn    +  |..",
        "..|------------------|..",
        "..+ &|BB,,rrrrXX,,,BB|..",
        "..|sS|,,,,,,,,,,,,,,,|..",
        "..|--|BB,,,,,,,,,,,BB|..",
        "..|& +,,,,,,,,,,,,,,,|..",
        "..|Ss|,,,,,,,,,,,,,BB|..",
        "..|--|BB,,,,-+--+----|..",
        "..+ &|,,,,,,|,,|,,|S +..",
        "..|sS|BB,,,,|LL|00|s&|..",
        "..-------++-----------..",
        "........................",
        "........................"
      ],
      "rotation": [ 0, 3 ],
      "palettes": [ "FEMA_camp" ],
      "furniture": { ",": "f_null" },
      "items": {
        "L": { "item": "surgery", "chance": 50, "repeat": 2 },
        "r": { "item": "drugs_emergency", "chance": 50, "repeat": 2 },
        "X": { "item": "hospital_lab", "chance": 75, "repeat": 2 }
      },
      "item": { "B": { "item": "rag_bloody", "amount": [ 0, 5 ] } },
      "monsters": { ",": { "monster": "GROUP_LAB_FEMA", "chance": 1, "density": 0.002 } }
    }
  }
]
