[
  {
    "type": "mapgen",
    "om_terrain": "FEMA_entrance",
    "//": "entrance. bottom edge",
    "weight": 250,
    "method": "json",
    "object": {
      "fill_ter": "t_floor",
      "rows": [
        "........iii.............",
        "ffff....iIi.........ffff",
        "...f....iii.........f...",
        "...--++-ggg-----!!!!N...",
        "...|~~~~~~~~DD6|!!!!N...",
        "...|~~~~~~~~~c~|!!!!N...",
        "...|X~~~c~~~~~~|!!!!N...",
        "...|X~~TT~~~~~~|!!!!N...",
        "...|X~~TT~~~lll|!!!!N...",
        "...-----ggg-----!!!!N...",
        "...N!!!!!!!!!!!!!!!!N...",
        "...N!!!!!!!!!!!!!!!!N...",
        "...N!!!!!!!!!!!!!!!!N...",
        "...N!!!!!!!!!!!!!!!!N...",
        "...N!!!!!------------...",
        "...N!!!!!|BB~~~~~DDD|...",
        "...N!!!!!|~~~~~~~~c~|...",
        "...N!!!!!|BB~~~~~~~~|...",
        "...N!!!!!|~~~~~~~~~~+...",
        "...N!!!!!|BB~~llll~~|...",
        "...N!!!!!------------...",
        "........................",
        "........................",
        "........................"
      ],
      "rotation": 2,
      "palettes": [ "FEMA_camp" ],
      "terrain": { "N": "t_dirt" },
      "items": { "X": { "item": "mil_surplus", "chance": 50, "repeat": 2 } }
    }
  }
]
